//MAP CONVERTED BY dmm2tgm.py THIS HEADER COMMENT PREVENTS RECONVERSION, DO NOT REMOVE
"a" = (
/turf/closed/indestructible/riveted,
/area/centcom/mafia)
"b" = (
/obj/mafia_game_board,
/obj/effect/mapping_helpers/broken_floor,
/turf/open/floor/plating/indoor/metal/grate,
/area/centcom/mafia)
"f" = (
/obj/structure/window/fulltile/halflife/combine,
/obj/effect/spawner/structure/window/reinforced/indestructible,
/turf/open/space/basic,
/area/centcom/mafia)
"i" = (
/turf/open/floor/plating/indoor/woodc,
/area/centcom/mafia)
"j" = (
/turf/template_noop,
/area/template_noop)
"q" = (
/turf/open/floor/plating/indoor/metal/grate,
/area/centcom/mafia)
"s" = (
/obj/structure/grille/indestructible,
/turf/open/floor/plating/indoor/metal/grate,
/area/centcom/mafia)
"v" = (
/obj/machinery/door/airlock/highsecurity/combine,
/obj/effect/mapping_helpers/airlock/locked,
/turf/open/floor/plating,
/area/centcom/mafia)
"y" = (
/obj/effect/landmark/mafia,
/turf/open/floor/plating/indoor/woodc/mosaic,
/area/centcom/mafia)
"A" = (
/obj/machinery/door/airlock/highsecurity/combine,
/obj/effect/mapping_helpers/airlock/locked,
/turf/open/floor/plating/indoor/woodc,
/area/centcom/mafia)
"C" = (
/obj/machinery/door/airlock/highsecurity/combine,
/obj/effect/mapping_helpers/airlock/locked,
/turf/open/floor/plating/indoor/woodc/mosaic,
/area/centcom/mafia)
"E" = (
/obj/structure/closet/cabinet{
	anchored = 1
	},
/turf/open/floor/plating/indoor/woodc/mosaic,
/area/centcom/mafia)
"J" = (
/turf/closed/wall/halflife/concrete/alt,
/area/centcom/mafia)
"K" = (
/obj/effect/baseturf_helper/asteroid,
/obj/effect/landmark/mafia/town_center,
/turf/open/floor/plating/ground/grass,
/area/centcom/mafia)
"L" = (
/obj/effect/mapping_helpers/burnt_floor,
/turf/open/floor/plating/indoor/metal/grate,
/area/centcom/mafia)
"M" = (
/turf/open/floor/plating/indoor/woodc/mosaic,
/area/centcom/mafia)
"N" = (
/obj/effect/mapping_helpers/broken_floor,
/turf/open/floor/plating/indoor/metal/grate,
/area/centcom/mafia)
"P" = (
/obj/mafia_game_board,
/turf/open/floor/plating/indoor/metal/grate,
/area/centcom/mafia)
"V" = (
/obj/effect/landmark/mafia,
/turf/open/floor/plating/indoor/woodc,
/area/centcom/mafia)
"W" = (
/obj/structure/closet/cabinet{
	anchored = 1
	},
/turf/open/floor/plating/indoor/woodc,
/area/centcom/mafia)
"X" = (
/obj/mafia_game_board,
/obj/effect/mapping_helpers/burnt_floor,
/turf/open/floor/plating/indoor/metal/grate,
/area/centcom/mafia)
"Y" = (
/turf/open/floor/plating/ground/grass,
/area/centcom/mafia)

(1,1,1) = {"
j
a
a
a
a
a
a
a
a
a
a
a
a
a
a
a
a
a
a
a
a
a
j
"}
(2,1,1) = {"
j
a
J
J
J
J
J
J
J
J
J
J
J
J
J
J
J
J
J
J
J
a
j
"}
(3,1,1) = {"
j
a
J
J
J
J
J
J
J
J
J
J
J
J
J
J
J
J
J
J
J
a
j
"}
(4,1,1) = {"
j
a
J
J
b
s
q
q
q
q
q
N
q
q
q
q
q
s
P
J
J
a
j
"}
(5,1,1) = {"
a
a
J
J
s
q
q
N
J
J
C
J
A
J
J
q
q
N
s
J
J
a
a
"}
(6,1,1) = {"
a
J
J
J
N
J
J
A
J
E
M
J
i
W
J
C
J
J
q
J
J
J
a
"}
(7,1,1) = {"
a
J
J
J
q
J
W
i
f
M
M
f
i
i
f
M
E
J
q
J
J
J
a
"}
(8,1,1) = {"
a
J
J
q
q
J
i
i
J
J
M
J
i
J
J
M
M
J
q
q
J
J
a
"}
(9,1,1) = {"
a
J
J
q
J
J
f
i
V
f
y
f
V
f
y
M
f
J
J
q
J
J
a
"}
(10,1,1) = {"
a
J
J
q
J
E
f
J
f
f
f
f
f
f
f
J
f
W
J
q
J
J
a
"}
(11,1,1) = {"
a
J
J
q
v
M
M
M
y
f
Y
Y
Y
f
V
i
i
i
A
N
J
J
a
"}
(12,1,1) = {"
a
J
J
N
J
J
f
J
f
f
Y
K
Y
f
f
J
f
J
J
q
J
J
a
"}
(13,1,1) = {"
a
J
J
q
A
i
i
i
V
f
Y
Y
Y
f
y
M
M
M
C
q
J
J
a
"}
(14,1,1) = {"
a
J
J
q
J
W
f
J
f
f
f
f
f
f
f
J
f
E
J
N
J
J
a
"}
(15,1,1) = {"
a
J
J
q
J
J
f
M
y
f
V
f
y
f
V
i
f
J
J
q
J
J
a
"}
(16,1,1) = {"
a
J
J
L
q
J
M
M
J
J
i
J
M
J
J
i
i
J
q
q
J
J
a
"}
(17,1,1) = {"
a
J
J
J
q
J
E
M
f
i
i
f
M
M
f
i
W
J
q
J
J
J
a
"}
(18,1,1) = {"
a
J
J
J
q
J
J
v
J
W
i
J
M
E
J
A
J
J
q
J
J
J
a
"}
(19,1,1) = {"
a
a
J
J
s
N
q
q
J
J
A
J
C
J
J
q
N
q
s
J
J
a
a
"}
(20,1,1) = {"
j
a
J
J
P
s
q
q
N
q
q
q
q
q
q
q
q
s
X
J
J
a
j
"}
(21,1,1) = {"
j
a
J
J
J
J
J
J
J
J
J
J
J
J
J
J
J
J
J
J
J
a
j
"}
(22,1,1) = {"
j
a
J
J
J
J
J
J
J
J
J
J
J
J
J
J
J
J
J
J
J
a
j
"}
(23,1,1) = {"
j
a
a
a
a
a
a
a
a
a
a
a
a
a
a
a
a
a
a
a
a
a
j
"}
