//MAP CONVERTED BY dmm2tgm.py THIS HEADER COMMENT PREVENTS RECONVERSION, DO NOT REMOVE
"aa" = (
/obj/effect/baseturf_helper/halflife/underground,
/turf/closed/wall/halflife/concrete,
/area/halflife/indoors/bunker)
"az" = (
/obj/structure/table/halflife/metal/grate,
/obj/item/restraints/legcuffs/beartrap{
	pixel_x = 8;
	pixel_y = 11
	},
/obj/item/restraints/legcuffs/beartrap{
	pixel_x = -5;
	pixel_y = 8
	},
/obj/machinery/light/small/directional/west,
/turf/open/floor/plating/indoor/concrete/small,
/area/halflife/indoors/bunker)
"aT" = (
/obj/machinery/light/small/directional/south,
/obj/item/restraints/legcuffs/beartrap{
	pixel_x = 8;
	pixel_y = 10
	},
/turf/open/floor/plating/indoor/concrete/bricks,
/area/halflife/indoors/bunker)
"cv" = (
/obj/structure/table/halflife/no_smooth/large/metal/desk{
	dir = 1
	},
/obj/item/reagent_containers/cup/glass/waterbottle/large/empty{
	pixel_x = 7;
	pixel_y = 15
	},
/turf/open/floor/plating/indoor/concrete/bricks,
/area/halflife/indoors/bunker)
"cP" = (
/obj/structure/bed/halflife/bedframe/wire,
/obj/structure/bed/halflife/mattress/old,
/obj/machinery/light/small/directional/north,
/obj/effect/mob_spawn/ghost_role/human/bunkeroperator,
/turf/open/floor/plating/indoor/concrete/bricks,
/area/halflife/indoors/bunker)
"dQ" = (
/obj/item/screwdriver{
	pixel_x = 6;
	pixel_y = 8
	},
/obj/item/stack/cable_coil/five{
	pixel_x = 12;
	pixel_y = -4
	},
/turf/open/floor/plating/indoor/concrete/bricks,
/area/halflife/indoors/bunker)
"eb" = (
/obj/structure/halflife/trash/cardboard,
/obj/item/reagent_containers/cup/glass/mouthwash{
	pixel_x = 4;
	pixel_y = 26
	},
/obj/item/reagent_containers/cup/glass/mouthwash{
	pixel_x = 16;
	pixel_y = 25
	},
/obj/item/reagent_containers/cup/glass/mouthwash{
	pixel_x = -9;
	pixel_y = 23
	},
/obj/item/storage/box/lights/bulbs{
	pixel_x = -7;
	pixel_y = 0
	},
/obj/structure/halflife/pipes/horizontal/end{
	dir = 1
	},
/turf/open/floor/plating/indoor/concrete/bricks,
/area/halflife/indoors/bunker)
"fo" = (
/obj/machinery/door/poddoor/shutters/window{
	id = "commsentrance"
	},
/obj/structure/window/fulltile,
/turf/open/floor/plating/indoor/concrete/bricks,
/area/halflife/indoors/bunker)
"fG" = (
/obj/structure/table/halflife/no_smooth/large/metal/desk{
	dir = 1
	},
/obj/item/storage/fancy/cigarettes/halflife{
	pixel_x = 15;
	pixel_y = 12
	},
/obj/item/storage/box/matches{
	pixel_x = -1;
	pixel_y = 10
	},
/obj/machinery/jukebox/radio,
/turf/open/floor/plating/indoor/concrete/bricks,
/area/halflife/indoors/bunker)
"fW" = (
/obj/structure/halflife/trash/papers/one{
	dir = 4
	},
/turf/open/floor/plating/indoor/concrete/bricks,
/area/halflife/indoors/bunker)
"gr" = (
/obj/structure/halflife/pipes/horizontal,
/obj/item/chair/halflife/metal/office/blue{
	dir = 1
	},
/turf/open/halflife/water/medium,
/area/halflife/indoors/bunker)
"gX" = (
/obj/machinery/button/door{
	id = "commsentrance"
	},
/obj/structure/table/halflife/metal,
/obj/item/pen{
	pixel_x = 8;
	pixel_y = 8
	},
/turf/open/floor/plating/indoor/concrete/small,
/area/halflife/indoors/bunker)
"ht" = (
/obj/structure/halflife/trash/garbage{
	pixel_x = -14;
	pixel_y = -4
	},
/turf/open/floor/plating/indoor/concrete/bricks,
/area/halflife/indoors/bunker)
"jv" = (
/obj/machinery/shower/halflife{
	dir = 8
	},
/obj/structure/fluff/shower_drain,
/turf/open/floor/plating/indoor/lino,
/area/halflife/indoors/bunker)
"jM" = (
/obj/machinery/door/unpowered/halflife/metal/red{
	dir = 4
	},
/turf/open/floor/plating/indoor/concrete/small,
/area/halflife/indoors/bunker)
"ki" = (
/obj/structure/halflife/trash/garbage{
	pixel_x = 8;
	pixel_y = 8
	},
/obj/structure/halflife/trash/garbage{
	pixel_x = -4;
	pixel_y = 13
	},
/turf/open/floor/plating/indoor/concrete/bricks,
/area/halflife/indoors/bunker)
"kn" = (
/obj/structure/halflife/trash/garbage{
	pixel_x = 6;
	pixel_y = -3
	},
/turf/open/floor/plating/indoor/concrete/bricks,
/area/halflife/indoors/bunker)
"kW" = (
/obj/machinery/light/small/directional/east,
/obj/item/wrench{
	pixel_x = -8;
	pixel_y = 2
	},
/obj/item/stack/cable_coil/five{
	pixel_x = -11;
	pixel_y = -7
	},
/turf/open/floor/plating/indoor/concrete/bricks,
/area/halflife/indoors/bunker)
"lj" = (
/obj/machinery/light/small/directional/east,
/turf/open/floor/plating/indoor/concrete/small,
/area/halflife/indoors/bunker)
"lq" = (
/obj/machinery/light/small/directional/east,
/obj/structure/filingcabinet/hl2,
/turf/open/floor/plating/indoor/concrete/small,
/area/halflife/indoors/bunker)
"mB" = (
/obj/machinery/light/small/broken/directional/east,
/obj/item/reagent_containers/condiment/vegetable_oil{
	pixel_x = 4;
	pixel_y = 8
	},
/turf/open/floor/plating/indoor/concrete/bricks,
/area/halflife/indoors/bunker)
"mY" = (
/obj/machinery/light/small/directional/north,
/turf/open/floor/plating/indoor/concrete/bricks,
/area/halflife/indoors/bunker)
"nS" = (
/turf/open/floor/plating/indoor/concrete/small,
/area/halflife/indoors/bunker)
"oC" = (
/obj/structure/table/halflife/no_smooth/large/metal/desk{
	dir = 1
	},
/obj/structure/halflife/trash/food/glass{
	pixel_x = 1;
	pixel_y = 11
	},
/turf/open/floor/plating/indoor/concrete/bricks,
/area/halflife/indoors/bunker)
"oI" = (
/obj/structure/chair/office/halflife/blue/broken,
/obj/structure/halflife/trash/papers/three{
	dir = 8
	},
/turf/open/floor/plating/indoor/concrete/bricks,
/area/halflife/indoors/bunker)
"pg" = (
/obj/structure/sink/halflife{
	pixel_y = 8
	},
/obj/structure/mirror/halflife{
	pixel_y = 32
	},
/turf/open/floor/plating/indoor/lino,
/area/halflife/indoors/bunker)
"pO" = (
/obj/structure/halflife/trash/glass/basic{
	pixel_x = 0;
	pixel_y = 10
	},
/obj/structure/table/halflife/metal,
/turf/open/floor/plating/indoor/concrete/small,
/area/halflife/indoors/bunker)
"qU" = (
/obj/machinery/door/unpowered/halflife/metal/red,
/turf/open/floor/plating/indoor/concrete/bricks,
/area/halflife/indoors/bunker)
"rz" = (
/obj/modular_map_connector,
/turf/template_noop,
/area/template_noop)
"sp" = (
/obj/machinery/door/unpowered/halflife/metal/red{
	dir = 4
	},
/turf/open/floor/plating/indoor/concrete/bricks,
/area/halflife/indoors/bunker)
"sq" = (
/obj/structure/halflife/tank,
/turf/open/floor/plating/indoor/concrete/small,
/area/halflife/indoors/bunker)
"te" = (
/obj/structure/table/halflife/no_smooth/wood/stand,
/turf/open/floor/plating/indoor/concrete/bricks,
/area/halflife/indoors/bunker)
"tK" = (
/obj/machinery/door/unpowered/halflife/metal/red,
/turf/open/floor/plating/indoor/lino,
/area/halflife/indoors/bunker)
"uD" = (
/turf/template_noop,
/area/template_noop)
"uG" = (
/obj/structure/table/halflife/metal/grate,
/obj/item/food/canned/halflife/beans{
	pixel_x = -1;
	pixel_y = 7
	},
/turf/open/floor/plating/indoor/concrete/bricks,
/area/halflife/indoors/bunker)
"uM" = (
/obj/structure/halflife/road_barrier/concrete{
	dir = 8
	},
/turf/open/floor/plating/indoor/concrete/bricks,
/area/halflife/indoors/bunker)
"wk" = (
/obj/effect/spawner/random/entertainment/arcade,
/turf/open/floor/plating/indoor/concrete/small,
/area/halflife/indoors/bunker)
"wl" = (
/obj/structure/halflife/trash/garbage{
	pixel_x = -3;
	pixel_y = -2
	},
/turf/open/floor/plating/indoor/concrete/bricks,
/area/halflife/indoors/bunker)
"xu" = (
/turf/closed/indestructible/rock,
/area/template_noop)
"yh" = (
/obj/structure/halflife/pipes/horizontal,
/turf/open/halflife/water/medium,
/area/halflife/indoors/bunker)
"zc" = (
/obj/structure/table/halflife/metal/grate,
/turf/open/floor/plating/indoor/concrete/small,
/area/halflife/indoors/bunker)
"zy" = (
/obj/structure/halflife/trash/garbage{
	pixel_x = -16;
	pixel_y = -4
	},
/turf/open/floor/plating/indoor/concrete/bricks,
/area/halflife/indoors/bunker)
"zz" = (
/obj/item/reagent_containers/cup/glass/waterbottle/large{
	pixel_x = -9;
	pixel_y = 18
	},
/obj/item/reagent_containers/cup/glass/waterbottle/large{
	pixel_x = 7;
	pixel_y = 13
	},
/turf/open/floor/plating/indoor/concrete/bricks,
/area/halflife/indoors/bunker)
"zC" = (
/obj/item/pushbroom{
	pixel_y = 2
	},
/obj/item/reagent_containers/spray/cleaner{
	pixel_y = 17
	},
/turf/open/floor/plating/indoor/concrete/bricks,
/area/halflife/indoors/bunker)
"zP" = (
/obj/structure/halflife/trash/garbage{
	pixel_x = 2;
	pixel_y = 17
	},
/turf/open/floor/plating/indoor/concrete/bricks,
/area/halflife/indoors/bunker)
"Al" = (
/obj/item/reagent_containers/cup/glass/waterbottle/large/empty{
	pixel_x = 8;
	pixel_y = 10
	},
/obj/structure/table/halflife/metal/grate,
/obj/item/paper_bin{
	pixel_x = -7;
	pixel_y = 7
	},
/turf/open/floor/plating/indoor/concrete/small,
/area/halflife/indoors/bunker)
"AL" = (
/obj/item/reagent_containers/cup/glass/bottle/vodka{
	pixel_x = 5;
	pixel_y = 10
	},
/obj/machinery/status_display/evac/directional/east,
/turf/open/floor/plating/indoor/concrete/bricks,
/area/halflife/indoors/bunker)
"Bj" = (
/turf/open/floor/plating/indoor/concrete/bricks,
/area/halflife/indoors/bunker)
"Bk" = (
/turf/open/halflife/water/medium,
/area/halflife/indoors/bunker)
"BG" = (
/obj/structure/halflife/pipes/vent,
/turf/open/floor/plating/indoor/concrete/bricks,
/area/halflife/indoors/bunker)
"Ci" = (
/obj/item/stack/medical/bandage{
	pixel_x = -8;
	pixel_y = 11
	},
/turf/open/floor/plating/indoor/concrete/bricks,
/area/halflife/indoors/bunker)
"CZ" = (
/obj/machinery/light/small/directional/west,
/turf/open/floor/plating/indoor/concrete/bricks,
/area/halflife/indoors/bunker)
"DE" = (
/obj/structure/table/halflife/metal/grate,
/obj/item/food/canned/halflife/beans{
	pixel_x = -9;
	pixel_y = 13
	},
/obj/item/paper/crumpled{
	pixel_x = 4;
	pixel_y = 0;
	default_raw_text = "I rigged this grenade to go off almost immediately after I pull the pin. Combine can't take me alive now."
	},
/obj/item/grenade/syndieminibomb/bouncer{
	name = "modified MK3A2 grenade";
	desc = "A heavily-modified MK3A2 grenade. You can see most of the electronic timer has been utterly busted, and will go off almost immediately after the pin is pulled. Better to die free.";
	det_time = 1;
	possible_fuse_time = list("Instant");
	pixel_x = 14;
	pixel_y = 16
	},
/turf/open/floor/plating/indoor/concrete/bricks,
/area/halflife/indoors/bunker)
"DV" = (
/turf/closed/wall/halflife/concrete,
/area/halflife/indoors/bunker)
"Fc" = (
/obj/structure/halflife/pipes/horizontal/end,
/turf/open/floor/plating/indoor/concrete/bricks,
/area/halflife/indoors/bunker)
"Fg" = (
/obj/structure/chair/office/halflife/blue,
/obj/machinery/light/small/directional/east,
/turf/open/floor/plating/indoor/concrete/bricks,
/area/halflife/indoors/bunker)
"Fv" = (
/obj/structure/halflife/pipes/horizontal,
/obj/structure/table/halflife/no_smooth/large/metal/desk/alt,
/obj/item/clothing/mask/gas/hl2/military{
	pixel_x = -2;
	pixel_y = 12
	},
/obj/item/ammo_box/magazine/service{
	pixel_x = 13;
	pixel_y = 5
	},
/turf/open/floor/plating/indoor/concrete/bricks,
/area/halflife/indoors/bunker)
"FT" = (
/obj/structure/halflife/pipes/horizontal/single,
/turf/open/halflife/water/medium,
/area/halflife/indoors/bunker)
"He" = (
/obj/structure/halflife/trash/cardboard{
	dir = 8;
	pixel_x = 1;
	pixel_y = -2
	},
/turf/open/floor/plating/indoor/concrete/bricks,
/area/halflife/indoors/bunker)
"Hg" = (
/obj/structure/halflife/toilet{
	pixel_y = 8
	},
/turf/open/floor/plating/indoor/lino,
/area/halflife/indoors/bunker)
"HJ" = (
/obj/machinery/light/small/red/dim/directional/west,
/obj/structure/reagent_dispensers/watertank,
/turf/open/floor/plating/indoor/concrete/bricks,
/area/halflife/indoors/bunker)
"Kf" = (
/obj/structure/table/halflife/no_smooth/large/metal/desk{
	dir = 1
	},
/obj/structure/halflife/trash/cardboard{
	dir = 4;
	pixel_x = 2;
	pixel_y = 12
	},
/obj/item/food/canned/halflife/crisps{
	pixel_x = -5;
	pixel_y = 23
	},
/obj/item/food/canned/halflife/crisps{
	pixel_x = 9;
	pixel_y = 21
	},
/obj/item/food/canned/halflife/seafood{
	pixel_x = -1;
	pixel_y = 15
	},
/obj/item/food/canned/halflife/seafood{
	pixel_x = 11;
	pixel_y = 13
	},
/turf/open/floor/plating/indoor/concrete/bricks,
/area/halflife/indoors/bunker)
"Kj" = (
/obj/structure/table/halflife/metal/grate,
/obj/machinery/computer/security/wooden_tv,
/turf/open/floor/plating/indoor/concrete/bricks,
/area/halflife/indoors/bunker)
"KG" = (
/obj/structure/halflife/trash/cardboard{
	dir = 10;
	pixel_x = -2;
	pixel_y = 7
	},
/turf/open/floor/plating/indoor/concrete/bricks,
/area/halflife/indoors/bunker)
"Mb" = (
/obj/structure/halflife/pipes/vent,
/obj/structure/table/halflife/metal/grate,
/obj/item/food/canned/halflife/seafood{
	pixel_x = -1;
	pixel_y = 15
	},
/turf/open/floor/plating/indoor/concrete/small,
/area/halflife/indoors/bunker)
"MR" = (
/obj/item/chair/halflife/metal/office/blue,
/turf/open/halflife/water/medium,
/area/halflife/indoors/bunker)
"Nu" = (
/obj/structure/table/halflife/metal/grate,
/obj/structure/halflife/trash/glass/cans{
	pixel_x = 7;
	pixel_y = 8
	},
/turf/open/floor/plating/indoor/concrete/bricks,
/area/halflife/indoors/bunker)
"NN" = (
/obj/item/restraints/legcuffs/beartrap{
	pixel_x = -6;
	pixel_y = 6
	},
/turf/open/floor/plating/indoor/concrete/bricks,
/area/halflife/indoors/bunker)
"Op" = (
/obj/structure/chair/office/halflife/blue{
	dir = 8
	},
/turf/open/floor/plating/indoor/concrete/small,
/area/halflife/indoors/bunker)
"Ps" = (
/obj/structure/table/halflife/metal/grate,
/obj/structure/halflife/trash/glass/plate{
	pixel_x = 0;
	pixel_y = 3
	},
/turf/open/floor/plating/indoor/concrete/bricks,
/area/halflife/indoors/bunker)
"Pv" = (
/obj/item/hl13_small_flag/poland,
/turf/open/floor/plating/indoor/concrete/bricks,
/area/halflife/indoors/bunker)
"PI" = (
/obj/structure/halflife/trash/books/pile,
/turf/open/floor/plating/indoor/concrete/bricks,
/area/halflife/indoors/bunker)
"PK" = (
/obj/structure/halflife/trash/garbage{
	pixel_x = -4;
	pixel_y = 18
	},
/turf/open/floor/plating/indoor/concrete/bricks,
/area/halflife/indoors/bunker)
"Qp" = (
/obj/machinery/light/small/broken/directional/west,
/obj/structure/halflife/trash/food/dinner,
/turf/open/floor/plating/indoor/concrete/bricks,
/area/halflife/indoors/bunker)
"Qt" = (
/obj/structure/halflife/pipes/horizontal/end{
	dir = 1
	},
/obj/structure/table/halflife/no_smooth/large/metal/desk,
/obj/structure/halflife/trash/cardboard{
	dir = 8;
	pixel_x = 2;
	pixel_y = 11
	},
/obj/item/light/bulb{
	pixel_x = 8;
	pixel_y = 7
	},
/turf/open/floor/plating/indoor/concrete/bricks,
/area/halflife/indoors/bunker)
"Qy" = (
/obj/structure/halflife/pipes/vent,
/obj/structure/halflife/trash/cardboard{
	dir = 4;
	pixel_y = 9
	},
/turf/open/floor/plating/indoor/concrete/bricks,
/area/halflife/indoors/bunker)
"QC" = (
/obj/structure/halflife/pipes/horizontal/random,
/obj/item/reagent_containers/condiment/sugar{
	pixel_x = -10;
	pixel_y = 13
	},
/obj/item/reagent_containers/condiment/flour{
	pixel_x = 2;
	pixel_y = 11
	},
/turf/open/floor/plating/indoor/concrete/bricks,
/area/halflife/indoors/bunker)
"Rf" = (
/obj/structure/halflife/trash/food/misc{
	pixel_x = -5;
	pixel_y = 6
	},
/turf/open/floor/plating/indoor/concrete/bricks,
/area/halflife/indoors/bunker)
"Rk" = (
/obj/machinery/door/unpowered/halflife/metal/red,
/obj/machinery/door/poddoor/shutters{
	id = "commsentrance"
	},
/turf/open/floor/plating/indoor/concrete/bricks,
/area/halflife/indoors/bunker)
"Rp" = (
/obj/structure/halflife/trash/garbage{
	pixel_x = -2;
	pixel_y = -3
	},
/obj/structure/halflife/trash/garbage{
	pixel_x = 7;
	pixel_y = 3
	},
/turf/open/floor/plating/indoor/concrete/bricks,
/area/halflife/indoors/bunker)
"Rz" = (
/obj/structure/halflife/trash/books/pile_alt,
/turf/open/floor/plating/indoor/concrete/bricks,
/area/halflife/indoors/bunker)
"RD" = (
/obj/item/hl13_small_flag/poland{
	pixel_x = 7;
	pixel_y = 26
	},
/turf/open/floor/plating/indoor/concrete/bricks,
/area/halflife/indoors/bunker)
"Sg" = (
/obj/structure/halflife/pipes/vent,
/obj/machinery/computer/security/wooden_tv{
	dir = 4
	},
/obj/structure/table/halflife/metal,
/turf/open/floor/plating/indoor/concrete/small,
/area/halflife/indoors/bunker)
"TM" = (
/obj/item/chair/halflife/metal/office/blue,
/turf/open/floor/plating/indoor/concrete/bricks,
/area/halflife/indoors/bunker)
"TU" = (
/obj/machinery/light/small/directional/north,
/turf/open/floor/plating/indoor/lino,
/area/halflife/indoors/bunker)
"TX" = (
/obj/machinery/light/small/broken/directional/east,
/turf/open/halflife/water/medium,
/area/halflife/indoors/bunker)
"UJ" = (
/obj/effect/spawner/random/halflife/loot/crafting_bench,
/obj/structure/halflife/pipes/horizontal,
/turf/open/floor/plating/indoor/concrete/bricks,
/area/halflife/indoors/bunker)
"UP" = (
/obj/machinery/door/unpowered/halflife/metal/red{
	dir = 8
	},
/turf/open/floor/plating/indoor/concrete/bricks,
/area/halflife/indoors/bunker)
"UQ" = (
/obj/machinery/light/small/directional/east,
/turf/open/floor/plating/indoor/concrete/bricks,
/area/halflife/indoors/bunker)
"VM" = (
/obj/structure/table/halflife/no_smooth/large/metal/desk{
	dir = 1
	},
/turf/open/floor/plating/indoor/concrete/bricks,
/area/halflife/indoors/bunker)
"WP" = (
/obj/structure/halflife/trash/papers/one{
	dir = 8;
	pixel_x = -2;
	pixel_y = -4
	},
/obj/item/reagent_containers/cup/glass/waterbottle/large/empty{
	pixel_x = 8;
	pixel_y = 12
	},
/turf/open/floor/plating/indoor/concrete/bricks,
/area/halflife/indoors/bunker)
"WU" = (
/obj/machinery/light/small/directional/south,
/obj/structure/halflife/trash/garbage{
	pixel_x = 8;
	pixel_y = -5
	},
/turf/open/floor/plating/indoor/concrete/bricks,
/area/halflife/indoors/bunker)
"Xe" = (
/obj/structure/table/halflife/metal/grate,
/obj/item/food/canned/halflife/crisps{
	pixel_x = -5;
	pixel_y = 9
	},
/obj/item/reagent_containers/pill/patch/medkit/vial{
	pixel_x = 8;
	pixel_y = 8
	},
/turf/open/floor/plating/indoor/concrete/bricks,
/area/halflife/indoors/bunker)
"Xr" = (
/obj/machinery/door/unpowered/halflife/metal/red{
	dir = 8;
	keylock = 1;
	locked = 1
	},
/turf/open/floor/plating/indoor/concrete/bricks,
/area/halflife/indoors/bunker)
"Yz" = (
/obj/machinery/door/unpowered/halflife/metal/red,
/turf/open/floor/plating/indoor/concrete/small,
/area/halflife/indoors/bunker)
"YW" = (
/obj/structure/bed/halflife/bedframe/wire,
/obj/structure/bed/halflife/mattress/stale,
/obj/machinery/light/small/directional/north,
/turf/open/floor/plating/indoor/concrete/bricks,
/area/halflife/indoors/bunker)
"Zg" = (
/obj/structure/halflife/pipes/horizontal/end,
/obj/item/stack/sheet/mineral/sandbags{
	amount = 5
	},
/turf/open/floor/plating/indoor/concrete/bricks,
/area/halflife/indoors/bunker)
"Zx" = (
/obj/structure/halflife/trash/cardboard,
/turf/open/floor/plating/indoor/concrete/bricks,
/area/halflife/indoors/bunker)
"ZJ" = (
/obj/item/reagent_containers/cup/glass/waterbottle/large/empty{
	pixel_x = -11;
	pixel_y = 14
	},
/turf/open/floor/plating/indoor/concrete/bricks,
/area/halflife/indoors/bunker)
"ZY" = (
/turf/open/floor/plating/indoor/lino,
/area/halflife/indoors/bunker)

(1,1,1) = {"
uD
uD
uD
uD
uD
uD
uD
uD
uD
uD
uD
uD
uD
uD
uD
uD
uD
uD
uD
uD
rz
"}
(2,1,1) = {"
uD
aa
DV
DV
DV
DV
DV
DV
DV
DV
Xr
DV
DV
DV
DV
DV
DV
DV
DV
DV
uD
"}
(3,1,1) = {"
uD
DV
BG
Bj
PI
DV
Bj
Bj
DV
NN
Bj
wl
DV
Qt
Qp
Bk
oI
HJ
oC
DV
uD
"}
(4,1,1) = {"
uD
DV
cP
Bj
Bj
qU
Bj
Bj
Rk
Bj
Bj
aT
DV
QC
Bk
Bk
Bk
Bk
Rf
DV
uD
"}
(5,1,1) = {"
uD
DV
te
Rz
Bj
DV
Bj
Bj
DV
Bj
Bj
kn
DV
gr
Bk
Bk
Bk
Bk
Bk
DV
uD
"}
(6,1,1) = {"
uD
DV
DV
DV
DV
DV
mY
Bj
DV
DV
fo
DV
DV
FT
Bk
Bk
Bk
Bk
Bk
DV
uD
"}
(7,1,1) = {"
uD
DV
BG
Bj
Bj
DV
Bj
Bj
DV
Sg
gX
pO
DV
yh
Bk
Bk
Bk
fW
TM
DV
uD
"}
(8,1,1) = {"
uD
DV
YW
Bj
Bj
qU
Bj
Bj
Yz
nS
Op
nS
DV
Fv
MR
Bk
Bk
ZJ
Kf
DV
uD
"}
(9,1,1) = {"
uD
DV
te
Bj
Bj
DV
Bj
Bj
DV
nS
lq
Al
DV
Zg
TX
WP
Bj
mB
zz
DV
uD
"}
(10,1,1) = {"
uD
DV
DV
DV
DV
DV
BG
uM
DV
DV
DV
DV
DV
DV
DV
DV
UP
DV
DV
DV
uD
"}
(11,1,1) = {"
uD
DV
Mb
az
zc
DV
mY
Bj
Bj
Bj
CZ
Bj
qU
Bj
Bj
CZ
Bj
Bj
Rp
DV
uD
"}
(12,1,1) = {"
uD
Yz
nS
nS
nS
Yz
Bj
Bj
Bj
Bj
Bj
Bj
DV
zP
Bj
Bj
Bj
Bj
zy
DV
uD
"}
(13,1,1) = {"
uD
DV
sq
nS
sq
DV
DV
DV
DV
sp
DV
DV
DV
DV
DV
DV
sp
DV
DV
DV
uD
"}
(14,1,1) = {"
uD
DV
DV
jM
DV
DV
uG
KG
CZ
Bj
He
Xe
DV
Hg
ZY
DV
Bj
Bj
cv
DV
uD
"}
(15,1,1) = {"
uD
DV
wk
lj
nS
DV
DE
Bj
Bj
Bj
Bj
Nu
DV
TU
ZY
tK
Bj
Bj
zC
DV
uD
"}
(16,1,1) = {"
uD
DV
DV
DV
DV
DV
Kj
Bj
Bj
Bj
Bj
Ps
DV
pg
ZY
DV
BG
Bj
WU
DV
uD
"}
(17,1,1) = {"
uD
xu
DV
eb
dQ
DV
Qy
Bj
Bj
Bj
Bj
Pv
DV
DV
DV
DV
PK
Bj
ht
DV
uD
"}
(18,1,1) = {"
uD
xu
DV
UJ
Bj
qU
Bj
Bj
fG
Bj
Bj
Bj
DV
TU
ZY
tK
Bj
Bj
VM
DV
uD
"}
(19,1,1) = {"
uD
xu
DV
Fc
kW
DV
RD
Fg
AL
Zx
UQ
Pv
DV
jv
ZY
DV
ki
Bj
Ci
DV
uD
"}
(20,1,1) = {"
uD
xu
DV
DV
DV
DV
DV
DV
DV
DV
DV
DV
DV
DV
DV
DV
DV
DV
DV
DV
uD
"}
(21,1,1) = {"
uD
uD
uD
uD
uD
uD
uD
uD
uD
uD
uD
uD
uD
uD
uD
uD
uD
uD
uD
uD
uD
"}
