//MAP CONVERTED BY dmm2tgm.py THIS HEADER COMMENT PREVENTS RECONVERSION, DO NOT REMOVE
"ab" = (
/obj/machinery/light/small/directional/north,
/turf/open/floor/plating/indoor/concrete/bricks,
/area/halflife/indoors/bunker)
"ag" = (
/obj/structure/table/halflife/no_smooth/large/metal/desk{
	dir = 1
	},
/obj/structure/halflife/trash/food/glass{
	pixel_x = 1;
	pixel_y = 11
	},
/turf/open/floor/plating/indoor/concrete/bricks,
/area/halflife/indoors/bunker)
"aM" = (
/mob/living/simple_animal/hostile/halflife/zombie/poison,
/turf/open/floor/plating/indoor/concrete/bricks,
/area/halflife/indoors/bunker)
"aT" = (
/obj/structure/table/halflife/no_smooth/wood/stand,
/turf/open/floor/plating/indoor/concrete/bricks,
/area/halflife/indoors/bunker)
"bZ" = (
/obj/structure/halflife/pipes/horizontal/end{
	dir = 1
	},
/obj/structure/table/halflife/no_smooth/large/metal/desk,
/obj/structure/halflife/trash/cardboard{
	dir = 8;
	pixel_x = 2;
	pixel_y = 11
	},
/obj/item/light/bulb{
	pixel_x = 16;
	pixel_y = 15
	},
/turf/open/floor/plating/indoor/concrete/bricks,
/area/halflife/indoors/bunker)
"cr" = (
/obj/structure/halflife/trash/garbage{
	pixel_x = 6;
	pixel_y = -3
	},
/turf/open/floor/plating/indoor/concrete/bricks,
/area/halflife/indoors/bunker)
"cw" = (
/obj/structure/table/halflife/no_smooth/large/metal/desk{
	dir = 1
	},
/turf/open/floor/plating/indoor/concrete/bricks,
/area/halflife/indoors/bunker)
"cz" = (
/obj/machinery/light/small/red/dim/directional/west,
/obj/structure/reagent_dispensers/watertank,
/turf/open/floor/plating/indoor/concrete/bricks,
/area/halflife/indoors/bunker)
"dB" = (
/obj/machinery/door/unpowered/halflife/metal/red,
/obj/machinery/door/poddoor/shutters{
	id = "commsentrance"
	},
/turf/open/floor/plating/indoor/concrete/bricks,
/area/halflife/indoors/bunker)
"ed" = (
/obj/structure/halflife/trash/papers/one{
	dir = 4
	},
/turf/open/floor/plating/indoor/concrete/bricks,
/area/halflife/indoors/bunker)
"eE" = (
/obj/structure/halflife/trash/garbage{
	pixel_x = -2;
	pixel_y = -3
	},
/obj/structure/halflife/trash/garbage{
	pixel_x = 7;
	pixel_y = 3
	},
/turf/open/floor/plating/indoor/concrete/bricks,
/area/halflife/indoors/bunker)
"eH" = (
/obj/structure/halflife/pipes/horizontal/random,
/obj/item/reagent_containers/condiment/sugar{
	pixel_x = -10;
	pixel_y = 13
	},
/obj/item/reagent_containers/condiment/flour{
	pixel_x = 2;
	pixel_y = 11
	},
/turf/open/floor/plating/indoor/concrete/bricks,
/area/halflife/indoors/bunker)
"gR" = (
/mob/living/basic/halflife/headcrab,
/turf/open/floor/plating/indoor/concrete/bricks,
/area/halflife/indoors/bunker)
"hd" = (
/obj/structure/table/halflife/metal/grate,
/obj/item/restraints/legcuffs/beartrap{
	pixel_x = 8;
	pixel_y = 11
	},
/obj/item/restraints/legcuffs/beartrap{
	pixel_x = -5;
	pixel_y = 8
	},
/obj/machinery/light/small/directional/west,
/turf/open/floor/plating/indoor/concrete/small,
/area/halflife/indoors/bunker)
"hB" = (
/obj/structure/halflife/trash/food/misc{
	pixel_x = -5;
	pixel_y = 6
	},
/turf/open/floor/plating/indoor/concrete/bricks,
/area/halflife/indoors/bunker)
"ik" = (
/obj/structure/table/halflife/no_smooth/large/metal/desk{
	dir = 1
	},
/obj/item/reagent_containers/cup/glass/waterbottle/large/empty{
	pixel_x = 7;
	pixel_y = 15
	},
/turf/open/floor/plating/indoor/concrete/bricks,
/area/halflife/indoors/bunker)
"iB" = (
/obj/machinery/door/unpowered/halflife/metal/red,
/turf/open/floor/plating/indoor/concrete/bricks,
/area/halflife/indoors/bunker)
"iL" = (
/obj/item/reagent_containers/cup/glass/waterbottle/large{
	pixel_x = -9;
	pixel_y = 18
	},
/obj/item/reagent_containers/cup/glass/waterbottle/large{
	pixel_x = 7;
	pixel_y = 13
	},
/turf/open/floor/plating/indoor/concrete/bricks,
/area/halflife/indoors/bunker)
"ky" = (
/mob/living/basic/halflife/zombie/zombine,
/turf/open/floor/plating/indoor/concrete/bricks,
/area/halflife/indoors/bunker)
"kC" = (
/obj/modular_map_connector,
/turf/template_noop,
/area/template_noop)
"ly" = (
/obj/structure/halflife/trash/garbage{
	pixel_x = 8;
	pixel_y = 8
	},
/obj/structure/halflife/trash/garbage{
	pixel_x = -4;
	pixel_y = 13
	},
/turf/open/floor/plating/indoor/concrete/bricks,
/area/halflife/indoors/bunker)
"mG" = (
/obj/item/hl13_small_flag/poland,
/turf/open/floor/plating/indoor/concrete/bricks,
/area/halflife/indoors/bunker)
"mV" = (
/obj/structure/halflife/pipes/vent,
/turf/open/floor/plating/indoor/concrete/bricks,
/area/halflife/indoors/bunker)
"nb" = (
/obj/structure/halflife/trash/cardboard,
/turf/open/floor/plating/indoor/concrete/bricks,
/area/halflife/indoors/bunker)
"nr" = (
/obj/structure/table/halflife/metal/grate,
/obj/item/grenade/syndieminibomb/bouncer{
	name = "modified MK3A2 grenade";
	desc = "A heavily-modified MK3A2 grenade. You can see most of the electronic timer has been utterly busted, and will go off almost immediately after the pin is pulled. Better to die free.";
	det_time = 1;
	possible_fuse_time = list("Instant");
	pixel_x = 6;
	pixel_y = 10
	},
/obj/item/paper/crumpled{
	pixel_x = -6;
	pixel_y = 9;
	default_raw_text = "I rigged this grenade to go off almost immediately after I pull the pin. Combine can't take me alive now."
	},
/turf/open/floor/plating/indoor/concrete/bricks,
/area/halflife/indoors/bunker)
"pR" = (
/obj/item/reagent_containers/cup/glass/bottle/vodka{
	pixel_x = 5;
	pixel_y = 10
	},
/turf/open/floor/plating/indoor/concrete/bricks,
/area/halflife/indoors/bunker)
"pT" = (
/obj/machinery/door/poddoor/shutters/window{
	id = "commsentrance"
	},
/obj/structure/window/fulltile,
/turf/open/floor/plating/indoor/concrete/bricks,
/area/halflife/indoors/bunker)
"pX" = (
/obj/machinery/door/unpowered/halflife/metal/red{
	dir = 8
	},
/turf/open/floor/plating/indoor/concrete/bricks,
/area/halflife/indoors/bunker)
"qz" = (
/obj/structure/table/halflife/no_smooth/large/metal/desk{
	dir = 1
	},
/obj/structure/halflife/trash/cardboard{
	dir = 4;
	pixel_x = 2;
	pixel_y = 12
	},
/obj/item/food/canned/halflife/crisps{
	pixel_x = -5;
	pixel_y = 23
	},
/obj/item/food/canned/halflife/crisps{
	pixel_x = 9;
	pixel_y = 21
	},
/obj/item/food/canned/halflife/seafood{
	pixel_x = -1;
	pixel_y = 15
	},
/obj/item/food/canned/halflife/seafood{
	pixel_x = 11;
	pixel_y = 13
	},
/turf/open/floor/plating/indoor/concrete/bricks,
/area/halflife/indoors/bunker)
"rn" = (
/obj/structure/bed/halflife/bedframe/wire,
/obj/structure/bed/halflife/mattress/old,
/obj/machinery/light/small/directional/north,
/turf/open/floor/plating/indoor/concrete/bricks,
/area/halflife/indoors/bunker)
"so" = (
/obj/machinery/button/door{
	id = "commsentrance"
	},
/turf/open/floor/plating/indoor/concrete/small,
/area/halflife/indoors/bunker)
"sp" = (
/obj/machinery/light/small/directional/south,
/obj/item/restraints/legcuffs/beartrap{
	pixel_x = 8;
	pixel_y = 10
	},
/turf/open/floor/plating/indoor/concrete/bricks,
/area/halflife/indoors/bunker)
"sG" = (
/obj/item/pushbroom{
	pixel_y = 2
	},
/obj/item/reagent_containers/spray/cleaner{
	pixel_y = 17
	},
/turf/open/floor/plating/indoor/concrete/bricks,
/area/halflife/indoors/bunker)
"sP" = (
/obj/item/chair/halflife/metal/office/blue,
/turf/open/halflife/water/medium,
/area/halflife/indoors/bunker)
"tI" = (
/obj/machinery/light/small/broken/directional/west,
/obj/structure/halflife/trash/food/dinner,
/turf/open/floor/plating/indoor/concrete/bricks,
/area/halflife/indoors/bunker)
"uu" = (
/obj/machinery/light/small/directional/east,
/mob/living/basic/halflife/headcrab/poison,
/turf/open/floor/plating/indoor/concrete/bricks,
/area/halflife/indoors/bunker)
"uN" = (
/obj/structure/halflife/trash/garbage{
	pixel_x = -3;
	pixel_y = -2
	},
/turf/open/floor/plating/indoor/concrete/bricks,
/area/halflife/indoors/bunker)
"uQ" = (
/obj/effect/spawner/random/halflife/loot/crafting_bench,
/turf/open/floor/plating/indoor/concrete/bricks,
/area/halflife/indoors/bunker)
"uV" = (
/obj/item/stack/medical/bandage{
	pixel_x = -8;
	pixel_y = 11
	},
/turf/open/floor/plating/indoor/concrete/bricks,
/area/halflife/indoors/bunker)
"ws" = (
/obj/structure/table/halflife/metal/grate,
/obj/structure/halflife/trash/glass/cans{
	pixel_x = 7;
	pixel_y = 8
	},
/turf/open/floor/plating/indoor/concrete/bricks,
/area/halflife/indoors/bunker)
"wz" = (
/obj/machinery/door/unpowered/halflife/metal/red,
/turf/open/floor/plating/indoor/lino,
/area/halflife/indoors/bunker)
"Ai" = (
/obj/structure/halflife/trash/papers/one{
	dir = 8;
	pixel_x = -2;
	pixel_y = -4
	},
/obj/item/reagent_containers/cup/glass/waterbottle/large/empty{
	pixel_x = 8;
	pixel_y = 12
	},
/turf/open/floor/plating/indoor/concrete/bricks,
/area/halflife/indoors/bunker)
"BO" = (
/obj/structure/table/halflife/metal/grate,
/obj/item/reagent_containers/condiment/peanut_butter{
	pixel_x = -7;
	pixel_y = 15
	},
/obj/item/reagent_containers/condiment/peanut_butter{
	pixel_x = 8;
	pixel_y = 18
	},
/obj/item/reagent_containers/condiment/protein{
	pixel_x = 2;
	pixel_y = 8
	},
/turf/open/floor/plating/indoor/concrete/bricks,
/area/halflife/indoors/bunker)
"CC" = (
/obj/structure/halflife/trash/cardboard{
	dir = 8
	},
/turf/open/floor/plating/indoor/concrete/bricks,
/area/halflife/indoors/bunker)
"Dj" = (
/obj/machinery/light/small/directional/east,
/turf/open/floor/plating/indoor/concrete/bricks,
/area/halflife/indoors/bunker)
"Dz" = (
/obj/machinery/door/unpowered/halflife/metal/red{
	dir = 4
	},
/turf/open/floor/plating/indoor/concrete/small,
/area/halflife/indoors/bunker)
"DB" = (
/turf/closed/wall/halflife/concrete,
/area/halflife/indoors/bunker)
"Fb" = (
/turf/open/floor/plating/indoor/concrete/small,
/area/halflife/indoors/bunker)
"Gd" = (
/obj/machinery/door/unpowered/halflife/metal/red{
	dir = 8;
	keylock = 1;
	locked = 1
	},
/turf/open/floor/plating/indoor/concrete/bricks,
/area/halflife/indoors/bunker)
"Gn" = (
/turf/open/floor/plating/indoor/lino,
/area/halflife/indoors/bunker)
"Gq" = (
/obj/structure/halflife/pipes/horizontal/end,
/obj/item/stack/sheet/mineral/sandbags{
	amount = 5
	},
/turf/open/floor/plating/indoor/concrete/bricks,
/area/halflife/indoors/bunker)
"Gx" = (
/obj/structure/table/halflife/metal/grate,
/obj/item/food/canned/halflife/crisps{
	pixel_x = -5;
	pixel_y = 9
	},
/turf/open/floor/plating/indoor/concrete/bricks,
/area/halflife/indoors/bunker)
"Hj" = (
/obj/structure/halflife/tank,
/turf/open/floor/plating/indoor/concrete/small,
/area/halflife/indoors/bunker)
"IB" = (
/obj/machinery/door/unpowered/halflife/metal/red{
	dir = 4
	},
/turf/open/floor/plating/indoor/concrete/bricks,
/area/halflife/indoors/bunker)
"IJ" = (
/obj/structure/table/halflife/metal/grate,
/obj/item/reagent_containers/condiment/cherryjelly{
	pixel_x = 6;
	pixel_y = 13
	},
/turf/open/floor/plating/indoor/concrete/small,
/area/halflife/indoors/bunker)
"Jw" = (
/obj/structure/halflife/trash/books/pile,
/turf/open/floor/plating/indoor/concrete/bricks,
/area/halflife/indoors/bunker)
"JJ" = (
/obj/structure/halflife/road_barrier/concrete{
	dir = 8
	},
/turf/open/floor/plating/indoor/concrete/bricks,
/area/halflife/indoors/bunker)
"JN" = (
/obj/structure/chair/office/halflife/blue,
/obj/machinery/light/small/directional/east,
/turf/open/floor/plating/indoor/concrete/bricks,
/area/halflife/indoors/bunker)
"JP" = (
/turf/template_noop,
/area/template_noop)
"Kl" = (
/obj/structure/halflife/trash/garbage{
	pixel_x = 2;
	pixel_y = 17
	},
/turf/open/floor/plating/indoor/concrete/bricks,
/area/halflife/indoors/bunker)
"Kq" = (
/obj/effect/spawner/random/entertainment/arcade,
/turf/open/floor/plating/indoor/concrete/small,
/area/halflife/indoors/bunker)
"Kx" = (
/obj/machinery/shower/halflife{
	dir = 8
	},
/obj/structure/fluff/shower_drain,
/turf/open/floor/plating/indoor/lino,
/area/halflife/indoors/bunker)
"KB" = (
/mob/living/basic/halflife/zombie/fast,
/turf/open/halflife/water/medium,
/area/halflife/indoors/bunker)
"KT" = (
/obj/structure/halflife/trash/cardboard{
	dir = 10
	},
/turf/open/floor/plating/indoor/concrete/bricks,
/area/halflife/indoors/bunker)
"Lm" = (
/obj/item/restraints/legcuffs/beartrap{
	pixel_x = -6;
	pixel_y = 6
	},
/turf/open/floor/plating/indoor/concrete/bricks,
/area/halflife/indoors/bunker)
"Lp" = (
/obj/structure/halflife/trash/books/pile_alt,
/turf/open/floor/plating/indoor/concrete/bricks,
/area/halflife/indoors/bunker)
"My" = (
/obj/machinery/light/small/broken/directional/east,
/obj/item/reagent_containers/condiment/vegetable_oil{
	pixel_x = 4;
	pixel_y = 8
	},
/turf/open/floor/plating/indoor/concrete/bricks,
/area/halflife/indoors/bunker)
"MZ" = (
/obj/structure/table/halflife/no_smooth/large/metal/desk{
	dir = 8
	},
/obj/structure/halflife/trash/glass/basic{
	pixel_x = 0;
	pixel_y = 10
	},
/turf/open/floor/plating/indoor/concrete/small,
/area/halflife/indoors/bunker)
"Na" = (
/obj/structure/chair/office/halflife/blue{
	dir = 8
	},
/turf/open/floor/plating/indoor/concrete/small,
/area/halflife/indoors/bunker)
"ND" = (
/obj/structure/halflife/pipes/horizontal,
/obj/structure/table/halflife/no_smooth/large/metal/desk/alt,
/obj/item/clothing/mask/gas/hl2/military{
	pixel_x = -2;
	pixel_y = 12
	},
/obj/item/ammo_box/magazine/m4a1/service{
	pixel_x = 13;
	pixel_y = 5
	},
/turf/open/floor/plating/indoor/concrete/bricks,
/area/halflife/indoors/bunker)
"NH" = (
/obj/structure/halflife/pipes/horizontal/single,
/turf/open/halflife/water/medium,
/area/halflife/indoors/bunker)
"NM" = (
/obj/structure/halflife/toilet{
	pixel_y = 8
	},
/turf/open/floor/plating/indoor/lino,
/area/halflife/indoors/bunker)
"NN" = (
/obj/structure/bed/halflife/bedframe/wire,
/obj/structure/bed/halflife/mattress/stale,
/obj/machinery/light/small/directional/north,
/turf/open/floor/plating/indoor/concrete/bricks,
/area/halflife/indoors/bunker)
"Ok" = (
/obj/structure/table/halflife/no_smooth/large/metal/desk{
	dir = 1
	},
/obj/item/storage/fancy/cigarettes/halflife{
	pixel_x = 15;
	pixel_y = 12
	},
/obj/item/storage/box/matches{
	pixel_x = -1;
	pixel_y = 10
	},
/turf/open/floor/plating/indoor/concrete/bricks,
/area/halflife/indoors/bunker)
"OM" = (
/obj/structure/halflife/trash/cardboard,
/obj/item/reagent_containers/cup/glass/mouthwash{
	pixel_x = 4;
	pixel_y = 26
	},
/obj/item/reagent_containers/cup/glass/mouthwash{
	pixel_x = 16;
	pixel_y = 25
	},
/obj/item/reagent_containers/cup/glass/mouthwash{
	pixel_x = -9;
	pixel_y = 23
	},
/turf/open/floor/plating/indoor/concrete/bricks,
/area/halflife/indoors/bunker)
"PA" = (
/obj/structure/halflife/pipes/horizontal,
/turf/open/halflife/water/medium,
/area/halflife/indoors/bunker)
"PK" = (
/obj/structure/table/halflife/metal/grate,
/obj/item/food/canned/halflife/beans{
	pixel_x = -9;
	pixel_y = 13
	},
/turf/open/floor/plating/indoor/concrete/bricks,
/area/halflife/indoors/bunker)
"PP" = (
/obj/structure/halflife/trash/garbage{
	pixel_x = -14;
	pixel_y = -4
	},
/turf/open/floor/plating/indoor/concrete/bricks,
/area/halflife/indoors/bunker)
"Qk" = (
/obj/structure/halflife/pipes/vent,
/turf/open/floor/plating/indoor/concrete/small,
/area/halflife/indoors/bunker)
"QI" = (
/obj/machinery/light/small/directional/north,
/turf/open/floor/plating/indoor/lino,
/area/halflife/indoors/bunker)
"QZ" = (
/turf/open/halflife/water/medium,
/area/halflife/indoors/bunker)
"Rt" = (
/obj/item/chair/halflife/metal/office/blue,
/turf/open/floor/plating/indoor/concrete/bricks,
/area/halflife/indoors/bunker)
"Sh" = (
/obj/structure/table/halflife/metal/grate,
/obj/structure/halflife/trash/glass/plate{
	pixel_x = 0;
	pixel_y = 3
	},
/turf/open/floor/plating/indoor/concrete/bricks,
/area/halflife/indoors/bunker)
"SR" = (
/obj/effect/baseturf_helper/halflife/underground,
/turf/closed/wall/halflife/concrete,
/area/halflife/indoors/bunker)
"Tc" = (
/obj/item/reagent_containers/cup/glass/waterbottle/large/empty{
	pixel_x = 8;
	pixel_y = 10
	},
/obj/structure/table/halflife/metal/grate,
/turf/open/floor/plating/indoor/concrete/small,
/area/halflife/indoors/bunker)
"UL" = (
/obj/structure/halflife/pipes/vent,
/obj/structure/halflife/trash/cardboard{
	dir = 4;
	pixel_y = 9
	},
/turf/open/floor/plating/indoor/concrete/bricks,
/area/halflife/indoors/bunker)
"Vc" = (
/obj/machinery/light/small/broken/directional/east,
/turf/open/halflife/water/medium,
/area/halflife/indoors/bunker)
"VG" = (
/obj/machinery/light/small/directional/west,
/turf/open/floor/plating/indoor/concrete/bricks,
/area/halflife/indoors/bunker)
"VK" = (
/obj/structure/chair/office/halflife/blue/broken,
/obj/structure/halflife/trash/papers/three{
	dir = 8
	},
/turf/open/floor/plating/indoor/concrete/bricks,
/area/halflife/indoors/bunker)
"Wc" = (
/obj/structure/halflife/pipes/vent,
/obj/structure/table/halflife/metal/grate,
/obj/item/reagent_containers/condiment/honey{
	pixel_x = 9;
	pixel_y = -7
	},
/turf/open/floor/plating/indoor/concrete/small,
/area/halflife/indoors/bunker)
"Wr" = (
/obj/machinery/light/small/directional/east,
/turf/open/floor/plating/indoor/concrete/small,
/area/halflife/indoors/bunker)
"Wu" = (
/turf/closed/indestructible/rock,
/area/template_noop)
"WQ" = (
/obj/machinery/door/unpowered/halflife/metal/red,
/turf/open/floor/plating/indoor/concrete/small,
/area/halflife/indoors/bunker)
"XU" = (
/obj/item/reagent_containers/cup/glass/waterbottle/large/empty{
	pixel_x = -11;
	pixel_y = 14
	},
/turf/open/floor/plating/indoor/concrete/bricks,
/area/halflife/indoors/bunker)
"Yo" = (
/obj/structure/halflife/trash/garbage{
	pixel_x = -16;
	pixel_y = -4
	},
/turf/open/floor/plating/indoor/concrete/bricks,
/area/halflife/indoors/bunker)
"YO" = (
/obj/machinery/light/small/directional/south,
/obj/structure/halflife/trash/garbage{
	pixel_x = 8;
	pixel_y = -5
	},
/turf/open/floor/plating/indoor/concrete/bricks,
/area/halflife/indoors/bunker)
"YX" = (
/obj/structure/sink/halflife{
	pixel_y = 8
	},
/obj/structure/mirror/halflife{
	pixel_y = 32
	},
/turf/open/floor/plating/indoor/lino,
/area/halflife/indoors/bunker)
"Ze" = (
/obj/structure/halflife/pipes/horizontal,
/obj/item/chair/halflife/metal/office/blue{
	dir = 1
	},
/turf/open/halflife/water/medium,
/area/halflife/indoors/bunker)
"Zq" = (
/turf/open/floor/plating/indoor/concrete/bricks,
/area/halflife/indoors/bunker)
"ZW" = (
/obj/structure/halflife/trash/garbage{
	pixel_x = -4;
	pixel_y = 18
	},
/turf/open/floor/plating/indoor/concrete/bricks,
/area/halflife/indoors/bunker)

(1,1,1) = {"
JP
JP
JP
JP
JP
JP
JP
JP
JP
JP
JP
JP
JP
JP
JP
JP
JP
JP
JP
JP
kC
"}
(2,1,1) = {"
JP
SR
DB
DB
DB
DB
DB
DB
DB
DB
Gd
DB
DB
DB
DB
DB
DB
DB
DB
DB
JP
"}
(3,1,1) = {"
JP
DB
mV
Zq
Jw
DB
Zq
Zq
DB
Lm
Zq
uN
DB
bZ
tI
QZ
VK
cz
ag
DB
JP
"}
(4,1,1) = {"
JP
DB
rn
Zq
Zq
iB
Zq
Zq
dB
Zq
Zq
sp
DB
eH
QZ
QZ
QZ
QZ
hB
DB
JP
"}
(5,1,1) = {"
JP
DB
aT
Lp
Zq
DB
Zq
Zq
DB
Zq
Zq
cr
DB
Ze
QZ
QZ
QZ
QZ
QZ
DB
JP
"}
(6,1,1) = {"
JP
DB
DB
DB
DB
DB
ab
Zq
DB
DB
pT
DB
DB
NH
QZ
KB
QZ
QZ
QZ
DB
JP
"}
(7,1,1) = {"
JP
DB
mV
Zq
Zq
DB
Zq
Zq
DB
Qk
so
MZ
DB
PA
QZ
QZ
QZ
ed
Rt
DB
JP
"}
(8,1,1) = {"
JP
DB
NN
Zq
Zq
iB
Zq
Zq
WQ
Fb
Na
Fb
DB
ND
sP
QZ
QZ
XU
qz
DB
JP
"}
(9,1,1) = {"
JP
DB
aT
Zq
Zq
DB
Zq
Zq
DB
Fb
Wr
Tc
DB
Gq
Vc
Ai
Zq
My
iL
DB
JP
"}
(10,1,1) = {"
JP
DB
DB
DB
DB
DB
mV
JJ
DB
DB
DB
DB
DB
DB
DB
DB
pX
DB
DB
DB
JP
"}
(11,1,1) = {"
JP
DB
Wc
hd
IJ
DB
ab
ky
Zq
Zq
VG
Zq
iB
Zq
Zq
VG
Zq
Zq
eE
DB
JP
"}
(12,1,1) = {"
JP
WQ
Fb
Fb
Fb
WQ
Zq
Zq
Zq
Zq
Zq
Zq
DB
Kl
Zq
Zq
Zq
Zq
Yo
DB
JP
"}
(13,1,1) = {"
JP
DB
Hj
Fb
Hj
DB
DB
DB
DB
IB
DB
DB
DB
DB
DB
DB
IB
DB
DB
DB
JP
"}
(14,1,1) = {"
JP
DB
DB
Dz
DB
DB
BO
KT
VG
Zq
Zq
Gx
DB
NM
Gn
DB
Zq
Zq
ik
DB
JP
"}
(15,1,1) = {"
JP
DB
Kq
Fb
Fb
DB
PK
Zq
Zq
Zq
Zq
ws
DB
QI
Gn
wz
Zq
Zq
sG
DB
JP
"}
(16,1,1) = {"
JP
DB
DB
DB
DB
DB
nr
Zq
Zq
aM
CC
Sh
DB
YX
Gn
DB
mV
Zq
YO
DB
JP
"}
(17,1,1) = {"
JP
Wu
DB
OM
Zq
DB
UL
Zq
Zq
Zq
Zq
mG
DB
DB
DB
DB
ZW
gR
PP
DB
JP
"}
(18,1,1) = {"
JP
Wu
DB
uQ
Zq
iB
Zq
Zq
Ok
Zq
Zq
Zq
DB
QI
Gn
wz
Zq
Zq
cw
DB
JP
"}
(19,1,1) = {"
JP
Wu
DB
Zq
uu
DB
Zq
JN
pR
nb
Dj
mG
DB
Kx
Gn
DB
ly
Zq
uV
DB
JP
"}
(20,1,1) = {"
JP
Wu
DB
DB
DB
DB
DB
DB
DB
DB
DB
DB
DB
DB
DB
DB
DB
DB
DB
DB
JP
"}
(21,1,1) = {"
JP
JP
JP
JP
JP
JP
JP
JP
JP
JP
JP
JP
JP
JP
JP
JP
JP
JP
JP
JP
JP
"}
