//MAP CONVERTED BY dmm2tgm.py THIS HEADER COMMENT PREVENTS RECONVERSION, DO NOT REMOVE
"az" = (
/obj/structure/table/halflife/metal/grate,
/obj/item/restraints/legcuffs/beartrap,
/obj/item/restraints/legcuffs/beartrap,
/turf/open/floor/plating/indoor/concrete/small,
/area/halflife/indoors/bunker)
"aT" = (
/obj/machinery/light/small/directional/south,
/obj/item/restraints/legcuffs/beartrap,
/turf/open/floor/plating/indoor/concrete/bricks,
/area/halflife/indoors/bunker)
"cv" = (
/obj/structure/table/halflife/no_smooth/large/metal/desk{
	dir = 1
	},
/obj/item/reagent_containers/cup/glass/waterbottle/large/empty,
/turf/open/floor/plating/indoor/concrete/bricks,
/area/halflife/indoors/bunker)
"cP" = (
/obj/structure/bed/halflife/bedframe/wire,
/obj/structure/bed/halflife/mattress/old,
/obj/machinery/light/small/directional/north,
/obj/effect/mob_spawn/ghost_role/human/bunkeroperator,
/turf/open/floor/plating/indoor/concrete/bricks,
/area/halflife/indoors/bunker)
"eb" = (
/obj/structure/halflife/trash/cardboard,
/obj/item/reagent_containers/cup/glass/mouthwash,
/obj/item/reagent_containers/cup/glass/mouthwash,
/obj/item/reagent_containers/cup/glass/mouthwash,
/turf/open/floor/plating/indoor/concrete/bricks,
/area/halflife/indoors/bunker)
"fo" = (
/obj/machinery/door/poddoor/shutters/window{
	id = "commsentrance"
	},
/obj/structure/window/fulltile,
/turf/open/floor/plating/indoor/concrete/bricks,
/area/halflife/indoors/bunker)
"fr" = (
/obj/machinery/light/small/directional/north,
/turf/open/floor/plating/indoor/concrete/small,
/area/halflife/indoors/bunker)
"fG" = (
/obj/structure/table/halflife/no_smooth/large/metal/desk{
	dir = 1
	},
/obj/item/storage/fancy/cigarettes/halflife,
/obj/item/storage/box/matches,
/turf/open/floor/plating/indoor/concrete/bricks,
/area/halflife/indoors/bunker)
"fW" = (
/obj/structure/halflife/trash/papers/one{
	dir = 4
	},
/turf/open/floor/plating/indoor/concrete/bricks,
/area/halflife/indoors/bunker)
"gr" = (
/obj/structure/halflife/pipes/horizontal,
/obj/item/chair/halflife/metal/office/blue{
	dir = 1
	},
/turf/open/halflife/water/medium,
/area/halflife/indoors/bunker)
"gX" = (
/obj/machinery/button/door{
	id = "commsentrance"
	},
/turf/open/floor/plating/indoor/concrete/small,
/area/halflife/indoors/bunker)
"jv" = (
/obj/machinery/shower/halflife{
	dir = 8
	},
/obj/structure/fluff/shower_drain,
/turf/open/floor/plating/indoor/lino,
/area/halflife/indoors/bunker)
"lj" = (
/obj/machinery/light/small/directional/east,
/turf/open/floor/plating/indoor/concrete/small,
/area/halflife/indoors/bunker)
"lq" = (
/obj/structure/halflife/trash/cardboard{
	dir = 8
	},
/turf/open/floor/plating/indoor/concrete/bricks,
/area/halflife/indoors/bunker)
"mB" = (
/obj/machinery/light/small/broken/directional/east,
/obj/item/reagent_containers/condiment/vegetable_oil,
/turf/open/floor/plating/indoor/concrete/bricks,
/area/halflife/indoors/bunker)
"mY" = (
/obj/machinery/light/small/directional/north,
/turf/open/floor/plating/indoor/concrete/bricks,
/area/halflife/indoors/bunker)
"nS" = (
/turf/open/floor/plating/indoor/concrete/small,
/area/halflife/indoors/bunker)
"oC" = (
/obj/structure/table/halflife/no_smooth/large/metal/desk{
	dir = 1
	},
/obj/structure/halflife/trash/food/glass,
/turf/open/floor/plating/indoor/concrete/bricks,
/area/halflife/indoors/bunker)
"oI" = (
/obj/structure/chair/office/halflife/blue/broken,
/obj/structure/halflife/trash/papers/three{
	dir = 8
	},
/turf/open/floor/plating/indoor/concrete/bricks,
/area/halflife/indoors/bunker)
"pg" = (
/obj/structure/sink/halflife{
	pixel_y = 8
	},
/obj/structure/mirror/halflife{
	pixel_y = 32
	},
/turf/open/floor/plating/indoor/lino,
/area/halflife/indoors/bunker)
"pO" = (
/obj/structure/table/halflife/no_smooth/large/metal/desk{
	dir = 8
	},
/obj/structure/halflife/trash/glass/basic,
/turf/open/floor/plating/indoor/concrete/small,
/area/halflife/indoors/bunker)
"qU" = (
/obj/machinery/door/unpowered/halflife/metal/red,
/turf/open/floor/plating/indoor/concrete/bricks,
/area/halflife/indoors/bunker)
"rz" = (
/obj/modular_map_connector,
/turf/template_noop,
/area/template_noop)
"sp" = (
/obj/machinery/door/unpowered/halflife/metal/red{
	dir = 4
	},
/turf/open/floor/plating/indoor/concrete/bricks,
/area/halflife/indoors/bunker)
"sq" = (
/obj/structure/halflife/tank,
/turf/open/floor/plating/indoor/concrete/small,
/area/halflife/indoors/bunker)
"te" = (
/obj/structure/table/halflife/no_smooth/wood/stand,
/turf/open/floor/plating/indoor/concrete/bricks,
/area/halflife/indoors/bunker)
"tK" = (
/obj/machinery/door/unpowered/halflife/metal/red,
/turf/open/floor/plating/indoor/lino,
/area/halflife/indoors/bunker)
"uD" = (
/turf/template_noop,
/area/template_noop)
"uM" = (
/obj/structure/halflife/road_barrier/concrete{
	dir = 8
	},
/turf/open/floor/plating/indoor/concrete/bricks,
/area/halflife/indoors/bunker)
"xu" = (
/turf/closed/indestructible/rock,
/area/template_noop)
"yh" = (
/obj/structure/halflife/pipes/horizontal,
/turf/open/halflife/water/medium,
/area/halflife/indoors/bunker)
"zc" = (
/obj/structure/table/halflife/metal/grate,
/obj/item/reagent_containers/condiment/cherryjelly,
/turf/open/floor/plating/indoor/concrete/small,
/area/halflife/indoors/bunker)
"zz" = (
/obj/item/reagent_containers/cup/glass/waterbottle/large,
/obj/item/reagent_containers/cup/glass/waterbottle/large,
/turf/open/floor/plating/indoor/concrete/bricks,
/area/halflife/indoors/bunker)
"Al" = (
/obj/item/reagent_containers/cup/glass/waterbottle/large/empty,
/obj/structure/table/halflife/metal/grate,
/turf/open/floor/plating/indoor/concrete/small,
/area/halflife/indoors/bunker)
"AL" = (
/obj/item/reagent_containers/cup/glass/bottle/vodka,
/turf/open/floor/plating/indoor/concrete/bricks,
/area/halflife/indoors/bunker)
"Bj" = (
/turf/open/floor/plating/indoor/concrete/bricks,
/area/halflife/indoors/bunker)
"Bk" = (
/turf/open/halflife/water/medium,
/area/halflife/indoors/bunker)
"BG" = (
/obj/structure/halflife/pipes/vent,
/turf/open/floor/plating/indoor/concrete/bricks,
/area/halflife/indoors/bunker)
"Ci" = (
/obj/item/stack/medical/bandage,
/turf/open/floor/plating/indoor/concrete/bricks,
/area/halflife/indoors/bunker)
"CZ" = (
/obj/machinery/light/small/directional/west,
/turf/open/floor/plating/indoor/concrete/bricks,
/area/halflife/indoors/bunker)
"DE" = (
/obj/structure/table/halflife/metal/grate,
/obj/item/reagent_containers/condiment/peanut_butter,
/turf/open/floor/plating/indoor/concrete/bricks,
/area/halflife/indoors/bunker)
"DV" = (
/turf/closed/wall/halflife/concrete,
/area/halflife/indoors/bunker)
"Fg" = (
/obj/structure/chair/office/halflife/blue,
/obj/machinery/light/small/directional/east,
/turf/open/floor/plating/indoor/concrete/bricks,
/area/halflife/indoors/bunker)
"Fv" = (
/obj/structure/halflife/pipes/horizontal,
/obj/structure/table/halflife/no_smooth/large/metal/desk/alt,
/obj/item/clothing/mask/gas/hl2/military,
/obj/item/ammo_box/magazine/service,
/turf/open/floor/plating/indoor/concrete/bricks,
/area/halflife/indoors/bunker)
"FT" = (
/obj/structure/halflife/pipes/horizontal/single,
/turf/open/halflife/water/medium,
/area/halflife/indoors/bunker)
"Hg" = (
/obj/structure/halflife/toilet{
	pixel_y = 8
	},
/turf/open/floor/plating/indoor/lino,
/area/halflife/indoors/bunker)
"HJ" = (
/obj/machinery/light/small/red/dim/directional/west,
/obj/structure/reagent_dispensers/watertank,
/turf/open/floor/plating/indoor/concrete/bricks,
/area/halflife/indoors/bunker)
"Kf" = (
/obj/structure/table/halflife/no_smooth/large/metal/desk{
	dir = 1
	},
/obj/structure/halflife/trash/cardboard{
	dir = 4
	},
/obj/item/food/canned/peaches,
/obj/item/food/canned/peaches,
/obj/item/food/canned/tomatoes,
/obj/item/food/canned/tomatoes,
/turf/open/floor/plating/indoor/concrete/bricks,
/area/halflife/indoors/bunker)
"Kj" = (
/obj/structure/table/halflife/metal/grate,
/obj/item/reagent_containers/condiment/protein,
/turf/open/floor/plating/indoor/concrete/bricks,
/area/halflife/indoors/bunker)
"KG" = (
/obj/structure/halflife/trash/cardboard{
	dir = 10
	},
/turf/open/floor/plating/indoor/concrete/bricks,
/area/halflife/indoors/bunker)
"Mb" = (
/obj/structure/halflife/pipes/vent,
/obj/structure/table/halflife/metal/grate,
/obj/item/reagent_containers/condiment/honey,
/turf/open/floor/plating/indoor/concrete/small,
/area/halflife/indoors/bunker)
"MR" = (
/obj/item/chair/halflife/metal/office/blue,
/turf/open/halflife/water/medium,
/area/halflife/indoors/bunker)
"Nu" = (
/obj/structure/table/halflife/metal/grate,
/obj/structure/halflife/trash/glass/cans,
/turf/open/floor/plating/indoor/concrete/bricks,
/area/halflife/indoors/bunker)
"NN" = (
/obj/item/restraints/legcuffs/beartrap,
/turf/open/floor/plating/indoor/concrete/bricks,
/area/halflife/indoors/bunker)
"Op" = (
/obj/structure/chair/office/halflife/blue{
	dir = 8
	},
/turf/open/floor/plating/indoor/concrete/small,
/area/halflife/indoors/bunker)
"Ps" = (
/obj/structure/table/halflife/metal/grate,
/obj/structure/halflife/trash/glass/plate,
/turf/open/floor/plating/indoor/concrete/bricks,
/area/halflife/indoors/bunker)
"Pv" = (
/obj/item/hl13_small_flag/poland,
/turf/open/floor/plating/indoor/concrete/bricks,
/area/halflife/indoors/bunker)
"PI" = (
/obj/structure/halflife/trash/books/pile,
/turf/open/floor/plating/indoor/concrete/bricks,
/area/halflife/indoors/bunker)
"Qp" = (
/obj/machinery/light/small/broken/directional/west,
/obj/structure/halflife/trash/food/dinner,
/turf/open/floor/plating/indoor/concrete/bricks,
/area/halflife/indoors/bunker)
"Qt" = (
/obj/structure/halflife/pipes/horizontal/end{
	dir = 1
	},
/obj/structure/table/halflife/no_smooth/large/metal/desk,
/obj/structure/halflife/trash/cardboard{
	dir = 8
	},
/obj/item/light/bulb,
/turf/open/floor/plating/indoor/concrete/bricks,
/area/halflife/indoors/bunker)
"Qy" = (
/obj/structure/halflife/pipes/vent,
/obj/structure/halflife/trash/cardboard{
	dir = 4;
	pixel_y = 9
	},
/turf/open/floor/plating/indoor/concrete/bricks,
/area/halflife/indoors/bunker)
"QC" = (
/obj/structure/halflife/pipes/horizontal/random,
/obj/item/reagent_containers/condiment/sugar,
/obj/item/reagent_containers/condiment/flour,
/turf/open/floor/plating/indoor/concrete/bricks,
/area/halflife/indoors/bunker)
"Rf" = (
/obj/structure/halflife/trash/food/misc,
/turf/open/floor/plating/indoor/concrete/bricks,
/area/halflife/indoors/bunker)
"Rk" = (
/obj/machinery/door/unpowered/halflife/metal/red,
/obj/machinery/door/poddoor/shutters{
	id = "commsentrance"
	},
/turf/open/floor/plating/indoor/concrete/bricks,
/area/halflife/indoors/bunker)
"Rp" = (
/obj/structure/halflife/trash/garbage,
/turf/open/floor/plating/indoor/concrete/bricks,
/area/halflife/indoors/bunker)
"Rz" = (
/obj/structure/halflife/trash/books/pile_alt,
/turf/open/floor/plating/indoor/concrete/bricks,
/area/halflife/indoors/bunker)
"Sg" = (
/obj/structure/halflife/pipes/vent,
/turf/open/floor/plating/indoor/concrete/small,
/area/halflife/indoors/bunker)
"TM" = (
/obj/item/chair/halflife/metal/office/blue,
/turf/open/floor/plating/indoor/concrete/bricks,
/area/halflife/indoors/bunker)
"TU" = (
/obj/machinery/light/small/directional/north,
/turf/open/floor/plating/indoor/lino,
/area/halflife/indoors/bunker)
"TX" = (
/obj/machinery/light/small/broken/directional/east,
/turf/open/halflife/water/medium,
/area/halflife/indoors/bunker)
"UJ" = (
/obj/effect/spawner/random/halflife/loot/crafting_bench,
/turf/open/floor/plating/indoor/concrete/bricks,
/area/halflife/indoors/bunker)
"UP" = (
/obj/machinery/door/unpowered/halflife/metal/red{
	dir = 8
	},
/turf/open/floor/plating/indoor/concrete/bricks,
/area/halflife/indoors/bunker)
"UQ" = (
/obj/machinery/light/small/directional/east,
/turf/open/floor/plating/indoor/concrete/bricks,
/area/halflife/indoors/bunker)
"VM" = (
/obj/structure/table/halflife/no_smooth/large/metal/desk{
	dir = 1
	},
/turf/open/floor/plating/indoor/concrete/bricks,
/area/halflife/indoors/bunker)
"WP" = (
/obj/structure/halflife/trash/papers/one{
	dir = 8
	},
/obj/item/reagent_containers/cup/glass/waterbottle/large/empty,
/turf/open/floor/plating/indoor/concrete/bricks,
/area/halflife/indoors/bunker)
"WU" = (
/obj/machinery/light/small/directional/south,
/obj/structure/halflife/trash/garbage,
/turf/open/floor/plating/indoor/concrete/bricks,
/area/halflife/indoors/bunker)
"Xe" = (
/obj/structure/table/halflife/metal/grate,
/obj/item/food/canned/pine_nuts,
/turf/open/floor/plating/indoor/concrete/bricks,
/area/halflife/indoors/bunker)
"Xr" = (
/obj/machinery/door/unpowered/halflife/metal/red{
	dir = 8;
	keylock = 1;
	locked = 1
	},
/turf/open/floor/plating/indoor/concrete/bricks,
/area/halflife/indoors/bunker)
"Yz" = (
/obj/machinery/door/unpowered/halflife/metal/red,
/turf/open/floor/plating/indoor/concrete/small,
/area/halflife/indoors/bunker)
"YW" = (
/obj/structure/bed/halflife/bedframe/wire,
/obj/structure/bed/halflife/mattress/stale,
/obj/machinery/light/small/directional/north,
/turf/open/floor/plating/indoor/concrete/bricks,
/area/halflife/indoors/bunker)
"Zg" = (
/obj/structure/halflife/pipes/horizontal/end,
/obj/item/stack/sheet/mineral/sandbags{
	amount = 5
	},
/turf/open/floor/plating/indoor/concrete/bricks,
/area/halflife/indoors/bunker)
"Zx" = (
/obj/structure/halflife/trash/cardboard,
/turf/open/floor/plating/indoor/concrete/bricks,
/area/halflife/indoors/bunker)
"ZJ" = (
/obj/item/reagent_containers/cup/glass/waterbottle/large/empty,
/turf/open/floor/plating/indoor/concrete/bricks,
/area/halflife/indoors/bunker)
"ZY" = (
/turf/open/floor/plating/indoor/lino,
/area/halflife/indoors/bunker)

(1,1,1) = {"
uD
uD
uD
uD
uD
uD
uD
uD
uD
uD
uD
uD
uD
uD
uD
uD
uD
uD
uD
uD
rz
"}
(2,1,1) = {"
uD
DV
DV
DV
DV
DV
DV
DV
DV
DV
Xr
DV
DV
DV
DV
DV
DV
DV
DV
DV
uD
"}
(3,1,1) = {"
uD
DV
BG
Bj
PI
DV
Bj
Bj
DV
NN
Bj
Rp
DV
Qt
Qp
Bk
oI
HJ
oC
DV
uD
"}
(4,1,1) = {"
uD
DV
cP
Bj
Bj
qU
Bj
Bj
Rk
Bj
Bj
aT
DV
QC
Bk
Bk
Bk
Bk
Rf
DV
uD
"}
(5,1,1) = {"
uD
DV
te
Rz
Bj
DV
Bj
Bj
DV
Bj
Bj
Rp
DV
gr
Bk
Bk
Bk
Bk
Bk
DV
uD
"}
(6,1,1) = {"
uD
DV
DV
DV
DV
DV
mY
Bj
DV
DV
fo
DV
DV
FT
Bk
Bk
Bk
Bk
Bk
DV
uD
"}
(7,1,1) = {"
uD
DV
BG
Bj
Bj
DV
Bj
Bj
DV
Sg
gX
pO
DV
yh
Bk
Bk
Bk
fW
TM
DV
uD
"}
(8,1,1) = {"
uD
DV
YW
Bj
Bj
qU
Bj
Bj
Yz
nS
Op
nS
DV
Fv
MR
Bk
Bk
ZJ
Kf
DV
uD
"}
(9,1,1) = {"
uD
DV
te
Bj
Bj
DV
Bj
Bj
DV
nS
lj
Al
DV
Zg
TX
WP
Bj
mB
zz
DV
uD
"}
(10,1,1) = {"
uD
DV
DV
DV
DV
DV
BG
uM
DV
DV
DV
DV
DV
DV
DV
DV
UP
DV
DV
DV
uD
"}
(11,1,1) = {"
uD
DV
Mb
az
zc
DV
mY
Bj
Bj
Bj
CZ
Bj
qU
Bj
Bj
CZ
Bj
Rp
Rp
DV
uD
"}
(12,1,1) = {"
uD
DV
fr
nS
nS
Yz
Bj
Bj
Bj
Bj
Bj
Bj
DV
Rp
Bj
Bj
Bj
Bj
Rp
DV
uD
"}
(13,1,1) = {"
uD
DV
sq
nS
sq
DV
DV
DV
DV
sp
DV
DV
DV
DV
DV
DV
sp
DV
DV
DV
uD
"}
(14,1,1) = {"
uD
DV
DV
DV
DV
DV
DE
KG
CZ
Bj
Bj
Xe
DV
Hg
ZY
DV
Bj
Bj
cv
DV
uD
"}
(15,1,1) = {"
uD
xu
xu
xu
xu
DV
DE
Bj
Bj
Bj
Bj
Nu
DV
TU
ZY
tK
Bj
Bj
Bj
DV
uD
"}
(16,1,1) = {"
uD
xu
DV
DV
DV
DV
Kj
Bj
Bj
Bj
lq
Ps
DV
pg
ZY
DV
BG
Bj
WU
DV
uD
"}
(17,1,1) = {"
uD
xu
DV
eb
Bj
DV
Qy
Bj
Bj
Bj
Bj
Pv
DV
DV
DV
DV
Rp
Bj
Rp
DV
uD
"}
(18,1,1) = {"
uD
xu
DV
UJ
Bj
qU
Bj
Bj
fG
Bj
Bj
Bj
DV
TU
ZY
tK
Bj
Bj
VM
DV
uD
"}
(19,1,1) = {"
uD
xu
DV
Bj
UQ
DV
Bj
Fg
AL
Zx
UQ
Pv
DV
jv
ZY
DV
Rp
Rp
Ci
DV
uD
"}
(20,1,1) = {"
uD
xu
DV
DV
DV
DV
DV
DV
DV
DV
DV
DV
DV
DV
DV
DV
DV
DV
DV
DV
uD
"}
(21,1,1) = {"
uD
uD
uD
uD
uD
uD
uD
uD
uD
uD
uD
uD
uD
uD
uD
uD
uD
uD
uD
uD
uD
"}
