//MAP CONVERTED BY dmm2tgm.py THIS HEADER COMMENT PREVENTS RECONVERSION, DO NOT REMOVE
"al" = (
/obj/structure/halflife/trash/cardboard,
/turf/open/floor/plating/indoor/concrete/bricks,
/area/halflife/indoors/bunker)
"at" = (
/obj/structure/table/halflife/metal/grate,
/turf/open/floor/plating/indoor/concrete/small,
/area/halflife/indoors/bunker)
"bK" = (
/obj/item/hl13_small_flag/poland,
/turf/open/floor/plating/indoor/concrete/bricks,
/area/halflife/indoors/bunker)
"bV" = (
/obj/machinery/door/unpowered/halflife/metal/red{
	dir = 8;
	keylock = 1;
	locked = 1
	},
/turf/open/floor/plating/indoor/concrete/bricks,
/area/halflife/indoors/bunker)
"ch" = (
/obj/structure/table/halflife/no_smooth/wood/stand,
/obj/structure/halflife/trash/books{
	pixel_x = -1;
	pixel_y = 6
	},
/turf/open/floor/plating/indoor/concrete/bricks,
/area/halflife/indoors/bunker)
"eV" = (
/turf/closed/indestructible/rock,
/area/template_noop)
"fQ" = (
/obj/structure/halflife/trash/garbage{
	pixel_x = -3;
	pixel_y = -2
	},
/turf/open/floor/plating/indoor/concrete/bricks,
/area/halflife/indoors/bunker)
"gc" = (
/obj/item/pushbroom{
	pixel_y = 2
	},
/obj/item/reagent_containers/spray/cleaner{
	pixel_y = 17
	},
/turf/open/floor/plating/indoor/concrete/bricks,
/area/halflife/indoors/bunker)
"gU" = (
/obj/structure/halflife/pipes/vent,
/obj/item/radio/intercom/bunker/comms{
	pixel_x = -32
	},
/turf/open/floor/plating/indoor/concrete/small,
/area/halflife/indoors/bunker)
"iF" = (
/obj/structure/halflife/trash/garbage{
	pixel_x = -16;
	pixel_y = -4
	},
/turf/open/floor/plating/indoor/concrete/bricks,
/area/halflife/indoors/bunker)
"iZ" = (
/obj/item/clothing/mask/gas/hl2/military{
	pixel_x = 4;
	pixel_y = -3;
	name = "dirty old gas mask";
	desc = "An old gas mask that smells utterly horrible. The filters should hold up, assuming you don't get a disease from it."
	},
/turf/open/halflife/water/sewer/shallow,
/area/halflife/indoors/bunker)
"jF" = (
/obj/machinery/door/unpowered/halflife/metal/red,
/turf/open/floor/plating/indoor/lino,
/area/halflife/indoors/bunker)
"jI" = (
/obj/structure/chair/office/halflife/blue/broken,
/obj/structure/halflife/trash/papers/three{
	dir = 8
	},
/turf/open/floor/plating/indoor/concrete/bricks,
/area/halflife/indoors/bunker)
"jT" = (
/obj/machinery/light/small/directional/east,
/turf/open/floor/plating/indoor/concrete/small,
/area/halflife/indoors/bunker)
"kI" = (
/obj/effect/spawner/random/halflife/loot/crafting_bench,
/turf/open/floor/plating/indoor/concrete/bricks,
/area/halflife/indoors/bunker)
"kK" = (
/turf/open/floor/plating/indoor/concrete/bricks,
/area/halflife/indoors/bunker)
"kY" = (
/obj/machinery/door/poddoor/shutters/window{
	id = "commsentrance"
	},
/obj/structure/window/fulltile,
/turf/open/floor/plating/indoor/concrete/bricks,
/area/halflife/indoors/bunker)
"lP" = (
/obj/structure/halflife/trash/papers/one{
	dir = 4
	},
/turf/open/floor/plating/indoor/concrete/bricks,
/area/halflife/indoors/bunker)
"lV" = (
/obj/structure/halflife/pipes/horizontal,
/obj/structure/table/halflife/no_smooth/large/metal/desk/alt,
/turf/open/floor/plating/indoor/concrete/bricks,
/area/halflife/indoors/bunker)
"mb" = (
/turf/closed/wall/halflife/concrete,
/area/halflife/indoors/bunker)
"mt" = (
/obj/modular_map_connector,
/turf/template_noop,
/area/template_noop)
"pb" = (
/obj/structure/table/halflife/no_smooth/large/metal/desk{
	dir = 1
	},
/obj/item/storage/fancy/cigarettes/halflife{
	pixel_x = 15;
	pixel_y = 12
	},
/obj/item/storage/box/matches{
	pixel_x = -1;
	pixel_y = 10
	},
/turf/open/floor/plating/indoor/concrete/bricks,
/area/halflife/indoors/bunker)
"pi" = (
/obj/structure/halflife/pipes/vent,
/turf/open/floor/plating/indoor/concrete/bricks,
/area/halflife/indoors/bunker)
"pj" = (
/obj/structure/halflife/trash/garbage{
	pixel_x = 6;
	pixel_y = -3
	},
/turf/open/floor/plating/indoor/concrete/bricks,
/area/halflife/indoors/bunker)
"pl" = (
/obj/machinery/light/small/broken/directional/east,
/turf/open/floor/plating/indoor/concrete/bricks,
/area/halflife/indoors/bunker)
"qI" = (
/obj/machinery/light/small/directional/east,
/turf/open/floor/plating/indoor/concrete/bricks,
/area/halflife/indoors/bunker)
"rv" = (
/obj/structure/halflife/pipes/vent,
/obj/structure/table/halflife/metal/grate,
/obj/item/food/canned/halflife/seafood{
	pixel_x = 0;
	pixel_y = 7
	},
/turf/open/floor/plating/indoor/concrete/small,
/area/halflife/indoors/bunker)
"ry" = (
/obj/structure/halflife/pipes/vent,
/obj/structure/closet/halflife,
/obj/item/clothing/under/citizen/refugee/green,
/turf/open/floor/plating/indoor/concrete/bricks,
/area/halflife/indoors/bunker)
"sU" = (
/obj/structure/chair/office/halflife/blue{
	dir = 8
	},
/turf/open/floor/plating/indoor/concrete/small,
/area/halflife/indoors/bunker)
"tJ" = (
/turf/open/floor/plating/indoor/lino,
/area/halflife/indoors/bunker)
"tO" = (
/obj/item/reagent_containers/cup/glass/bottle/vodka{
	pixel_x = 5;
	pixel_y = 10
	},
/turf/open/floor/plating/indoor/concrete/bricks,
/area/halflife/indoors/bunker)
"ud" = (
/obj/structure/halflife/trash/books/pile_alt,
/turf/open/floor/plating/indoor/concrete/bricks,
/area/halflife/indoors/bunker)
"uE" = (
/obj/structure/halflife/pipes/horizontal,
/turf/open/halflife/water/sewer/deep,
/area/halflife/indoors/bunker)
"uH" = (
/obj/structure/extinguisher_cabinet/directional/north,
/turf/open/floor/plating/indoor/concrete/bricks,
/area/halflife/indoors/bunker)
"vp" = (
/obj/structure/closet/halflife/wall/firstaid,
/obj/effect/spawner/random/halflife/loot/heal,
/turf/open/floor/plating/indoor/concrete/bricks,
/area/halflife/indoors/bunker)
"vF" = (
/obj/structure/halflife/trash/cardboard{
	dir = 10
	},
/turf/open/floor/plating/indoor/concrete/bricks,
/area/halflife/indoors/bunker)
"wR" = (
/obj/machinery/door/unpowered/halflife/metal/red,
/turf/open/floor/plating/indoor/concrete/small,
/area/halflife/indoors/bunker)
"wY" = (
/obj/structure/halflife/trash/food/misc{
	pixel_x = -5;
	pixel_y = 6
	},
/turf/open/floor/plating/indoor/concrete/bricks,
/area/halflife/indoors/bunker)
"xo" = (
/obj/structure/chair/office/halflife/blue,
/obj/machinery/light/small/directional/east,
/turf/open/floor/plating/indoor/concrete/bricks,
/area/halflife/indoors/bunker)
"zW" = (
/obj/structure/halflife/pipes/vent,
/obj/structure/closet/halflife,
/turf/open/floor/plating/indoor/concrete/bricks,
/area/halflife/indoors/bunker)
"zY" = (
/obj/machinery/light/small/red/dim/directional/west,
/obj/structure/reagent_dispensers/watertank,
/turf/open/floor/plating/indoor/concrete/bricks,
/area/halflife/indoors/bunker)
"Aa" = (
/obj/structure/halflife/trash/cardboard{
	dir = 8
	},
/turf/open/floor/plating/indoor/concrete/bricks,
/area/halflife/indoors/bunker)
"Ay" = (
/obj/structure/halflife/toilet{
	pixel_y = 8
	},
/turf/open/floor/plating/indoor/lino,
/area/halflife/indoors/bunker)
"BH" = (
/obj/structure/bed/halflife/bedframe/wire,
/obj/structure/bed/halflife/mattress/old,
/obj/machinery/light/small/directional/north,
/turf/open/floor/plating/indoor/concrete/bricks,
/area/halflife/indoors/bunker)
"Ck" = (
/obj/machinery/door/unpowered/halflife/metal/red,
/obj/effect/decal/cleanable/blood/footprints{
	dir = 1
	},
/turf/open/floor/plating/indoor/lino,
/area/halflife/indoors/bunker)
"CQ" = (
/obj/structure/halflife/trash/garbage{
	pixel_x = -14;
	pixel_y = -4
	},
/turf/open/floor/plating/indoor/concrete/bricks,
/area/halflife/indoors/bunker)
"Dm" = (
/obj/machinery/door/unpowered/halflife/metal/red{
	dir = 8
	},
/turf/open/floor/plating/indoor/concrete/bricks,
/area/halflife/indoors/bunker)
"DT" = (
/obj/structure/halflife/trash/garbage{
	pixel_x = -2;
	pixel_y = -3
	},
/obj/structure/halflife/trash/garbage{
	pixel_x = 7;
	pixel_y = 3
	},
/turf/open/floor/plating/indoor/concrete/bricks,
/area/halflife/indoors/bunker)
"DX" = (
/obj/machinery/door/unpowered/halflife/metal/red,
/obj/machinery/door/poddoor/shutters{
	id = "commsentrance"
	},
/turf/open/floor/plating/indoor/concrete/bricks,
/area/halflife/indoors/bunker)
"Ej" = (
/obj/structure/table/halflife/metal/grate,
/obj/structure/halflife/trash/glass/cans{
	pixel_x = 7;
	pixel_y = 8
	},
/turf/open/floor/plating/indoor/concrete/bricks,
/area/halflife/indoors/bunker)
"En" = (
/obj/structure/table/halflife/metal/grate,
/turf/open/floor/plating/indoor/concrete/bricks,
/area/halflife/indoors/bunker)
"Fg" = (
/obj/structure/halflife/pipes/horizontal/random,
/obj/item/reagent_containers/condiment/sugar{
	pixel_x = -10;
	pixel_y = 13
	},
/obj/item/reagent_containers/condiment/flour{
	pixel_x = 2;
	pixel_y = 11
	},
/turf/open/floor/plating/indoor/concrete/bricks,
/area/halflife/indoors/bunker)
"Fl" = (
/obj/machinery/door/unpowered/halflife/metal/red{
	dir = 4
	},
/turf/open/floor/plating/indoor/concrete/bricks,
/area/halflife/indoors/bunker)
"Gi" = (
/obj/structure/halflife/pipes/horizontal,
/obj/item/chair/halflife/metal/office/blue{
	dir = 1
	},
/turf/open/halflife/water/sewer/deep,
/area/halflife/indoors/bunker)
"Hg" = (
/obj/item/radio/intercom/bunker/comms{
	pixel_y = 32
	},
/turf/open/floor/plating/indoor/concrete/bricks,
/area/halflife/indoors/bunker)
"Hs" = (
/obj/structure/halflife/pipes/horizontal/end,
/obj/item/stack/sheet/mineral/sandbags{
	amount = 5
	},
/turf/open/floor/plating/indoor/concrete/bricks,
/area/halflife/indoors/bunker)
"Iq" = (
/obj/machinery/door/unpowered/halflife/metal/red{
	dir = 4
	},
/turf/open/floor/plating/indoor/concrete/small,
/area/halflife/indoors/bunker)
"ID" = (
/obj/structure/halflife/road_barrier/concrete{
	dir = 8
	},
/turf/open/floor/plating/indoor/concrete/bricks,
/area/halflife/indoors/bunker)
"JP" = (
/turf/open/halflife/water/sewer/shallow,
/area/halflife/indoors/bunker)
"JZ" = (
/obj/structure/table/halflife/no_smooth/wood/stand,
/turf/open/floor/plating/indoor/concrete/bricks,
/area/halflife/indoors/bunker)
"Kb" = (
/obj/structure/table/halflife/metal/grate,
/obj/item/restraints/legcuffs/beartrap{
	pixel_x = 8;
	pixel_y = 11
	},
/obj/item/restraints/legcuffs/beartrap{
	pixel_x = -5;
	pixel_y = 8
	},
/obj/machinery/light/small/directional/west,
/turf/open/floor/plating/indoor/concrete/small,
/area/halflife/indoors/bunker)
"Kk" = (
/obj/effect/baseturf_helper/halflife/underground,
/turf/closed/wall/halflife/concrete,
/area/halflife/indoors/bunker)
"Lb" = (
/obj/structure/table/halflife/no_smooth/large/metal/desk{
	dir = 1
	},
/obj/structure/halflife/trash/cardboard{
	dir = 4;
	pixel_x = 2;
	pixel_y = 12
	},
/obj/item/food/canned/halflife/crisps{
	pixel_x = -5;
	pixel_y = 23
	},
/obj/item/food/canned/halflife/seafood{
	pixel_x = 7;
	pixel_y = 7
	},
/turf/open/floor/plating/indoor/concrete/bricks,
/area/halflife/indoors/bunker)
"Ll" = (
/obj/machinery/door/unpowered/halflife/metal/red,
/turf/open/floor/plating/indoor/concrete/bricks,
/area/halflife/indoors/bunker)
"Ln" = (
/obj/structure/table/halflife/metal/grate,
/obj/structure/halflife/trash/glass/plate{
	pixel_x = 0;
	pixel_y = 3
	},
/turf/open/floor/plating/indoor/concrete/bricks,
/area/halflife/indoors/bunker)
"LH" = (
/obj/machinery/light/small/directional/west,
/turf/open/floor/plating/indoor/concrete/bricks,
/area/halflife/indoors/bunker)
"LZ" = (
/turf/open/halflife/water/sewer/deep,
/area/halflife/indoors/bunker)
"MH" = (
/turf/open/floor/plating/indoor/concrete/small,
/area/halflife/indoors/bunker)
"MZ" = (
/obj/item/gun/ballistic/automatic/pistol/usp/no_mag,
/obj/item/ammo_casing/spent,
/turf/open/floor/plating/indoor/lino,
/area/halflife/indoors/bunker)
"Ng" = (
/obj/structure/bed/halflife/bedframe/wire,
/obj/machinery/light/small/directional/north,
/obj/structure/bed/halflife/mattress/dirty,
/turf/open/floor/plating/indoor/concrete/bricks,
/area/halflife/indoors/bunker)
"Oc" = (
/obj/item/chair/halflife/metal/office/blue,
/turf/open/floor/plating/indoor/concrete/bricks,
/area/halflife/indoors/bunker)
"Ok" = (
/obj/structure/halflife/tank,
/turf/open/floor/plating/indoor/concrete/small,
/area/halflife/indoors/bunker)
"OJ" = (
/obj/structure/halflife/trash/garbage{
	pixel_x = 2;
	pixel_y = 17
	},
/turf/open/floor/plating/indoor/concrete/bricks,
/area/halflife/indoors/bunker)
"OM" = (
/obj/effect/decal/cleanable/blood/gibs/core,
/obj/effect/mob_spawn/corpse/human/refugee,
/turf/open/floor/plating/indoor/lino,
/area/halflife/indoors/bunker)
"PH" = (
/obj/machinery/shower/halflife{
	dir = 8
	},
/obj/structure/fluff/shower_drain,
/turf/open/floor/plating/indoor/lino,
/area/halflife/indoors/bunker)
"PO" = (
/obj/machinery/light/small/broken/directional/east,
/turf/open/halflife/water/sewer/shallow,
/area/halflife/indoors/bunker)
"Ql" = (
/obj/structure/halflife/trash/cardboard,
/obj/item/reagent_containers/cup/glass/mouthwash{
	pixel_x = 4;
	pixel_y = 26
	},
/obj/item/reagent_containers/cup/glass/mouthwash{
	pixel_x = 16;
	pixel_y = 25
	},
/obj/item/reagent_containers/cup/glass/mouthwash{
	pixel_x = -9;
	pixel_y = 23
	},
/turf/open/floor/plating/indoor/concrete/bricks,
/area/halflife/indoors/bunker)
"QO" = (
/obj/structure/halflife/pipes/horizontal/end{
	dir = 1
	},
/obj/structure/table/halflife/no_smooth/large/metal/desk,
/obj/structure/halflife/trash/cardboard{
	dir = 8;
	pixel_x = 2;
	pixel_y = 11
	},
/obj/item/light/bulb{
	pixel_x = 16;
	pixel_y = 15
	},
/turf/open/floor/plating/indoor/concrete/bricks,
/area/halflife/indoors/bunker)
"QW" = (
/obj/structure/halflife/trash/papers/one{
	dir = 8;
	pixel_x = -2;
	pixel_y = -4
	},
/obj/item/hl13_small_flag/poland{
	pixel_x = 11;
	pixel_y = 3
	},
/turf/open/floor/plating/indoor/concrete/bricks,
/area/halflife/indoors/bunker)
"QX" = (
/obj/machinery/button/door{
	id = "commsentrance"
	},
/turf/open/floor/plating/indoor/concrete/small,
/area/halflife/indoors/bunker)
"QZ" = (
/turf/template_noop,
/area/template_noop)
"RG" = (
/obj/machinery/light/small/broken/directional/west,
/obj/structure/halflife/trash/food/dinner,
/turf/open/floor/plating/indoor/concrete/bricks,
/area/halflife/indoors/bunker)
"Si" = (
/obj/structure/table/halflife/no_smooth/large/metal/desk{
	dir = 1
	},
/turf/open/floor/plating/indoor/concrete/bricks,
/area/halflife/indoors/bunker)
"Sq" = (
/obj/structure/table/halflife/no_smooth/large/metal/desk{
	dir = 1
	},
/obj/item/reagent_containers/cup/glass/waterbottle/large/empty{
	pixel_x = 7;
	pixel_y = 15
	},
/turf/open/floor/plating/indoor/concrete/bricks,
/area/halflife/indoors/bunker)
"Sv" = (
/obj/item/reagent_containers/cup/glass/waterbottle/large{
	pixel_x = -9;
	pixel_y = 18
	},
/obj/item/reagent_containers/cup/glass/waterbottle/large{
	pixel_x = 7;
	pixel_y = 13
	},
/turf/open/floor/plating/indoor/concrete/bricks,
/area/halflife/indoors/bunker)
"Sx" = (
/obj/structure/halflife/pipes/vent,
/obj/structure/halflife/trash/cardboard{
	dir = 4;
	pixel_y = 9
	},
/turf/open/floor/plating/indoor/concrete/bricks,
/area/halflife/indoors/bunker)
"Tp" = (
/obj/structure/halflife/trash/books/pile,
/turf/open/floor/plating/indoor/concrete/bricks,
/area/halflife/indoors/bunker)
"Ub" = (
/obj/machinery/light/small/directional/north,
/turf/open/floor/plating/indoor/concrete/bricks,
/area/halflife/indoors/bunker)
"Un" = (
/obj/item/chair/halflife/metal/office/blue,
/turf/open/halflife/water/sewer/shallow,
/area/halflife/indoors/bunker)
"Us" = (
/obj/structure/table/halflife/no_smooth/large/metal/desk{
	dir = 1
	},
/obj/structure/halflife/trash/food/glass{
	pixel_x = 1;
	pixel_y = 11
	},
/turf/open/floor/plating/indoor/concrete/bricks,
/area/halflife/indoors/bunker)
"UL" = (
/obj/structure/table/halflife/no_smooth/large/metal/desk{
	dir = 8
	},
/obj/structure/halflife/trash/glass/basic{
	pixel_x = 0;
	pixel_y = 10
	},
/turf/open/floor/plating/indoor/concrete/small,
/area/halflife/indoors/bunker)
"We" = (
/obj/effect/spawner/random/entertainment/arcade,
/turf/open/floor/plating/indoor/concrete/small,
/area/halflife/indoors/bunker)
"WR" = (
/obj/machinery/light/small/directional/north,
/turf/open/floor/plating/indoor/lino,
/area/halflife/indoors/bunker)
"WU" = (
/obj/structure/sink/halflife{
	pixel_y = 8
	},
/obj/structure/mirror/halflife{
	pixel_y = 32
	},
/turf/open/floor/plating/indoor/lino,
/area/halflife/indoors/bunker)
"Xu" = (
/obj/structure/halflife/trash/garbage{
	pixel_x = -4;
	pixel_y = 18
	},
/turf/open/floor/plating/indoor/concrete/bricks,
/area/halflife/indoors/bunker)
"XQ" = (
/obj/item/restraints/legcuffs/beartrap{
	pixel_x = -6;
	pixel_y = 6
	},
/turf/open/floor/plating/indoor/concrete/bricks,
/area/halflife/indoors/bunker)
"Ya" = (
/obj/structure/halflife/trash/garbage{
	pixel_x = 8;
	pixel_y = 8
	},
/obj/structure/halflife/trash/garbage{
	pixel_x = -4;
	pixel_y = 13
	},
/turf/open/floor/plating/indoor/concrete/bricks,
/area/halflife/indoors/bunker)
"Yv" = (
/obj/item/reagent_containers/cup/glass/waterbottle/large/empty{
	pixel_x = 8;
	pixel_y = 10
	},
/obj/structure/table/halflife/metal/grate,
/turf/open/floor/plating/indoor/concrete/small,
/area/halflife/indoors/bunker)
"Zb" = (
/obj/machinery/light/small/directional/south,
/obj/structure/halflife/trash/garbage{
	pixel_x = 8;
	pixel_y = -5
	},
/turf/open/floor/plating/indoor/concrete/bricks,
/area/halflife/indoors/bunker)
"ZB" = (
/obj/machinery/light/small/directional/south,
/obj/item/restraints/legcuffs/beartrap{
	pixel_x = 8;
	pixel_y = 10
	},
/turf/open/floor/plating/indoor/concrete/bricks,
/area/halflife/indoors/bunker)
"ZI" = (
/obj/structure/halflife/pipes/horizontal/single,
/turf/open/halflife/water/sewer/deep,
/area/halflife/indoors/bunker)

(1,1,1) = {"
QZ
QZ
QZ
QZ
QZ
QZ
QZ
QZ
QZ
QZ
QZ
QZ
QZ
QZ
QZ
QZ
QZ
QZ
QZ
QZ
mt
"}
(2,1,1) = {"
QZ
Kk
mb
mb
mb
mb
mb
mb
mb
mb
bV
mb
mb
mb
mb
mb
mb
mb
mb
mb
QZ
"}
(3,1,1) = {"
QZ
mb
zW
kK
Tp
mb
kK
kK
mb
XQ
kK
fQ
mb
QO
RG
JP
jI
zY
Us
mb
QZ
"}
(4,1,1) = {"
QZ
mb
BH
kK
kK
Ll
kK
kK
DX
kK
kK
ZB
mb
Fg
JP
JP
iZ
JP
wY
mb
QZ
"}
(5,1,1) = {"
QZ
mb
JZ
ud
kK
mb
kK
kK
mb
Hg
kK
pj
mb
Gi
LZ
JP
JP
JP
JP
mb
QZ
"}
(6,1,1) = {"
QZ
mb
mb
mb
mb
mb
Ub
kK
mb
mb
kY
mb
mb
ZI
LZ
LZ
JP
JP
JP
mb
QZ
"}
(7,1,1) = {"
QZ
mb
ry
kK
kK
mb
kK
kK
mb
gU
QX
UL
mb
uE
LZ
JP
JP
lP
Oc
mb
QZ
"}
(8,1,1) = {"
QZ
mb
Ng
kK
kK
Ll
kK
kK
wR
MH
sU
MH
mb
lV
Un
JP
JP
kK
Lb
mb
QZ
"}
(9,1,1) = {"
QZ
mb
ch
kK
kK
mb
uH
kK
mb
MH
jT
Yv
mb
Hs
PO
QW
kK
pl
Sv
mb
QZ
"}
(10,1,1) = {"
QZ
mb
mb
mb
mb
mb
pi
ID
mb
mb
mb
mb
mb
mb
mb
mb
Dm
mb
mb
mb
QZ
"}
(11,1,1) = {"
QZ
mb
rv
Kb
at
mb
Ub
kK
kK
kK
LH
kK
Ll
kK
kK
LH
kK
kK
DT
mb
QZ
"}
(12,1,1) = {"
QZ
wR
MH
MH
MH
wR
kK
kK
kK
kK
kK
kK
mb
OJ
kK
kK
kK
kK
iF
mb
QZ
"}
(13,1,1) = {"
QZ
mb
Ok
MH
Ok
mb
mb
mb
mb
Fl
mb
mb
mb
mb
mb
mb
Fl
mb
mb
mb
QZ
"}
(14,1,1) = {"
QZ
mb
mb
Iq
mb
mb
En
vF
LH
kK
kK
En
mb
Ay
tJ
mb
vp
kK
Sq
mb
QZ
"}
(15,1,1) = {"
QZ
mb
We
MH
MH
mb
En
kK
kK
kK
kK
Ej
mb
WR
tJ
jF
kK
kK
gc
mb
QZ
"}
(16,1,1) = {"
QZ
mb
mb
mb
mb
mb
En
kK
kK
kK
Aa
Ln
mb
WU
tJ
mb
pi
kK
Zb
mb
QZ
"}
(17,1,1) = {"
QZ
eV
mb
Ql
kK
mb
Sx
kK
kK
kK
kK
bK
mb
mb
mb
mb
Xu
kK
CQ
mb
QZ
"}
(18,1,1) = {"
QZ
eV
mb
kI
kK
Ll
kK
kK
pb
kK
kK
kK
mb
WR
MZ
Ck
kK
kK
Si
mb
QZ
"}
(19,1,1) = {"
QZ
eV
mb
kK
qI
mb
kK
xo
tO
al
qI
bK
mb
PH
OM
mb
Ya
kK
kK
mb
QZ
"}
(20,1,1) = {"
QZ
eV
mb
mb
mb
mb
mb
mb
mb
mb
mb
mb
mb
mb
mb
mb
mb
mb
mb
mb
QZ
"}
(21,1,1) = {"
QZ
QZ
QZ
QZ
QZ
QZ
QZ
QZ
QZ
QZ
QZ
QZ
QZ
QZ
QZ
QZ
QZ
QZ
QZ
QZ
QZ
"}
