//MAP CONVERTED BY dmm2tgm.py THIS HEADER COMMENT PREVENTS RECONVERSION, DO NOT REMOVE
"ab" = (
/obj/machinery/light/small/directional/north,
/turf/open/floor/plating/indoor/concrete/bricks,
/area/halflife/indoors/bunker)
"ag" = (
/obj/structure/table/halflife/no_smooth/large/metal/desk{
	dir = 1
	},
/obj/structure/halflife/trash/food/glass,
/turf/open/floor/plating/indoor/concrete/bricks,
/area/halflife/indoors/bunker)
"aM" = (
/mob/living/simple_animal/hostile/halflife/zombie/poison,
/turf/open/floor/plating/indoor/concrete/bricks,
/area/halflife/indoors/bunker)
"aT" = (
/obj/structure/table/halflife/no_smooth/wood/stand,
/turf/open/floor/plating/indoor/concrete/bricks,
/area/halflife/indoors/bunker)
"bZ" = (
/obj/structure/halflife/pipes/horizontal/end{
	dir = 1
	},
/obj/structure/table/halflife/no_smooth/large/metal/desk,
/obj/structure/halflife/trash/cardboard{
	dir = 8
	},
/obj/item/light/bulb,
/turf/open/floor/plating/indoor/concrete/bricks,
/area/halflife/indoors/bunker)
"cw" = (
/obj/structure/table/halflife/no_smooth/large/metal/desk{
	dir = 1
	},
/turf/open/floor/plating/indoor/concrete/bricks,
/area/halflife/indoors/bunker)
"cz" = (
/obj/machinery/light/small/red/dim/directional/west,
/obj/structure/reagent_dispensers/watertank,
/turf/open/floor/plating/indoor/concrete/bricks,
/area/halflife/indoors/bunker)
"dB" = (
/obj/machinery/door/unpowered/halflife/metal/red,
/obj/machinery/door/poddoor/shutters{
	id = "commsentrance"
	},
/turf/open/floor/plating/indoor/concrete/bricks,
/area/halflife/indoors/bunker)
"ed" = (
/obj/structure/halflife/trash/papers/one{
	dir = 4
	},
/turf/open/floor/plating/indoor/concrete/bricks,
/area/halflife/indoors/bunker)
"eH" = (
/obj/structure/halflife/pipes/horizontal/random,
/turf/open/floor/plating/indoor/concrete/bricks,
/area/halflife/indoors/bunker)
"hB" = (
/obj/structure/halflife/trash/food/misc,
/turf/open/floor/plating/indoor/concrete/bricks,
/area/halflife/indoors/bunker)
"iB" = (
/obj/machinery/door/unpowered/halflife/metal/red,
/turf/open/floor/plating/indoor/concrete/bricks,
/area/halflife/indoors/bunker)
"iL" = (
/obj/item/reagent_containers/cup/glass/waterbottle/large,
/turf/open/floor/plating/indoor/concrete/bricks,
/area/halflife/indoors/bunker)
"kC" = (
/obj/modular_map_connector,
/turf/template_noop,
/area/template_noop)
"ly" = (
/obj/structure/halflife/trash/garbage,
/turf/open/floor/plating/indoor/concrete/bricks,
/area/halflife/indoors/bunker)
"mG" = (
/obj/item/hl13_small_flag/poland,
/turf/open/floor/plating/indoor/concrete/bricks,
/area/halflife/indoors/bunker)
"mV" = (
/obj/structure/halflife/pipes/vent,
/turf/open/floor/plating/indoor/concrete/bricks,
/area/halflife/indoors/bunker)
"nb" = (
/obj/structure/halflife/trash/cardboard,
/turf/open/floor/plating/indoor/concrete/bricks,
/area/halflife/indoors/bunker)
"pR" = (
/obj/effect/spawner/random/halflife/loot/rare,
/turf/open/floor/plating/indoor/concrete/bricks,
/area/halflife/indoors/bunker)
"pT" = (
/obj/machinery/door/poddoor/shutters/window{
	id = "commsentrance"
	},
/obj/structure/window/fulltile,
/turf/open/floor/plating/indoor/concrete/bricks,
/area/halflife/indoors/bunker)
"pX" = (
/obj/machinery/door/unpowered/halflife/metal/red{
	dir = 8
	},
/turf/open/floor/plating/indoor/concrete/bricks,
/area/halflife/indoors/bunker)
"qz" = (
/obj/structure/table/halflife/no_smooth/large/metal/desk{
	dir = 1
	},
/obj/structure/halflife/trash/cardboard{
	dir = 4
	},
/obj/item/food/canned/peaches,
/obj/item/food/canned/tomatoes,
/turf/open/floor/plating/indoor/concrete/bricks,
/area/halflife/indoors/bunker)
"rn" = (
/obj/structure/bed/halflife/bedframe/wire,
/obj/structure/bed/halflife/mattress/old,
/obj/machinery/light/small/directional/north,
/turf/open/floor/plating/indoor/concrete/bricks,
/area/halflife/indoors/bunker)
"so" = (
/obj/machinery/button/door{
	id = "commsentrance"
	},
/turf/open/floor/plating/indoor/concrete/small,
/area/halflife/indoors/bunker)
"sp" = (
/obj/machinery/light/small/directional/south,
/turf/open/floor/plating/indoor/concrete/bricks,
/area/halflife/indoors/bunker)
"sP" = (
/obj/item/chair/halflife/metal/office/blue,
/turf/open/halflife/water/medium,
/area/halflife/indoors/bunker)
"tI" = (
/obj/machinery/light/small/broken/directional/west,
/obj/structure/halflife/trash/food/dinner,
/turf/open/floor/plating/indoor/concrete/bricks,
/area/halflife/indoors/bunker)
"ws" = (
/obj/structure/table/halflife/metal/grate,
/obj/structure/halflife/trash/glass/cans,
/turf/open/floor/plating/indoor/concrete/bricks,
/area/halflife/indoors/bunker)
"wz" = (
/obj/machinery/door/unpowered/halflife/metal/red,
/turf/open/floor/plating/indoor/lino,
/area/halflife/indoors/bunker)
"Ai" = (
/obj/structure/halflife/trash/papers/one{
	dir = 8
	},
/turf/open/floor/plating/indoor/concrete/bricks,
/area/halflife/indoors/bunker)
"CC" = (
/obj/structure/halflife/trash/cardboard{
	dir = 8
	},
/turf/open/floor/plating/indoor/concrete/bricks,
/area/halflife/indoors/bunker)
"Dj" = (
/obj/machinery/light/small/directional/east,
/turf/open/floor/plating/indoor/concrete/bricks,
/area/halflife/indoors/bunker)
"DB" = (
/turf/closed/wall/halflife/concrete,
/area/halflife/indoors/bunker)
"DY" = (
/obj/machinery/light/small/directional/north,
/turf/open/floor/plating/indoor/concrete/small,
/area/halflife/indoors/bunker)
"Fb" = (
/turf/open/floor/plating/indoor/concrete/small,
/area/halflife/indoors/bunker)
"Gn" = (
/turf/open/floor/plating/indoor/lino,
/area/halflife/indoors/bunker)
"Gq" = (
/obj/structure/halflife/pipes/horizontal/end,
/obj/effect/spawner/random/halflife/loot,
/turf/open/floor/plating/indoor/concrete/bricks,
/area/halflife/indoors/bunker)
"Hj" = (
/obj/structure/halflife/tank,
/turf/open/floor/plating/indoor/concrete/small,
/area/halflife/indoors/bunker)
"IB" = (
/obj/machinery/door/unpowered/halflife/metal/red{
	dir = 4
	},
/turf/open/floor/plating/indoor/concrete/bricks,
/area/halflife/indoors/bunker)
"Jw" = (
/obj/structure/halflife/trash/books/pile,
/turf/open/floor/plating/indoor/concrete/bricks,
/area/halflife/indoors/bunker)
"JJ" = (
/obj/structure/halflife/road_barrier/concrete{
	dir = 8
	},
/turf/open/floor/plating/indoor/concrete/bricks,
/area/halflife/indoors/bunker)
"JN" = (
/obj/structure/chair/office/halflife/blue,
/obj/machinery/light/small/directional/east,
/turf/open/floor/plating/indoor/concrete/bricks,
/area/halflife/indoors/bunker)
"JP" = (
/turf/template_noop,
/area/template_noop)
"Kx" = (
/obj/machinery/shower/halflife{
	dir = 8
	},
/obj/structure/fluff/shower_drain,
/turf/open/floor/plating/indoor/lino,
/area/halflife/indoors/bunker)
"KT" = (
/obj/structure/halflife/trash/cardboard{
	dir = 10
	},
/turf/open/floor/plating/indoor/concrete/bricks,
/area/halflife/indoors/bunker)
"Lp" = (
/obj/structure/halflife/trash/books/pile_alt,
/turf/open/floor/plating/indoor/concrete/bricks,
/area/halflife/indoors/bunker)
"My" = (
/obj/machinery/light/small/broken/directional/east,
/turf/open/floor/plating/indoor/concrete/bricks,
/area/halflife/indoors/bunker)
"MZ" = (
/obj/structure/table/halflife/no_smooth/large/metal/desk{
	dir = 8
	},
/obj/structure/halflife/trash/glass/basic,
/turf/open/floor/plating/indoor/concrete/small,
/area/halflife/indoors/bunker)
"Na" = (
/obj/structure/chair/office/halflife/blue{
	dir = 8
	},
/turf/open/floor/plating/indoor/concrete/small,
/area/halflife/indoors/bunker)
"ND" = (
/obj/structure/halflife/pipes/horizontal,
/obj/structure/table/halflife/no_smooth/large/metal/desk/alt,
/turf/open/floor/plating/indoor/concrete/bricks,
/area/halflife/indoors/bunker)
"NH" = (
/obj/structure/halflife/pipes/horizontal/single,
/turf/open/halflife/water/medium,
/area/halflife/indoors/bunker)
"NM" = (
/obj/structure/halflife/toilet{
	pixel_y = 8
	},
/turf/open/floor/plating/indoor/lino,
/area/halflife/indoors/bunker)
"NN" = (
/obj/structure/bed/halflife/bedframe/wire,
/obj/structure/bed/halflife/mattress/stale,
/obj/machinery/light/small/directional/north,
/turf/open/floor/plating/indoor/concrete/bricks,
/area/halflife/indoors/bunker)
"PA" = (
/obj/structure/halflife/pipes/horizontal,
/turf/open/halflife/water/medium,
/area/halflife/indoors/bunker)
"PK" = (
/obj/structure/table/halflife/metal/grate,
/turf/open/floor/plating/indoor/concrete/bricks,
/area/halflife/indoors/bunker)
"Qk" = (
/obj/structure/halflife/pipes/vent,
/turf/open/floor/plating/indoor/concrete/small,
/area/halflife/indoors/bunker)
"QI" = (
/obj/machinery/light/small/directional/north,
/turf/open/floor/plating/indoor/lino,
/area/halflife/indoors/bunker)
"QZ" = (
/turf/open/halflife/water/medium,
/area/halflife/indoors/bunker)
"Rt" = (
/obj/item/chair/halflife/metal/office/blue,
/turf/open/floor/plating/indoor/concrete/bricks,
/area/halflife/indoors/bunker)
"Sh" = (
/obj/structure/table/halflife/metal/grate,
/obj/structure/halflife/trash/glass/plate,
/turf/open/floor/plating/indoor/concrete/bricks,
/area/halflife/indoors/bunker)
"UL" = (
/obj/structure/halflife/pipes/vent,
/obj/structure/halflife/trash/cardboard{
	dir = 4;
	pixel_y = 9
	},
/turf/open/floor/plating/indoor/concrete/bricks,
/area/halflife/indoors/bunker)
"Vc" = (
/obj/machinery/light/small/broken/directional/east,
/turf/open/halflife/water/medium,
/area/halflife/indoors/bunker)
"VG" = (
/obj/machinery/light/small/directional/west,
/turf/open/floor/plating/indoor/concrete/bricks,
/area/halflife/indoors/bunker)
"VK" = (
/obj/structure/chair/office/halflife/blue/broken,
/obj/structure/halflife/trash/papers/three{
	dir = 8
	},
/turf/open/floor/plating/indoor/concrete/bricks,
/area/halflife/indoors/bunker)
"Wr" = (
/obj/machinery/light/small/directional/east,
/turf/open/floor/plating/indoor/concrete/small,
/area/halflife/indoors/bunker)
"Wu" = (
/turf/closed/indestructible/rock,
/area/template_noop)
"WQ" = (
/obj/machinery/door/unpowered/halflife/metal/red,
/turf/open/floor/plating/indoor/concrete/small,
/area/halflife/indoors/bunker)
"Yo" = (
/mob/living/simple_animal/hostile/halflife/zombie,
/turf/open/halflife/water/medium,
/area/halflife/indoors/bunker)
"YO" = (
/obj/machinery/light/small/directional/south,
/obj/structure/halflife/trash/garbage,
/turf/open/floor/plating/indoor/concrete/bricks,
/area/halflife/indoors/bunker)
"YX" = (
/obj/structure/sink/halflife{
	pixel_y = 8
	},
/obj/structure/mirror/halflife{
	pixel_y = 32
	},
/turf/open/floor/plating/indoor/lino,
/area/halflife/indoors/bunker)
"Ze" = (
/obj/structure/halflife/pipes/horizontal,
/obj/item/chair/halflife/metal/office/blue{
	dir = 1
	},
/turf/open/halflife/water/medium,
/area/halflife/indoors/bunker)
"Zq" = (
/turf/open/floor/plating/indoor/concrete/bricks,
/area/halflife/indoors/bunker)

(1,1,1) = {"
JP
JP
JP
JP
JP
JP
JP
JP
JP
JP
JP
JP
JP
JP
JP
JP
JP
JP
JP
JP
kC
"}
(2,1,1) = {"
JP
DB
DB
DB
DB
DB
DB
DB
DB
DB
pX
DB
DB
DB
DB
DB
DB
DB
DB
DB
JP
"}
(3,1,1) = {"
JP
DB
mV
Zq
Jw
DB
Zq
Zq
DB
Zq
Zq
ly
DB
bZ
tI
QZ
VK
cz
ag
DB
JP
"}
(4,1,1) = {"
JP
DB
rn
Zq
Zq
iB
Zq
Zq
dB
Zq
Zq
sp
DB
eH
QZ
QZ
QZ
QZ
hB
DB
JP
"}
(5,1,1) = {"
JP
DB
aT
Lp
Zq
DB
Zq
Zq
DB
Zq
Zq
ly
DB
Ze
QZ
QZ
QZ
Yo
QZ
DB
JP
"}
(6,1,1) = {"
JP
DB
DB
DB
DB
DB
ab
Zq
DB
DB
pT
DB
DB
NH
QZ
QZ
QZ
QZ
QZ
DB
JP
"}
(7,1,1) = {"
JP
DB
mV
Zq
Zq
DB
Zq
Zq
DB
Qk
so
MZ
DB
PA
QZ
QZ
QZ
ed
Rt
DB
JP
"}
(8,1,1) = {"
JP
DB
NN
Zq
Zq
iB
Zq
Zq
WQ
Fb
Na
Fb
DB
ND
sP
QZ
QZ
Zq
qz
DB
JP
"}
(9,1,1) = {"
JP
DB
aT
Zq
Zq
DB
Zq
Zq
DB
Fb
Wr
Fb
DB
Gq
Vc
Ai
Zq
My
iL
DB
JP
"}
(10,1,1) = {"
JP
DB
DB
DB
DB
DB
mV
JJ
DB
DB
DB
DB
DB
DB
DB
DB
pX
DB
DB
DB
JP
"}
(11,1,1) = {"
JP
DB
Qk
Fb
Fb
DB
ab
Zq
Zq
Zq
VG
Zq
iB
Zq
Zq
VG
Zq
ly
ly
DB
JP
"}
(12,1,1) = {"
JP
DB
DY
Fb
Fb
WQ
Zq
Zq
Zq
Zq
Zq
Zq
DB
ly
Zq
Zq
Zq
Zq
ly
DB
JP
"}
(13,1,1) = {"
JP
DB
Hj
Fb
Hj
DB
DB
DB
DB
IB
DB
DB
DB
DB
DB
DB
IB
DB
DB
DB
JP
"}
(14,1,1) = {"
JP
DB
DB
DB
DB
DB
PK
KT
VG
Zq
Zq
PK
DB
NM
Gn
DB
Zq
Zq
cw
DB
JP
"}
(15,1,1) = {"
JP
Wu
Wu
Wu
Wu
DB
PK
Zq
Zq
Zq
Zq
ws
DB
QI
Gn
wz
Zq
Zq
Zq
DB
JP
"}
(16,1,1) = {"
JP
Wu
Wu
Wu
Wu
DB
PK
Zq
aM
Zq
CC
Sh
DB
YX
Gn
DB
mV
Zq
YO
DB
JP
"}
(17,1,1) = {"
JP
Wu
Wu
Wu
Wu
DB
UL
Zq
Zq
Zq
Zq
mG
DB
DB
DB
DB
ly
Zq
ly
DB
JP
"}
(18,1,1) = {"
JP
Wu
Wu
Wu
Wu
DB
Zq
Zq
cw
Zq
Zq
Zq
DB
QI
Gn
wz
Zq
Zq
cw
DB
JP
"}
(19,1,1) = {"
JP
Wu
Wu
Wu
Wu
DB
Zq
JN
pR
nb
Dj
mG
DB
Kx
Gn
DB
ly
ly
Zq
DB
JP
"}
(20,1,1) = {"
JP
Wu
Wu
Wu
Wu
DB
DB
DB
DB
DB
DB
DB
DB
DB
DB
DB
DB
DB
DB
DB
JP
"}
(21,1,1) = {"
JP
JP
JP
JP
JP
JP
JP
JP
JP
JP
JP
JP
JP
JP
JP
JP
JP
JP
JP
JP
JP
"}
