//MAP CONVERTED BY dmm2tgm.py THIS HEADER COMMENT PREVENTS RECONVERSION, DO NOT REMOVE
"av" = (
/obj/structure/table/halflife/metal/grate,
/turf/open/floor/plating/indoor/concrete/bricks,
/area/halflife/indoors/bunker)
"aD" = (
/obj/machinery/light/small/directional/south,
/obj/structure/halflife/trash/garbage{
	pixel_x = 8;
	pixel_y = -5
	},
/turf/open/floor/plating/indoor/concrete/bricks,
/area/halflife/indoors/bunker)
"aZ" = (
/obj/item/reagent_containers/cup/glass/waterbottle/large/empty{
	pixel_x = -11;
	pixel_y = 14
	},
/obj/structure/alien/weeds,
/obj/structure/flora/xen/tinyshrooms,
/turf/open/floor/plating/indoor/concrete/bricks,
/area/halflife/indoors/bunker)
"be" = (
/obj/effect/decal/cleanable/blood/footprints{
	dir = 4
	},
/turf/open/floor/plating/indoor/concrete/bricks,
/area/halflife/indoors/bunker)
"bm" = (
/obj/machinery/light/small/directional/north,
/turf/open/floor/plating/indoor/concrete/bricks,
/area/halflife/indoors/bunker)
"bp" = (
/obj/structure/halflife/pipes/vent,
/obj/effect/decal/cleanable/blood/footprints{
	dir = 4
	},
/turf/open/floor/plating/indoor/concrete/bricks,
/area/halflife/indoors/bunker)
"bt" = (
/obj/machinery/light/small/directional/south,
/obj/item/restraints/legcuffs/beartrap{
	pixel_x = 8;
	pixel_y = 10
	},
/turf/open/floor/plating/indoor/concrete/bricks,
/area/halflife/indoors/bunker)
"bw" = (
/obj/structure/halflife/pipes/horizontal/end{
	dir = 1
	},
/obj/structure/table/halflife/no_smooth/large/metal/desk,
/obj/structure/halflife/trash/cardboard{
	dir = 8;
	pixel_x = 2;
	pixel_y = 11
	},
/obj/item/light/bulb{
	pixel_x = 16;
	pixel_y = 15
	},
/obj/structure/alien/weeds,
/obj/item/stack/spacecash/c1{
	amount = 10
	},
/turf/open/floor/plating/indoor/concrete/bricks,
/area/halflife/indoors/bunker)
"bR" = (
/obj/structure/halflife/pipes/horizontal,
/obj/structure/alien/weeds,
/turf/open/halflife/water/sewer/deep,
/area/halflife/indoors/bunker)
"cg" = (
/obj/machinery/shower/halflife{
	dir = 8
	},
/obj/structure/fluff/shower_drain,
/mob/living/basic/halflife/zombie/fast,
/turf/open/floor/plating/indoor/lino,
/area/halflife/indoors/bunker)
"cv" = (
/obj/structure/halflife/road_barrier/concrete{
	dir = 8
	},
/turf/open/floor/plating/indoor/concrete/bricks,
/area/halflife/indoors/bunker)
"dq" = (
/obj/structure/halflife/trash/garbage{
	pixel_x = -3;
	pixel_y = -2
	},
/turf/open/floor/plating/indoor/concrete/bricks,
/area/halflife/indoors/bunker)
"dR" = (
/obj/item/ammo_casing/spent,
/turf/open/halflife/water/sewer/shallow,
/area/halflife/indoors/bunker)
"ed" = (
/obj/structure/bed/halflife/bedframe/wire,
/obj/machinery/light/small/directional/north,
/obj/structure/bed/halflife/mattress/dirty,
/turf/open/floor/plating/indoor/concrete/bricks,
/area/halflife/indoors/bunker)
"eV" = (
/obj/structure/halflife/trash/food/misc{
	pixel_x = -5;
	pixel_y = 6
	},
/obj/item/stack/kevlar/two{
	pixel_x = 3;
	pixel_y = 12
	},
/obj/structure/alien/weeds,
/obj/effect/spawner/random/halflife/loot/legendary,
/turf/open/floor/plating/indoor/concrete/bricks,
/area/halflife/indoors/bunker)
"eZ" = (
/obj/machinery/door/unpowered/halflife/metal/red{
	dir = 4
	},
/turf/open/floor/plating/indoor/concrete/small,
/area/halflife/indoors/bunker)
"fg" = (
/obj/item/ammo_casing/spent,
/obj/item/ammo_box/magazine/m4a1/service{
	pixel_x = 13;
	pixel_y = 5
	},
/turf/open/halflife/water/sewer/shallow,
/area/halflife/indoors/bunker)
"gu" = (
/obj/machinery/button/door{
	id = "commsentrance"
	},
/turf/open/floor/plating/indoor/concrete/small,
/area/halflife/indoors/bunker)
"gR" = (
/mob/living/basic/halflife/headcrab,
/turf/open/floor/plating/indoor/concrete/bricks,
/area/halflife/indoors/bunker)
"ha" = (
/obj/modular_map_connector,
/turf/template_noop,
/area/template_noop)
"hi" = (
/obj/item/chair/halflife/metal/office/blue,
/obj/effect/decal/cleanable/blood/old,
/obj/structure/alien/weeds,
/turf/open/floor/plating/indoor/concrete/bricks,
/area/halflife/indoors/bunker)
"hl" = (
/turf/closed/wall/halflife/concrete,
/area/halflife/indoors/bunker)
"hq" = (
/obj/structure/table/halflife/metal/grate,
/obj/item/restraints/legcuffs/beartrap{
	pixel_x = 8;
	pixel_y = 11
	},
/obj/item/restraints/legcuffs/beartrap{
	pixel_x = -5;
	pixel_y = 8
	},
/obj/machinery/light/small/directional/west,
/turf/open/floor/plating/indoor/concrete/small,
/area/halflife/indoors/bunker)
"hC" = (
/obj/structure/table/halflife/no_smooth/wood/stand,
/obj/structure/halflife/trash/books{
	pixel_x = -1;
	pixel_y = 6
	},
/turf/open/floor/plating/indoor/concrete/bricks,
/area/halflife/indoors/bunker)
"ik" = (
/obj/structure/halflife/trash/papers/one{
	dir = 4
	},
/obj/effect/decal/cleanable/blood/gibs/body,
/turf/open/floor/plating/indoor/concrete/bricks,
/area/halflife/indoors/bunker)
"iF" = (
/obj/structure/table/halflife/no_smooth/large/metal/desk{
	dir = 1
	},
/obj/structure/halflife/trash/food/glass{
	pixel_x = 1;
	pixel_y = 11
	},
/obj/structure/alien/weeds,
/obj/effect/spawner/random/halflife/loot/legendary,
/turf/open/floor/plating/indoor/concrete/bricks,
/area/halflife/indoors/bunker)
"jq" = (
/obj/item/stack/medical/bandage{
	pixel_x = -8;
	pixel_y = 11
	},
/turf/open/floor/plating/indoor/concrete/bricks,
/area/halflife/indoors/bunker)
"kp" = (
/obj/structure/halflife/pipes/horizontal,
/obj/item/chair/halflife/metal/office/blue{
	dir = 1
	},
/obj/structure/alien/weeds,
/turf/open/halflife/water/sewer/deep,
/area/halflife/indoors/bunker)
"kB" = (
/obj/structure/halflife/trash/cardboard,
/obj/item/reagent_containers/cup/glass/mouthwash{
	pixel_x = 4;
	pixel_y = 26
	},
/obj/item/reagent_containers/cup/glass/mouthwash{
	pixel_x = 16;
	pixel_y = 25
	},
/obj/item/reagent_containers/cup/glass/mouthwash{
	pixel_x = -9;
	pixel_y = 23
	},
/turf/open/floor/plating/indoor/concrete/bricks,
/area/halflife/indoors/bunker)
"lA" = (
/obj/structure/halflife/trash/cardboard{
	dir = 10
	},
/turf/open/floor/plating/indoor/concrete/bricks,
/area/halflife/indoors/bunker)
"lW" = (
/obj/structure/halflife/pipes/vent,
/obj/structure/halflife/trash/cardboard{
	dir = 4;
	pixel_y = 9
	},
/turf/open/floor/plating/indoor/concrete/bricks,
/area/halflife/indoors/bunker)
"ns" = (
/obj/structure/sink/halflife{
	pixel_y = 8
	},
/obj/structure/mirror/halflife{
	pixel_y = 32
	},
/turf/open/floor/plating/indoor/lino,
/area/halflife/indoors/bunker)
"nF" = (
/turf/open/halflife/water/sewer/shallow,
/area/halflife/indoors/bunker)
"nO" = (
/obj/machinery/door/unpowered/halflife/metal/red{
	dir = 8;
	keylock = 1;
	locked = 1
	},
/turf/open/floor/plating/indoor/concrete/bricks,
/area/halflife/indoors/bunker)
"ov" = (
/obj/item/ammo_casing/spent,
/obj/item/ammo_casing/spent,
/obj/item/ammo_casing/spent,
/turf/open/halflife/water/sewer/shallow,
/area/halflife/indoors/bunker)
"oB" = (
/obj/structure/halflife/tank,
/turf/open/floor/plating/indoor/concrete/small,
/area/halflife/indoors/bunker)
"oN" = (
/obj/structure/halflife/trash/books/pile_alt,
/turf/open/floor/plating/indoor/concrete/bricks,
/area/halflife/indoors/bunker)
"oQ" = (
/obj/structure/halflife/trash/garbage{
	pixel_x = -4;
	pixel_y = 18
	},
/obj/effect/decal/cleanable/blood/footprints{
	dir = 4
	},
/turf/open/floor/plating/indoor/concrete/bricks,
/area/halflife/indoors/bunker)
"oR" = (
/turf/open/floor/plating/indoor/lino,
/area/halflife/indoors/bunker)
"oS" = (
/obj/effect/decal/cleanable/blood/drip,
/turf/open/floor/plating/indoor/concrete/bricks,
/area/halflife/indoors/bunker)
"pH" = (
/obj/structure/table/halflife/metal/grate,
/obj/item/food/canned/halflife/beans{
	pixel_x = -9;
	pixel_y = 13
	},
/turf/open/floor/plating/indoor/concrete/bricks,
/area/halflife/indoors/bunker)
"pV" = (
/obj/structure/halflife/pipes/vent,
/obj/structure/closet/halflife,
/obj/item/clothing/under/citizen/refugee/green,
/turf/open/floor/plating/indoor/concrete/bricks,
/area/halflife/indoors/bunker)
"qg" = (
/obj/item/clothing/suit/armor/halflife/kevlar,
/turf/open/halflife/water/sewer/deep,
/area/halflife/indoors/bunker)
"qZ" = (
/obj/item/restraints/legcuffs/beartrap{
	pixel_x = -6;
	pixel_y = 6
	},
/turf/open/floor/plating/indoor/concrete/bricks,
/area/halflife/indoors/bunker)
"sA" = (
/obj/structure/halflife/pipes/vent,
/turf/open/floor/plating/indoor/concrete/bricks,
/area/halflife/indoors/bunker)
"sY" = (
/turf/open/floor/plating/indoor/concrete/bricks,
/area/halflife/indoors/bunker)
"td" = (
/obj/item/pushbroom{
	pixel_y = 2
	},
/obj/item/reagent_containers/spray/cleaner{
	pixel_y = 17
	},
/turf/open/floor/plating/indoor/concrete/bricks,
/area/halflife/indoors/bunker)
"to" = (
/obj/item/ammo_box/magazine/m4a1/service{
	pixel_x = -8;
	pixel_y = 8;
	start_empty = 1
	},
/turf/open/halflife/water/sewer/deep,
/area/halflife/indoors/bunker)
"tA" = (
/obj/structure/table/halflife/no_smooth/large/metal/desk{
	dir = 8
	},
/obj/structure/halflife/trash/glass/basic{
	pixel_x = 0;
	pixel_y = 10
	},
/turf/open/floor/plating/indoor/concrete/small,
/area/halflife/indoors/bunker)
"uP" = (
/obj/structure/halflife/trash/garbage{
	pixel_x = -16;
	pixel_y = -4
	},
/turf/open/floor/plating/indoor/concrete/bricks,
/area/halflife/indoors/bunker)
"vS" = (
/obj/structure/table/halflife/metal/grate,
/obj/item/food/canned/halflife/crisps{
	pixel_x = -5;
	pixel_y = 9
	},
/obj/item/stack/medical/suture,
/turf/open/floor/plating/indoor/concrete/bricks,
/area/halflife/indoors/bunker)
"wc" = (
/obj/structure/halflife/trash/garbage{
	pixel_x = 8;
	pixel_y = 8
	},
/obj/structure/halflife/trash/garbage{
	pixel_x = -4;
	pixel_y = 13
	},
/turf/open/floor/plating/indoor/concrete/bricks,
/area/halflife/indoors/bunker)
"wj" = (
/obj/item/reagent_containers/cup/glass/bottle/vodka{
	pixel_x = 5;
	pixel_y = 10
	},
/turf/open/floor/plating/indoor/concrete/bricks,
/area/halflife/indoors/bunker)
"wq" = (
/obj/structure/halflife/toilet{
	pixel_y = 8
	},
/turf/open/floor/plating/indoor/lino,
/area/halflife/indoors/bunker)
"xg" = (
/obj/machinery/door/unpowered/halflife/metal/red{
	dir = 8
	},
/turf/open/floor/plating/indoor/concrete/bricks,
/area/halflife/indoors/bunker)
"xu" = (
/obj/machinery/door/unpowered/halflife/metal/red,
/turf/open/floor/plating/indoor/concrete/bricks,
/area/halflife/indoors/bunker)
"xR" = (
/obj/structure/halflife/trash/papers/one{
	dir = 8;
	pixel_x = -2;
	pixel_y = -4
	},
/obj/item/reagent_containers/cup/glass/waterbottle/large/empty{
	pixel_x = 8;
	pixel_y = 12
	},
/obj/item/hl13_small_flag/poland{
	pixel_x = 11;
	pixel_y = 3
	},
/turf/open/floor/plating/indoor/concrete/bricks,
/area/halflife/indoors/bunker)
"yv" = (
/obj/structure/halflife/trash/cardboard{
	dir = 8
	},
/turf/open/floor/plating/indoor/concrete/bricks,
/area/halflife/indoors/bunker)
"zp" = (
/obj/structure/halflife/pipes/horizontal,
/obj/structure/table/halflife/no_smooth/large/metal/desk/alt,
/obj/structure/alien/weeds,
/obj/item/stack/spacecash/c1{
	amount = 10
	},
/turf/open/floor/plating/indoor/concrete/bricks,
/area/halflife/indoors/bunker)
"zq" = (
/obj/structure/chair/office/halflife/blue,
/obj/machinery/light/small/directional/east,
/turf/open/floor/plating/indoor/concrete/bricks,
/area/halflife/indoors/bunker)
"zx" = (
/obj/item/hl13_small_flag/poland,
/turf/open/floor/plating/indoor/concrete/bricks,
/area/halflife/indoors/bunker)
"zT" = (
/obj/machinery/light/small/broken/directional/east,
/obj/item/reagent_containers/condiment/vegetable_oil{
	pixel_x = 4;
	pixel_y = 8
	},
/obj/structure/alien/weeds,
/turf/open/floor/plating/indoor/concrete/bricks,
/area/halflife/indoors/bunker)
"Af" = (
/obj/structure/halflife/pipes/vent,
/obj/structure/closet/halflife,
/turf/open/floor/plating/indoor/concrete/bricks,
/area/halflife/indoors/bunker)
"Ah" = (
/obj/machinery/light/small/directional/east,
/mob/living/basic/halflife/headcrab/poison,
/turf/open/floor/plating/indoor/concrete/bricks,
/area/halflife/indoors/bunker)
"Aj" = (
/obj/effect/decal/cleanable/blood/footprints{
	dir = 4
	},
/obj/structure/closet/halflife/wall/firstaid,
/obj/effect/spawner/random/halflife/loot/heal,
/turf/open/floor/plating/indoor/concrete/bricks,
/area/halflife/indoors/bunker)
"Al" = (
/obj/machinery/door/unpowered/halflife/metal/red{
	dir = 4
	},
/turf/open/floor/plating/indoor/concrete/bricks,
/area/halflife/indoors/bunker)
"AO" = (
/obj/structure/table/halflife/no_smooth/large/metal/desk{
	dir = 1
	},
/obj/item/stack/medical/bandage{
	pixel_x = -1;
	pixel_y = 5
	},
/turf/open/floor/plating/indoor/concrete/bricks,
/area/halflife/indoors/bunker)
"Bc" = (
/obj/structure/table/halflife/no_smooth/large/metal/desk{
	dir = 1
	},
/obj/item/storage/fancy/cigarettes/halflife{
	pixel_x = 15;
	pixel_y = 12
	},
/obj/item/storage/box/matches{
	pixel_x = -1;
	pixel_y = 10
	},
/turf/open/floor/plating/indoor/concrete/bricks,
/area/halflife/indoors/bunker)
"Bp" = (
/obj/structure/halflife/pipes/horizontal/single,
/obj/structure/alien/weeds,
/obj/structure/flora/xen/cougher,
/turf/open/halflife/water/sewer/deep,
/area/halflife/indoors/bunker)
"CX" = (
/obj/machinery/light/small/directional/east,
/turf/open/floor/plating/indoor/concrete/bricks,
/area/halflife/indoors/bunker)
"Dh" = (
/obj/structure/table/halflife/metal/grate,
/obj/item/food/canned/halflife/beans{
	pixel_x = -1;
	pixel_y = 7
	},
/turf/open/floor/plating/indoor/concrete/bricks,
/area/halflife/indoors/bunker)
"Dm" = (
/obj/effect/baseturf_helper/halflife/underground,
/turf/closed/wall/halflife/concrete,
/area/halflife/indoors/bunker)
"DA" = (
/obj/item/ammo_casing/spent,
/mob/living/basic/halflife/zombie/gonome/complete,
/turf/open/halflife/water/sewer/deep,
/area/halflife/indoors/bunker)
"DF" = (
/obj/structure/halflife/trash/garbage{
	pixel_x = 6;
	pixel_y = -3
	},
/turf/open/floor/plating/indoor/concrete/bricks,
/area/halflife/indoors/bunker)
"DI" = (
/obj/structure/halflife/pipes/vent,
/obj/structure/table/halflife/metal/grate,
/obj/item/food/canned/halflife/seafood{
	pixel_x = 0;
	pixel_y = 7
	},
/turf/open/floor/plating/indoor/concrete/small,
/area/halflife/indoors/bunker)
"EA" = (
/turf/template_noop,
/area/template_noop)
"EH" = (
/obj/item/chair/halflife/metal/office/blue,
/turf/open/halflife/water/sewer/shallow,
/area/halflife/indoors/bunker)
"Fb" = (
/obj/machinery/light/small/directional/east,
/turf/open/floor/plating/indoor/concrete/small,
/area/halflife/indoors/bunker)
"FF" = (
/obj/machinery/light/small/red/dim/directional/west,
/obj/structure/reagent_dispensers/watertank,
/obj/structure/alien/weeds,
/turf/open/floor/plating/indoor/concrete/bricks,
/area/halflife/indoors/bunker)
"Gm" = (
/obj/item/gun/ballistic/automatic/servicerifle/no_mag,
/turf/open/halflife/water/sewer/shallow,
/area/halflife/indoors/bunker)
"Go" = (
/mob/living/basic/halflife/zombie/zombine,
/turf/open/floor/plating/indoor/concrete/bricks,
/area/halflife/indoors/bunker)
"GQ" = (
/obj/item/ammo_casing/spent,
/obj/structure/alien/weeds,
/turf/open/halflife/water/sewer/deep,
/area/halflife/indoors/bunker)
"HS" = (
/obj/item/clothing/head/beret{
	pixel_x = -12;
	pixel_y = 9;
	desc = "An old beret that reeks of sewage and rot.";
	name = "sewer-soaked beret"
	},
/turf/open/halflife/water/sewer/shallow,
/area/halflife/indoors/bunker)
"Ij" = (
/obj/structure/halflife/trash/garbage{
	pixel_x = -2;
	pixel_y = -3
	},
/obj/structure/halflife/trash/garbage{
	pixel_x = 7;
	pixel_y = 3
	},
/turf/open/floor/plating/indoor/concrete/bricks,
/area/halflife/indoors/bunker)
"IJ" = (
/obj/machinery/light/small/broken/directional/east,
/turf/open/halflife/water/sewer/shallow,
/area/halflife/indoors/bunker)
"Jn" = (
/obj/item/radio/intercom/bunker/comms{
	pixel_y = 32
	},
/turf/open/floor/plating/indoor/concrete/bricks,
/area/halflife/indoors/bunker)
"Kr" = (
/obj/structure/bed/halflife/bedframe/wire,
/obj/structure/bed/halflife/mattress/old,
/obj/machinery/light/small/directional/north,
/turf/open/floor/plating/indoor/concrete/bricks,
/area/halflife/indoors/bunker)
"KO" = (
/obj/machinery/light/small/directional/west,
/turf/open/floor/plating/indoor/concrete/bricks,
/area/halflife/indoors/bunker)
"Ll" = (
/obj/item/knife/combat{
	pixel_x = 16;
	pixel_y = 7
	},
/turf/open/halflife/water/sewer/shallow,
/area/halflife/indoors/bunker)
"Lt" = (
/obj/structure/chair/office/halflife/blue{
	dir = 8
	},
/turf/open/floor/plating/indoor/concrete/small,
/area/halflife/indoors/bunker)
"Lu" = (
/obj/item/reagent_containers/cup/glass/waterbottle/large{
	pixel_x = -9;
	pixel_y = 18
	},
/obj/item/reagent_containers/cup/glass/waterbottle/large{
	pixel_x = 7;
	pixel_y = 13
	},
/obj/structure/alien/weeds,
/turf/open/floor/plating/indoor/concrete/bricks,
/area/halflife/indoors/bunker)
"Lw" = (
/obj/structure/table/halflife/metal/grate,
/obj/structure/halflife/trash/glass/plate{
	pixel_x = 0;
	pixel_y = 3
	},
/turf/open/floor/plating/indoor/concrete/bricks,
/area/halflife/indoors/bunker)
"LA" = (
/obj/machinery/door/unpowered/halflife/metal/red,
/turf/open/floor/plating/indoor/concrete/small,
/area/halflife/indoors/bunker)
"LW" = (
/obj/item/clothing/mask/gas/hl2/military{
	pixel_x = 4;
	pixel_y = -3;
	name = "dirty old gas mask";
	desc = "An old gas mask that smells utterly horrible. The filters should hold up, assuming you don't get a disease from it."
	},
/turf/open/halflife/water/sewer/shallow,
/area/halflife/indoors/bunker)
"LZ" = (
/obj/structure/halflife/trash/cardboard,
/turf/open/floor/plating/indoor/concrete/bricks,
/area/halflife/indoors/bunker)
"Mm" = (
/obj/structure/halflife/pipes/vent,
/obj/item/radio/intercom/bunker/comms{
	pixel_x = -32
	},
/turf/open/floor/plating/indoor/concrete/small,
/area/halflife/indoors/bunker)
"ME" = (
/obj/structure/chair/office/halflife/blue/broken,
/obj/structure/halflife/trash/papers/three{
	dir = 8
	},
/obj/structure/alien/weeds,
/turf/open/floor/plating/indoor/concrete/bricks,
/area/halflife/indoors/bunker)
"MN" = (
/obj/structure/extinguisher_cabinet/directional/north,
/turf/open/floor/plating/indoor/concrete/bricks,
/area/halflife/indoors/bunker)
"Op" = (
/obj/effect/spawner/random/halflife/loot/crafting_bench,
/turf/open/floor/plating/indoor/concrete/bricks,
/area/halflife/indoors/bunker)
"OD" = (
/obj/machinery/door/unpowered/halflife/metal/red{
	dir = 4
	},
/obj/effect/decal/cleanable/blood/footprints{
	dir = 4
	},
/turf/open/floor/plating/indoor/concrete/bricks,
/area/halflife/indoors/bunker)
"OX" = (
/obj/structure/table/halflife/no_smooth/large/metal/desk{
	dir = 1
	},
/obj/structure/halflife/trash/cardboard{
	dir = 4;
	pixel_x = 2;
	pixel_y = 12
	},
/obj/item/food/canned/halflife/crisps{
	pixel_x = -5;
	pixel_y = 23
	},
/obj/item/food/canned/halflife/crisps{
	pixel_x = 9;
	pixel_y = 21
	},
/obj/item/food/canned/halflife/seafood{
	pixel_x = -1;
	pixel_y = 15
	},
/obj/item/food/canned/halflife/seafood{
	pixel_x = 11;
	pixel_y = 13
	},
/obj/structure/alien/weeds,
/turf/open/floor/plating/indoor/concrete/bricks,
/area/halflife/indoors/bunker)
"Pu" = (
/obj/effect/decal/cleanable/blood/old,
/turf/open/floor/plating/indoor/concrete/bricks,
/area/halflife/indoors/bunker)
"Qa" = (
/obj/structure/halflife/pipes/horizontal/random,
/obj/item/reagent_containers/condiment/sugar{
	pixel_x = -10;
	pixel_y = 13
	},
/obj/item/reagent_containers/condiment/flour{
	pixel_x = 2;
	pixel_y = 11
	},
/obj/structure/alien/weeds,
/turf/open/floor/plating/indoor/concrete/bricks,
/area/halflife/indoors/bunker)
"RI" = (
/obj/machinery/door/poddoor/shutters/window{
	id = "commsentrance"
	},
/obj/structure/window/fulltile,
/turf/open/floor/plating/indoor/concrete/bricks,
/area/halflife/indoors/bunker)
"Sr" = (
/obj/effect/decal/cleanable/blood/old,
/obj/item/knife/hunting{
	pixel_x = 12;
	pixel_y = 8
	},
/turf/open/floor/plating/indoor/lino,
/area/halflife/indoors/bunker)
"Tb" = (
/obj/item/ammo_casing/spent,
/turf/open/floor/plating/indoor/concrete/bricks,
/area/halflife/indoors/bunker)
"Tq" = (
/obj/effect/spawner/random/entertainment/arcade,
/turf/open/floor/plating/indoor/concrete/small,
/area/halflife/indoors/bunker)
"TI" = (
/obj/structure/table/halflife/no_smooth/wood/stand,
/turf/open/floor/plating/indoor/concrete/bricks,
/area/halflife/indoors/bunker)
"TJ" = (
/obj/structure/halflife/pipes/horizontal/end,
/obj/item/stack/sheet/mineral/sandbags{
	amount = 5
	},
/obj/structure/alien/weeds,
/turf/open/floor/plating/indoor/concrete/bricks,
/area/halflife/indoors/bunker)
"Uo" = (
/turf/open/floor/plating/indoor/concrete/small,
/area/halflife/indoors/bunker)
"UI" = (
/obj/structure/halflife/trash/garbage{
	pixel_x = -14;
	pixel_y = -4
	},
/turf/open/floor/plating/indoor/concrete/bricks,
/area/halflife/indoors/bunker)
"Va" = (
/mob/living/basic/halflife/zombie/poison,
/turf/open/floor/plating/indoor/concrete/bricks,
/area/halflife/indoors/bunker)
"Vi" = (
/obj/item/ammo_casing/spent,
/obj/item/ammo_casing/spent,
/turf/open/halflife/water/sewer/shallow,
/area/halflife/indoors/bunker)
"VA" = (
/obj/structure/halflife/trash/books/pile,
/turf/open/floor/plating/indoor/concrete/bricks,
/area/halflife/indoors/bunker)
"VE" = (
/obj/structure/table/halflife/metal/grate,
/obj/item/weaponcrafting/receiver,
/turf/open/floor/plating/indoor/concrete/small,
/area/halflife/indoors/bunker)
"VK" = (
/obj/machinery/door/unpowered/halflife/metal/red,
/obj/effect/decal/cleanable/blood/footprints{
	dir = 1
	},
/turf/open/floor/plating/indoor/lino,
/area/halflife/indoors/bunker)
"VZ" = (
/obj/item/gun/ballistic/automatic/pistol/usp,
/turf/open/halflife/water/sewer/shallow,
/area/halflife/indoors/bunker)
"Wj" = (
/obj/machinery/light/small/directional/north,
/turf/open/floor/plating/indoor/lino,
/area/halflife/indoors/bunker)
"Wt" = (
/obj/structure/table/halflife/metal/grate,
/obj/structure/halflife/trash/glass/cans{
	pixel_x = 7;
	pixel_y = 8
	},
/turf/open/floor/plating/indoor/concrete/bricks,
/area/halflife/indoors/bunker)
"WI" = (
/obj/item/reagent_containers/cup/glass/waterbottle/large/empty{
	pixel_x = 8;
	pixel_y = 10
	},
/obj/structure/table/halflife/metal/grate,
/turf/open/floor/plating/indoor/concrete/small,
/area/halflife/indoors/bunker)
"Yj" = (
/obj/structure/halflife/trash/garbage{
	pixel_x = 2;
	pixel_y = 17
	},
/turf/open/floor/plating/indoor/concrete/bricks,
/area/halflife/indoors/bunker)
"Yr" = (
/turf/closed/indestructible/rock,
/area/template_noop)
"YE" = (
/obj/machinery/door/unpowered/halflife/metal/red,
/obj/machinery/door/poddoor/shutters{
	id = "commsentrance"
	},
/turf/open/floor/plating/indoor/concrete/bricks,
/area/halflife/indoors/bunker)
"YQ" = (
/obj/machinery/light/small/broken/directional/west,
/obj/structure/halflife/trash/food/dinner,
/obj/structure/alien/weeds,
/obj/effect/decal/cleanable/blood/gibs/core,
/turf/open/floor/plating/indoor/concrete/bricks,
/area/halflife/indoors/bunker)
"YX" = (
/obj/machinery/door/unpowered/halflife/metal/red,
/turf/open/floor/plating/indoor/lino,
/area/halflife/indoors/bunker)
"Ze" = (
/obj/structure/table/halflife/no_smooth/large/metal/desk{
	dir = 1
	},
/obj/item/reagent_containers/cup/glass/waterbottle/large/empty{
	pixel_x = 7;
	pixel_y = 15
	},
/turf/open/floor/plating/indoor/concrete/bricks,
/area/halflife/indoors/bunker)
"ZY" = (
/obj/machinery/light/small/directional/west,
/obj/item/ammo_casing/spent,
/turf/open/floor/plating/indoor/concrete/bricks,
/area/halflife/indoors/bunker)

(1,1,1) = {"
EA
EA
EA
EA
EA
EA
EA
EA
EA
EA
EA
EA
EA
EA
EA
EA
EA
EA
EA
EA
ha
"}
(2,1,1) = {"
EA
Dm
hl
hl
hl
hl
hl
hl
hl
hl
nO
hl
hl
hl
hl
hl
hl
hl
hl
hl
EA
"}
(3,1,1) = {"
EA
hl
Af
sY
VA
hl
sY
sY
hl
qZ
sY
dq
hl
bw
YQ
nF
ME
FF
iF
hl
EA
"}
(4,1,1) = {"
EA
hl
Kr
sY
sY
xu
sY
sY
YE
sY
sY
bt
hl
Qa
Gm
HS
LW
nF
eV
hl
EA
"}
(5,1,1) = {"
EA
hl
TI
oN
sY
hl
Pu
sY
hl
Jn
sY
DF
hl
kp
qg
dR
dR
VZ
nF
hl
EA
"}
(6,1,1) = {"
EA
hl
hl
hl
hl
hl
bm
sY
hl
hl
RI
hl
hl
Bp
GQ
DA
Vi
fg
Ll
hl
EA
"}
(7,1,1) = {"
EA
hl
pV
sY
sY
hl
sY
sY
hl
Mm
gu
tA
hl
bR
to
ov
ov
ik
hi
hl
EA
"}
(8,1,1) = {"
EA
hl
ed
sY
sY
xu
sY
sY
LA
Uo
Lt
Uo
hl
zp
EH
Vi
dR
aZ
OX
hl
EA
"}
(9,1,1) = {"
EA
hl
hC
sY
sY
hl
MN
Pu
hl
Uo
Fb
WI
hl
TJ
IJ
xR
Pu
zT
Lu
hl
EA
"}
(10,1,1) = {"
EA
hl
hl
hl
hl
hl
sA
cv
hl
hl
hl
hl
hl
hl
hl
hl
xg
hl
hl
hl
EA
"}
(11,1,1) = {"
EA
hl
DI
hq
VE
hl
bm
Go
Pu
sY
KO
Tb
xu
sY
sY
ZY
Tb
sY
Ij
hl
EA
"}
(12,1,1) = {"
EA
LA
Uo
Uo
Uo
LA
sY
sY
Tb
Tb
sY
Pu
hl
Yj
sY
sY
sY
Tb
uP
hl
EA
"}
(13,1,1) = {"
EA
hl
oB
Uo
oB
hl
hl
hl
hl
Al
hl
hl
hl
hl
hl
hl
OD
hl
hl
hl
EA
"}
(14,1,1) = {"
EA
hl
hl
eZ
hl
hl
Dh
lA
KO
sY
sY
vS
hl
wq
oR
hl
Aj
sY
Ze
hl
EA
"}
(15,1,1) = {"
EA
hl
Tq
Uo
Uo
hl
pH
sY
sY
sY
sY
Wt
hl
Wj
oR
YX
be
sY
td
hl
EA
"}
(16,1,1) = {"
EA
hl
hl
hl
hl
hl
av
sY
sY
Va
yv
Lw
hl
ns
oR
hl
bp
sY
aD
hl
EA
"}
(17,1,1) = {"
EA
Yr
hl
kB
sY
hl
lW
sY
sY
sY
sY
zx
hl
hl
hl
hl
oQ
gR
UI
hl
EA
"}
(18,1,1) = {"
EA
Yr
hl
Op
sY
xu
sY
sY
Bc
sY
sY
sY
hl
Wj
Sr
VK
oS
sY
AO
hl
EA
"}
(19,1,1) = {"
EA
Yr
hl
sY
Ah
hl
sY
zq
wj
LZ
CX
zx
hl
cg
oR
hl
wc
Pu
jq
hl
EA
"}
(20,1,1) = {"
EA
Yr
hl
hl
hl
hl
hl
hl
hl
hl
hl
hl
hl
hl
hl
hl
hl
hl
hl
hl
EA
"}
(21,1,1) = {"
EA
EA
EA
EA
EA
EA
EA
EA
EA
EA
EA
EA
EA
EA
EA
EA
EA
EA
EA
EA
EA
"}
