//MAP CONVERTED BY dmm2tgm.py THIS HEADER COMMENT PREVENTS RECONVERSION, DO NOT REMOVE
"a" = (
/turf/closed/mineral/random,
/area/halflife/indoors/sewer/cave)
"l" = (
/obj/structure/flora/rock/style_random,
/turf/open/floor/plating/ground/rockunder,
/area/halflife/indoors/sewer/cave)
"o" = (
/turf/open/halflife/water/sewer/shallow,
/area/halflife/indoors/sewer/cave)
"s" = (
/obj/structure/flora/xen/tinyshrooms,
/turf/open/floor/plating/ground/rockunder,
/area/halflife/indoors/sewer/cave)
"t" = (
/turf/open/floor/plating/ground/rockunder,
/area/halflife/indoors/sewer/cave)
"w" = (
/obj/modular_map_connector,
/turf/template_noop,
/area/template_noop)
"C" = (
/obj/effect/spawner/random/halflife/loot/uncommon,
/turf/open/floor/plating/ground/rockunder,
/area/halflife/indoors/sewer/cave)
"E" = (
/obj/effect/spawner/random/halflife/random_bullsquid,
/turf/open/floor/plating/ground/rockunder,
/area/halflife/indoors/sewer/cave)
"F" = (
/obj/effect/spawner/random/halflife/loot/rare,
/obj/effect/spawner/random/halflife/loot/heal,
/turf/open/halflife/water/sewer/shallow,
/area/halflife/indoors/sewer/cave)
"I" = (
/obj/structure/flora/xen/leafy,
/turf/open/floor/plating/ground/rockunder,
/area/halflife/indoors/sewer/cave)
"V" = (
/turf/template_noop,
/area/template_noop)

(1,1,1) = {"
V
V
V
V
V
V
V
V
V
V
V
V
V
V
V
V
V
V
V
V
V
w
"}
(2,1,1) = {"
V
a
a
a
a
a
a
a
a
a
a
a
a
a
a
a
a
a
a
a
a
V
"}
(3,1,1) = {"
V
a
a
a
a
a
a
a
a
a
a
a
a
a
a
a
a
a
a
a
a
V
"}
(4,1,1) = {"
V
a
a
a
a
a
a
a
a
a
a
a
a
a
a
a
a
a
a
a
a
V
"}
(5,1,1) = {"
V
a
a
a
a
a
a
a
a
a
a
a
a
a
a
a
a
a
a
a
a
V
"}
(6,1,1) = {"
V
a
a
a
a
a
a
a
a
a
a
a
a
a
a
a
a
a
a
a
a
V
"}
(7,1,1) = {"
V
a
a
a
a
a
a
a
a
a
a
a
a
a
a
a
a
a
a
a
a
V
"}
(8,1,1) = {"
V
a
a
a
a
a
a
a
a
a
t
t
a
a
a
a
a
a
a
a
a
V
"}
(9,1,1) = {"
V
a
a
a
a
a
a
a
a
l
t
t
a
a
t
a
a
a
a
a
a
V
"}
(10,1,1) = {"
V
a
a
a
a
a
a
t
t
t
t
t
a
t
a
a
a
a
a
a
a
V
"}
(11,1,1) = {"
V
a
a
a
a
a
a
t
t
t
t
t
t
t
t
a
a
a
a
a
a
V
"}
(12,1,1) = {"
V
a
a
a
a
a
t
t
t
t
a
t
t
t
t
a
a
a
a
a
a
V
"}
(13,1,1) = {"
V
a
a
a
C
t
t
t
t
a
a
a
t
t
l
a
a
a
a
a
a
V
"}
(14,1,1) = {"
V
a
a
a
t
t
t
o
t
t
a
a
a
a
a
a
a
a
a
a
a
V
"}
(15,1,1) = {"
V
a
a
a
t
E
o
o
o
I
a
a
a
a
a
a
a
a
a
a
a
V
"}
(16,1,1) = {"
V
a
a
a
t
t
o
F
o
t
t
a
a
a
a
a
a
a
a
a
a
V
"}
(17,1,1) = {"
V
a
a
a
a
t
o
o
o
t
C
a
a
a
a
a
a
a
a
a
a
V
"}
(18,1,1) = {"
V
a
a
a
a
t
s
o
t
a
a
a
a
a
a
a
a
a
a
a
a
V
"}
(19,1,1) = {"
V
a
a
a
a
a
a
a
a
a
a
a
a
a
a
a
a
a
a
a
a
V
"}
(20,1,1) = {"
V
a
a
a
a
a
a
a
a
a
a
a
a
a
a
a
a
a
a
a
a
V
"}
(21,1,1) = {"
V
a
a
a
a
a
a
a
a
a
a
a
a
a
a
a
a
a
a
a
a
V
"}
(22,1,1) = {"
V
V
V
V
V
V
V
V
V
V
V
V
V
V
V
V
V
V
V
V
V
V
"}
