//MAP CONVERTED BY dmm2tgm.py THIS HEADER COMMENT PREVENTS RECONVERSION, DO NOT REMOVE
"a" = (
/turf/template_noop,
/area/template_noop)
"i" = (
/turf/open/floor/plating/ground/rockunder,
/area/halflife/indoors/sewer/cave)
"o" = (
/mob/living/basic/halflife/chumtoad,
/turf/open/floor/plating/ground/rockunder,
/area/halflife/indoors/sewer/cave)
"w" = (
/obj/modular_map_connector,
/turf/template_noop,
/area/template_noop)
"z" = (
/obj/structure/flora/xen/leafy,
/turf/open/floor/plating/ground/rockunder,
/area/halflife/indoors/sewer/cave)
"G" = (
/turf/closed/mineral/random,
/area/halflife/indoors/sewer/cave)

(1,1,1) = {"
a
a
a
a
a
a
a
a
a
a
a
a
a
a
a
a
a
a
a
a
a
w
"}
(2,1,1) = {"
a
G
G
G
G
G
G
G
G
G
G
G
G
G
G
G
G
G
G
G
G
a
"}
(3,1,1) = {"
a
G
G
G
G
G
G
G
G
G
G
G
G
G
G
G
G
G
G
G
G
a
"}
(4,1,1) = {"
a
G
G
G
G
G
G
G
G
G
G
G
G
G
G
G
G
G
G
G
G
a
"}
(5,1,1) = {"
a
G
G
G
G
G
G
G
G
G
G
G
G
G
G
G
G
G
G
G
G
a
"}
(6,1,1) = {"
a
G
G
G
G
G
G
G
G
G
G
G
G
G
G
G
G
G
G
G
G
a
"}
(7,1,1) = {"
a
G
G
G
G
G
G
G
G
G
G
G
G
G
G
G
G
G
G
G
G
a
"}
(8,1,1) = {"
a
G
G
G
G
G
G
G
G
G
i
i
G
G
G
G
G
G
G
G
G
a
"}
(9,1,1) = {"
a
G
G
G
G
G
G
i
G
i
o
z
i
G
G
G
G
G
G
G
G
a
"}
(10,1,1) = {"
a
G
G
G
G
G
z
i
i
i
i
i
i
G
G
G
G
G
G
G
G
a
"}
(11,1,1) = {"
a
G
G
G
G
G
o
i
i
i
i
i
i
i
i
G
G
G
G
G
G
a
"}
(12,1,1) = {"
a
G
G
G
G
G
z
i
i
i
i
i
i
G
G
G
G
G
G
G
G
a
"}
(13,1,1) = {"
a
G
G
G
G
G
G
i
i
i
i
i
i
G
G
G
G
G
G
G
G
a
"}
(14,1,1) = {"
a
G
G
G
G
G
G
G
G
i
o
z
i
G
G
G
G
G
G
G
G
a
"}
(15,1,1) = {"
a
G
G
G
G
G
G
G
G
G
i
i
G
G
G
G
G
G
G
G
G
a
"}
(16,1,1) = {"
a
G
G
G
G
G
G
G
G
G
G
G
G
G
G
G
G
G
G
G
G
a
"}
(17,1,1) = {"
a
G
G
G
G
G
G
G
G
G
G
G
G
G
G
G
G
G
G
G
G
a
"}
(18,1,1) = {"
a
G
G
G
G
G
G
G
G
G
G
G
G
G
G
G
G
G
G
G
G
a
"}
(19,1,1) = {"
a
G
G
G
G
G
G
G
G
G
G
G
G
G
G
G
G
G
G
G
G
a
"}
(20,1,1) = {"
a
G
G
G
G
G
G
G
G
G
G
G
G
G
G
G
G
G
G
G
G
a
"}
(21,1,1) = {"
a
G
G
G
G
G
G
G
G
G
G
G
G
G
G
G
G
G
G
G
G
a
"}
(22,1,1) = {"
a
a
a
a
a
a
a
a
a
a
a
a
a
a
a
a
a
a
a
a
a
a
"}
