//MAP CONVERTED BY dmm2tgm.py THIS HEADER COMMENT PREVENTS RECONVERSION, DO NOT REMOVE
"a" = (
/turf/closed/mineral/random,
/area/halflife/indoors/sewer/cave)
"h" = (
/turf/template_noop,
/area/template_noop)
"i" = (
/obj/modular_map_connector,
/turf/template_noop,
/area/template_noop)
"I" = (
/turf/open/halflife/water/shallow,
/area/halflife/indoors/sewer/cave)
"R" = (
/turf/open/halflife/water/medium,
/area/halflife/indoors/sewer/cave)
"Z" = (
/turf/open/floor/plating/ground/rockunder,
/area/halflife/indoors/sewer/cave)

(1,1,1) = {"
h
h
h
h
h
h
h
h
h
h
h
h
h
h
h
h
h
h
h
h
h
i
"}
(2,1,1) = {"
h
a
a
a
a
a
a
a
a
a
a
a
a
a
a
a
a
a
a
a
a
h
"}
(3,1,1) = {"
h
a
a
a
a
a
a
a
a
a
a
a
a
a
a
a
a
a
a
a
a
h
"}
(4,1,1) = {"
h
a
a
a
a
a
a
a
a
a
a
a
a
a
a
a
a
a
a
a
a
h
"}
(5,1,1) = {"
h
a
a
a
a
a
a
a
a
a
a
a
a
a
a
a
a
a
a
a
a
h
"}
(6,1,1) = {"
h
a
a
a
a
a
a
a
a
Z
a
a
a
a
a
a
a
a
a
a
a
h
"}
(7,1,1) = {"
h
a
a
a
a
a
a
Z
Z
I
a
I
I
a
a
a
a
a
a
a
a
h
"}
(8,1,1) = {"
h
a
a
a
a
a
I
I
I
I
I
I
I
I
a
a
a
a
a
a
a
h
"}
(9,1,1) = {"
h
a
a
a
a
I
I
I
I
I
R
I
I
I
a
a
a
a
a
a
a
h
"}
(10,1,1) = {"
h
a
a
a
a
I
I
R
R
R
R
R
I
I
I
a
a
a
a
a
a
h
"}
(11,1,1) = {"
h
a
a
a
a
a
I
I
R
R
R
R
R
I
I
Z
a
a
a
a
a
h
"}
(12,1,1) = {"
h
a
a
a
a
a
a
I
R
R
R
R
I
I
I
Z
a
a
a
a
a
h
"}
(13,1,1) = {"
h
a
a
a
a
a
I
I
R
R
R
I
I
I
I
a
a
a
a
a
a
h
"}
(14,1,1) = {"
h
a
a
a
a
a
a
I
I
R
I
I
I
I
a
a
a
a
a
a
a
h
"}
(15,1,1) = {"
h
a
a
a
a
a
a
I
I
I
I
I
Z
Z
a
a
a
a
a
a
a
h
"}
(16,1,1) = {"
h
a
a
a
a
a
a
a
a
I
I
I
Z
a
a
a
a
a
a
a
a
h
"}
(17,1,1) = {"
h
a
a
a
a
a
a
a
a
a
a
Z
a
a
a
a
a
a
a
a
a
h
"}
(18,1,1) = {"
h
a
a
a
a
a
a
a
a
a
a
a
a
a
a
a
a
a
a
a
a
h
"}
(19,1,1) = {"
h
a
a
a
a
a
a
a
a
a
a
a
a
a
a
a
a
a
a
a
a
h
"}
(20,1,1) = {"
h
a
a
a
a
a
a
a
a
a
a
a
a
a
a
a
a
a
a
a
a
h
"}
(21,1,1) = {"
h
a
a
a
a
a
a
a
a
a
a
a
a
a
a
a
a
a
a
a
a
h
"}
(22,1,1) = {"
h
h
h
h
h
h
h
h
h
h
h
h
h
h
h
h
h
h
h
h
h
h
"}
