//MAP CONVERTED BY dmm2tgm.py THIS HEADER COMMENT PREVENTS RECONVERSION, DO NOT REMOVE
"a" = (
/turf/closed/mineral/random,
/area/halflife/indoors/sewer/cave)
"d" = (
/obj/effect/rune/crab_cultist,
/mob/living/basic/halflife/zombie/gonome/deployment,
/turf/open/floor/plating/ground/rockunder,
/area/halflife/indoors/sewer/cave)
"j" = (
/turf/open/floor/plating/ground/rockunder,
/area/halflife/indoors/sewer/cave)
"r" = (
/obj/item/clothing/suit/armor/platearmor,
/turf/open/floor/plating/ground/rockunder,
/area/halflife/indoors/sewer/cave)
"s" = (
/obj/item/clothing/head/helmet/halflife/headcrab,
/turf/open/floor/plating/ground/rockunder,
/area/halflife/indoors/sewer/cave)
"w" = (
/obj/modular_map_connector,
/turf/template_noop,
/area/template_noop)
"B" = (
/obj/item/food/meat/slab/halflife/zombie,
/turf/open/floor/plating/ground/rockunder,
/area/halflife/indoors/sewer/cave)
"D" = (
/obj/effect/decal/cleanable/blood/splatter,
/turf/open/floor/plating/ground/rockunder,
/area/halflife/indoors/sewer/cave)
"F" = (
/turf/template_noop,
/area/template_noop)
"N" = (
/obj/structure/barricade/wooden/solid,
/turf/open/floor/plating/ground/rockunder,
/area/halflife/indoors/sewer/cave)
"Q" = (
/obj/item/spear/halflife,
/turf/open/floor/plating/ground/rockunder,
/area/halflife/indoors/sewer/cave)

(1,1,1) = {"
F
F
F
F
F
F
F
F
F
F
F
F
F
F
F
F
F
F
F
F
F
w
"}
(2,1,1) = {"
F
a
a
a
a
a
a
a
a
a
a
a
a
a
a
a
a
a
a
a
a
F
"}
(3,1,1) = {"
F
a
a
a
a
a
a
a
a
a
a
a
a
a
a
a
a
a
a
a
a
F
"}
(4,1,1) = {"
F
a
a
a
a
a
a
a
a
a
a
a
a
a
a
a
a
a
a
a
a
F
"}
(5,1,1) = {"
F
a
a
a
a
a
a
a
a
a
a
a
a
a
a
a
a
a
a
a
a
F
"}
(6,1,1) = {"
F
a
a
a
a
a
a
a
a
a
a
a
a
a
a
a
a
a
a
a
a
F
"}
(7,1,1) = {"
F
a
a
a
a
a
a
a
a
a
a
a
a
a
a
a
a
a
a
a
a
F
"}
(8,1,1) = {"
F
a
a
a
a
a
a
a
a
j
N
N
a
a
a
a
a
a
a
a
a
F
"}
(9,1,1) = {"
F
a
a
a
a
a
a
a
j
j
j
j
j
a
a
a
a
a
a
a
a
F
"}
(10,1,1) = {"
F
a
a
a
a
a
a
N
j
r
D
Q
j
B
a
a
a
a
a
a
a
F
"}
(11,1,1) = {"
F
a
a
a
a
a
a
j
j
j
d
j
j
N
a
a
a
a
a
a
a
F
"}
(12,1,1) = {"
F
a
a
a
a
a
a
N
j
B
s
j
D
N
a
a
a
a
a
a
a
F
"}
(13,1,1) = {"
F
a
a
a
a
a
a
a
j
j
j
j
j
a
a
a
a
a
a
a
a
F
"}
(14,1,1) = {"
F
a
a
a
a
a
a
a
a
N
N
j
a
a
a
a
a
a
a
a
a
F
"}
(15,1,1) = {"
F
a
a
a
a
a
a
a
a
a
a
a
a
a
a
a
a
a
a
a
a
F
"}
(16,1,1) = {"
F
a
a
a
a
a
a
a
a
a
a
a
a
a
a
a
a
a
a
a
a
F
"}
(17,1,1) = {"
F
a
a
a
a
a
a
a
a
a
a
a
a
a
a
a
a
a
a
a
a
F
"}
(18,1,1) = {"
F
a
a
a
a
a
a
a
a
a
a
a
a
a
a
a
a
a
a
a
a
F
"}
(19,1,1) = {"
F
a
a
a
a
a
a
a
a
a
a
a
a
a
a
a
a
a
a
a
a
F
"}
(20,1,1) = {"
F
a
a
a
a
a
a
a
a
a
a
a
a
a
a
a
a
a
a
a
a
F
"}
(21,1,1) = {"
F
a
a
a
a
a
a
a
a
a
a
a
a
a
a
a
a
a
a
a
a
F
"}
(22,1,1) = {"
F
F
F
F
F
F
F
F
F
F
F
F
F
F
F
F
F
F
F
F
F
F
"}
