//MAP CONVERTED BY dmm2tgm.py THIS HEADER COMMENT PREVENTS RECONVERSION, DO NOT REMOVE
"a" = (
/turf/closed/mineral/random,
/area/halflife/indoors/sewer/cave)
"d" = (
/obj/modular_map_connector,
/turf/template_noop,
/area/template_noop)
"s" = (
/turf/template_noop,
/area/template_noop)
"t" = (
/obj/structure/closet/crate/halflife/wooden,
/obj/effect/spawner/random/halflife/loot/uncommon,
/obj/effect/spawner/random/halflife/loot/uncommon,
/turf/open/floor/plating/ground/rockunder,
/area/halflife/indoors/sewer/cave)
"u" = (
/obj/structure/closet/crate/halflife/wooden,
/obj/effect/spawner/random/halflife/loot,
/obj/effect/spawner/random/halflife/loot,
/turf/open/floor/plating/ground/rockunder,
/area/halflife/indoors/sewer/cave)
"v" = (
/obj/structure/closet/crate/halflife/wooden,
/obj/effect/spawner/random/halflife/loot/consumables,
/obj/effect/spawner/random/halflife/loot/consumables,
/turf/open/floor/plating/ground/rockunder,
/area/halflife/indoors/sewer/cave)
"B" = (
/turf/open/floor/plating/ground/rockunder,
/area/halflife/indoors/sewer/cave)
"G" = (
/obj/structure/flora/rock/style_random,
/turf/open/floor/plating/ground/rockunder,
/area/halflife/indoors/sewer/cave)
"W" = (
/obj/structure/barricade/wooden/solid,
/turf/open/floor/plating/ground/rockunder,
/area/halflife/indoors/sewer/cave)

(1,1,1) = {"
s
s
s
s
s
s
s
s
s
s
s
s
s
s
s
s
s
s
s
s
s
d
"}
(2,1,1) = {"
s
a
a
a
a
a
a
a
a
a
a
a
a
a
a
a
a
a
a
a
a
s
"}
(3,1,1) = {"
s
a
a
a
a
a
a
a
a
a
a
a
a
a
a
a
a
a
a
a
a
s
"}
(4,1,1) = {"
s
a
a
a
a
a
a
a
a
a
a
a
a
a
a
B
B
a
a
a
a
s
"}
(5,1,1) = {"
s
a
a
a
a
a
a
a
a
a
a
a
a
a
a
G
B
B
a
a
a
s
"}
(6,1,1) = {"
s
a
a
a
a
a
a
a
a
a
a
a
a
a
a
a
B
B
a
a
a
s
"}
(7,1,1) = {"
s
a
a
a
a
a
a
a
a
a
a
a
a
a
a
a
B
B
a
a
a
s
"}
(8,1,1) = {"
s
a
a
a
a
a
a
a
B
a
a
a
a
a
a
a
a
B
a
a
a
s
"}
(9,1,1) = {"
s
a
a
a
a
W
u
B
B
W
a
a
a
a
a
a
a
B
B
a
a
s
"}
(10,1,1) = {"
s
a
a
a
a
B
B
B
B
B
t
a
a
a
a
a
a
a
B
a
a
s
"}
(11,1,1) = {"
s
a
a
a
a
B
B
B
B
B
B
a
a
a
a
a
a
a
B
a
a
s
"}
(12,1,1) = {"
s
a
a
a
a
B
B
B
B
B
a
a
a
a
a
a
a
a
B
a
a
s
"}
(13,1,1) = {"
s
a
a
a
a
a
W
B
v
W
a
a
a
a
a
a
a
a
B
a
a
s
"}
(14,1,1) = {"
s
a
a
a
a
a
a
a
a
a
a
a
a
a
a
a
a
a
a
a
a
s
"}
(15,1,1) = {"
s
a
a
a
a
a
a
a
a
a
a
a
a
a
a
a
a
a
a
a
a
s
"}
(16,1,1) = {"
s
a
a
a
a
a
a
a
a
a
a
a
a
a
a
a
a
a
a
a
a
s
"}
(17,1,1) = {"
s
a
a
a
a
a
a
a
a
a
a
a
a
a
a
a
a
a
a
a
a
s
"}
(18,1,1) = {"
s
a
a
a
a
a
a
a
a
a
a
a
a
a
a
a
a
a
a
a
a
s
"}
(19,1,1) = {"
s
a
a
a
a
a
a
a
a
a
a
a
a
a
a
a
a
a
a
a
a
s
"}
(20,1,1) = {"
s
a
a
a
a
a
a
a
a
a
a
a
a
a
a
a
a
a
a
a
a
s
"}
(21,1,1) = {"
s
a
a
a
a
a
a
a
a
a
a
a
a
a
a
a
a
a
a
a
a
s
"}
(22,1,1) = {"
s
s
s
s
s
s
s
s
s
s
s
s
s
s
s
s
s
s
s
s
s
s
"}
