//MAP CONVERTED BY dmm2tgm.py THIS HEADER COMMENT PREVENTS RECONVERSION, DO NOT REMOVE
"a" = (
/turf/closed/mineral/random,
/area/halflife/indoors/sewer/cave)
"c" = (
/mob/living/basic/halflife/grub{
	dir = 4
	},
/turf/open/floor/plating/ground/rockunder,
/area/halflife/indoors/sewer/cave)
"k" = (
/mob/living/basic/halflife/grub,
/turf/open/floor/plating/ground/rockunder,
/area/halflife/indoors/sewer/cave)
"u" = (
/turf/open/floor/plating/ground/rockunder,
/area/halflife/indoors/sewer/cave)
"B" = (
/mob/living/simple_animal/hostile/halflife/antlion,
/turf/open/floor/plating/ground/rockunder,
/area/halflife/indoors/sewer/cave)
"N" = (
/mob/living/basic/halflife/grub{
	dir = 8
	},
/turf/open/floor/plating/ground/rockunder,
/area/halflife/indoors/sewer/cave)
"X" = (
/turf/template_noop,
/area/template_noop)

(1,1,1) = {"
X
X
X
X
X
X
X
X
X
X
X
X
X
X
X
X
X
X
X
X
X
X
"}
(2,1,1) = {"
X
a
a
a
a
a
a
a
a
a
a
a
a
a
a
a
a
a
a
a
a
X
"}
(3,1,1) = {"
X
a
a
a
a
a
u
a
a
a
a
a
a
a
a
a
a
a
a
a
a
X
"}
(4,1,1) = {"
X
a
a
u
u
u
u
a
a
a
a
a
a
a
a
a
a
a
a
a
a
X
"}
(5,1,1) = {"
X
a
a
u
u
u
a
a
a
a
a
a
a
a
a
a
a
a
a
a
a
X
"}
(6,1,1) = {"
X
a
a
a
u
a
a
a
a
a
a
a
a
a
a
a
u
u
a
a
a
X
"}
(7,1,1) = {"
X
a
a
u
u
u
a
a
a
a
a
a
a
a
a
a
a
u
u
a
a
X
"}
(8,1,1) = {"
X
a
a
u
u
a
a
u
u
u
a
a
a
a
u
a
a
u
u
a
a
X
"}
(9,1,1) = {"
X
a
a
a
a
a
a
u
u
u
u
u
a
c
u
a
a
a
a
a
a
X
"}
(10,1,1) = {"
X
a
a
a
a
a
a
a
N
u
u
u
u
u
u
a
a
a
a
a
a
X
"}
(11,1,1) = {"
X
a
a
a
a
a
a
a
u
u
B
u
u
u
a
a
a
a
a
a
a
X
"}
(12,1,1) = {"
X
a
a
a
a
a
a
a
u
u
u
u
u
a
a
a
a
a
a
a
a
X
"}
(13,1,1) = {"
X
a
a
a
a
a
a
u
a
k
u
u
u
a
a
a
a
a
a
a
a
X
"}
(14,1,1) = {"
X
a
a
a
a
a
u
u
a
a
u
u
a
a
u
u
u
a
a
a
a
X
"}
(15,1,1) = {"
X
a
a
a
a
a
u
u
u
u
u
a
a
a
a
u
u
a
a
a
a
X
"}
(16,1,1) = {"
X
a
a
u
a
a
a
u
u
a
u
a
a
a
a
u
u
u
a
a
a
X
"}
(17,1,1) = {"
X
a
a
u
u
a
a
a
a
a
a
a
a
a
a
u
u
u
a
a
a
X
"}
(18,1,1) = {"
X
a
a
a
u
u
u
a
a
a
a
a
a
a
a
u
a
a
a
a
a
X
"}
(19,1,1) = {"
X
a
a
a
a
a
a
a
a
a
a
a
a
a
a
a
a
a
a
a
a
X
"}
(20,1,1) = {"
X
a
a
a
a
a
a
a
a
a
a
a
a
a
a
a
a
a
a
a
a
X
"}
(21,1,1) = {"
X
a
a
a
a
a
a
a
a
a
a
a
a
a
a
a
a
a
a
a
a
X
"}
(22,1,1) = {"
X
X
X
X
X
X
X
X
X
X
X
X
X
X
X
X
X
X
X
X
X
X
"}
