//MAP CONVERTED BY dmm2tgm.py THIS HEADER COMMENT PREVENTS RECONVERSION, DO NOT REMOVE
"a" = (
/turf/template_noop,
/area/template_noop)
"b" = (
/obj/structure/flora/rock/style_random,
/obj/effect/spawner/random/halflife/loot,
/turf/open/floor/plating/ground/rockunder,
/area/halflife/indoors/sewer/cave)
"i" = (
/obj/structure/flora/rock/style_random,
/turf/open/floor/plating/ground/rockunder,
/area/halflife/indoors/sewer/cave)
"j" = (
/turf/closed/mineral/random,
/area/halflife/indoors/sewer/cave)
"S" = (
/turf/open/floor/plating/ground/rockunder,
/area/halflife/indoors/sewer/cave)
"Y" = (
/obj/modular_map_connector,
/turf/template_noop,
/area/template_noop)

(1,1,1) = {"
a
a
a
a
a
a
a
a
a
a
a
a
a
a
a
a
a
a
a
a
a
Y
"}
(2,1,1) = {"
a
j
j
j
j
j
j
j
j
j
j
j
j
j
j
j
j
j
j
j
j
a
"}
(3,1,1) = {"
a
j
j
j
j
j
j
j
j
j
j
j
j
j
j
j
j
j
j
j
j
a
"}
(4,1,1) = {"
a
j
j
j
j
j
j
j
j
j
j
j
j
j
j
j
j
j
j
j
j
a
"}
(5,1,1) = {"
a
j
j
j
j
j
S
j
j
i
S
S
S
j
j
j
j
j
j
j
j
a
"}
(6,1,1) = {"
a
j
j
j
j
S
S
j
j
S
S
S
S
S
j
j
j
j
j
j
j
a
"}
(7,1,1) = {"
a
j
j
j
S
j
S
S
S
S
S
S
S
S
j
j
j
j
j
j
j
a
"}
(8,1,1) = {"
a
j
j
S
S
S
S
S
S
S
S
S
S
S
S
j
S
j
j
j
j
a
"}
(9,1,1) = {"
a
j
j
j
S
S
S
S
S
S
S
S
S
S
S
S
S
j
j
j
j
a
"}
(10,1,1) = {"
a
j
j
j
S
S
S
S
S
j
j
j
S
S
S
S
S
j
j
j
j
a
"}
(11,1,1) = {"
a
j
j
j
S
S
S
S
S
j
b
j
S
S
S
S
S
i
j
j
j
a
"}
(12,1,1) = {"
a
j
j
j
S
S
S
S
S
j
j
j
S
S
S
S
S
S
j
j
j
a
"}
(13,1,1) = {"
a
j
j
j
i
S
S
S
S
S
S
S
S
S
S
S
S
S
j
j
j
a
"}
(14,1,1) = {"
a
j
j
j
j
S
S
S
S
S
S
S
S
S
S
S
S
S
j
j
j
a
"}
(15,1,1) = {"
a
j
j
j
j
j
S
S
S
S
S
S
S
S
S
S
S
S
j
j
j
a
"}
(16,1,1) = {"
a
j
j
j
j
j
j
j
S
S
S
S
S
S
S
j
j
j
j
j
j
a
"}
(17,1,1) = {"
a
j
j
j
j
j
j
j
S
S
S
S
S
S
j
j
j
j
j
j
j
a
"}
(18,1,1) = {"
a
j
j
j
j
j
j
j
j
i
S
j
j
j
j
j
j
j
j
j
j
a
"}
(19,1,1) = {"
a
j
j
j
j
j
j
j
j
j
j
j
j
j
j
j
j
j
j
j
j
a
"}
(20,1,1) = {"
a
j
j
j
j
j
j
j
j
j
j
j
j
j
j
j
j
j
j
j
j
a
"}
(21,1,1) = {"
a
j
j
j
j
j
j
j
j
j
j
j
j
j
j
j
j
j
j
j
j
a
"}
(22,1,1) = {"
a
a
a
a
a
a
a
a
a
a
a
a
a
a
a
a
a
a
a
a
a
a
"}
