//MAP CONVERTED BY dmm2tgm.py THIS HEADER COMMENT PREVENTS RECONVERSION, DO NOT REMOVE
"a" = (
/turf/template_noop,
/area/template_noop)
"c" = (
/obj/structure/flora/rock/style_random,
/turf/open/floor/plating/ground/rockunder,
/area/halflife/indoors/sewer/cave)
"f" = (
/obj/effect/decal/cleanable/blood/old,
/obj/effect/spawner/random/halflife/loot/uncommon,
/turf/open/floor/plating/ground/rockunder,
/area/halflife/indoors/sewer/cave)
"g" = (
/turf/closed/mineral/random,
/area/halflife/indoors/sewer/cave)
"n" = (
/mob/living/basic/halflife/zombie/fungal,
/turf/open/floor/plating/ground/rockunder,
/area/halflife/indoors/sewer/cave)
"A" = (
/obj/effect/decal/cleanable/blood/trails{
	dir = 6
	},
/turf/open/floor/plating/ground/rockunder,
/area/halflife/indoors/sewer/cave)
"B" = (
/obj/effect/spawner/random/halflife/loot,
/turf/open/floor/plating/ground/rockunder,
/area/halflife/indoors/sewer/cave)
"C" = (
/obj/structure/alien/weeds/node,
/turf/open/floor/plating/ground/rockunder,
/area/halflife/indoors/sewer/cave)
"E" = (
/obj/structure/flora/xen/leafy,
/turf/open/floor/plating/ground/rockunder,
/area/halflife/indoors/sewer/cave)
"L" = (
/obj/effect/decal/cleanable/blood/trails{
	dir = 9
	},
/turf/open/floor/plating/ground/rockunder,
/area/halflife/indoors/sewer/cave)
"Q" = (
/obj/structure/flora/xen/tinyshrooms,
/turf/open/floor/plating/ground/rockunder,
/area/halflife/indoors/sewer/cave)
"S" = (
/obj/effect/decal/cleanable/blood/trails{
	dir = 1
	},
/turf/open/floor/plating/ground/rockunder,
/area/halflife/indoors/sewer/cave)
"U" = (
/turf/open/floor/plating/ground/rockunder,
/area/halflife/indoors/sewer/cave)

(1,1,1) = {"
a
a
a
a
a
a
a
a
a
a
a
a
a
a
a
a
a
a
a
a
a
a
"}
(2,1,1) = {"
a
g
g
g
g
g
g
g
g
g
g
g
g
g
g
g
g
g
g
g
g
a
"}
(3,1,1) = {"
a
g
g
g
g
g
g
g
U
g
g
g
g
g
g
g
g
g
g
g
g
a
"}
(4,1,1) = {"
a
g
g
g
g
g
g
g
U
U
g
g
g
g
g
g
g
g
g
g
g
a
"}
(5,1,1) = {"
a
g
g
g
g
g
g
g
g
U
U
U
g
U
U
U
g
g
g
g
g
a
"}
(6,1,1) = {"
a
g
g
g
g
g
g
g
g
g
U
U
U
U
U
U
g
g
g
g
g
a
"}
(7,1,1) = {"
a
g
g
g
g
g
g
g
g
g
g
g
U
U
U
g
g
g
g
g
g
a
"}
(8,1,1) = {"
a
g
g
g
g
g
U
g
g
g
g
g
g
g
g
g
g
g
g
g
g
a
"}
(9,1,1) = {"
a
g
g
g
c
g
U
U
g
g
g
g
g
g
g
g
g
g
g
g
g
a
"}
(10,1,1) = {"
a
g
g
g
U
U
U
U
U
g
g
g
U
U
g
g
g
g
g
g
g
a
"}
(11,1,1) = {"
a
g
g
g
U
U
g
g
U
g
g
g
U
U
U
g
g
g
U
g
g
a
"}
(12,1,1) = {"
a
g
g
g
U
U
g
g
U
U
g
g
g
U
U
g
g
g
U
g
g
a
"}
(13,1,1) = {"
a
g
g
g
U
U
B
C
g
U
U
g
g
g
U
g
g
U
U
g
g
a
"}
(14,1,1) = {"
a
g
g
g
g
U
E
U
U
g
U
g
g
g
g
g
g
c
U
g
g
a
"}
(15,1,1) = {"
a
g
g
g
g
U
U
L
f
U
U
U
g
g
g
g
g
U
U
g
g
a
"}
(16,1,1) = {"
a
g
g
g
U
S
S
A
n
U
U
C
g
g
g
g
g
U
U
g
g
a
"}
(17,1,1) = {"
a
g
g
U
U
U
U
Q
g
g
U
U
g
g
g
g
U
U
U
g
g
a
"}
(18,1,1) = {"
a
g
g
C
U
B
U
g
g
U
U
g
g
g
g
g
U
U
g
g
g
a
"}
(19,1,1) = {"
a
g
g
g
g
g
g
g
g
g
g
g
g
g
g
U
U
g
g
g
g
a
"}
(20,1,1) = {"
a
g
g
g
g
g
g
g
g
g
g
g
g
g
g
g
g
g
g
g
g
a
"}
(21,1,1) = {"
a
g
g
g
g
g
g
g
g
g
g
g
g
g
g
g
g
g
g
g
g
a
"}
(22,1,1) = {"
a
a
a
a
a
a
a
a
a
a
a
a
a
a
a
a
a
a
a
a
a
a
"}
