//MAP CONVERTED BY dmm2tgm.py THIS HEADER COMMENT PREVENTS RECONVERSION, DO NOT REMOVE
"a" = (
/turf/template_noop,
/area/template_noop)
"c" = (
/obj/structure/flora/rock/style_random,
/turf/open/floor/plating/ground/rockunder,
/area/halflife/indoors/sewer/cave)
"g" = (
/turf/closed/mineral/random,
/area/halflife/indoors/sewer/cave)
"v" = (
/obj/modular_map_connector,
/turf/template_noop,
/area/template_noop)
"D" = (
/turf/open/floor/plating/ground/rockunder,
/area/halflife/indoors/sewer/cave)

(1,1,1) = {"
a
a
a
a
a
a
a
a
a
a
a
a
a
a
a
a
a
a
a
a
a
v
"}
(2,1,1) = {"
a
g
g
g
g
g
g
g
g
g
g
g
g
g
g
g
g
g
g
g
g
a
"}
(3,1,1) = {"
a
g
g
g
g
g
g
g
g
g
g
g
g
g
g
g
g
g
g
g
g
a
"}
(4,1,1) = {"
a
g
g
g
g
g
g
g
g
g
g
g
g
g
g
g
g
g
g
g
g
a
"}
(5,1,1) = {"
a
g
g
g
g
g
g
g
g
g
g
g
g
g
g
g
g
g
D
g
g
a
"}
(6,1,1) = {"
a
g
g
g
g
g
g
g
g
g
g
g
g
g
g
g
D
D
c
g
g
a
"}
(7,1,1) = {"
a
g
g
g
g
g
D
D
D
g
g
g
g
g
g
g
D
D
g
g
g
a
"}
(8,1,1) = {"
a
g
g
g
g
g
c
D
D
g
g
g
g
g
g
c
D
g
g
g
g
a
"}
(9,1,1) = {"
a
g
g
g
g
g
g
g
D
D
D
g
g
g
g
D
D
g
g
g
g
a
"}
(10,1,1) = {"
a
g
g
g
g
g
g
g
D
D
D
g
g
g
g
D
g
g
g
g
g
a
"}
(11,1,1) = {"
a
g
g
g
g
g
g
g
g
g
D
D
g
g
g
D
g
g
g
g
g
a
"}
(12,1,1) = {"
a
g
g
g
D
D
g
g
g
g
g
D
D
g
g
D
g
g
g
g
g
a
"}
(13,1,1) = {"
a
g
g
c
D
g
g
g
g
D
D
D
c
D
D
D
g
g
g
g
g
a
"}
(14,1,1) = {"
a
g
g
D
g
g
g
g
D
D
D
g
g
D
g
g
g
g
g
g
g
a
"}
(15,1,1) = {"
a
g
g
D
g
g
g
D
D
g
g
g
g
g
g
g
g
g
g
g
g
a
"}
(16,1,1) = {"
a
g
g
D
g
g
g
D
D
g
g
g
g
g
g
g
g
g
g
g
g
a
"}
(17,1,1) = {"
a
g
g
D
c
g
g
g
g
g
g
g
g
g
g
g
g
g
g
g
g
a
"}
(18,1,1) = {"
a
g
g
g
D
g
g
g
g
g
g
g
g
g
g
g
g
g
g
g
g
a
"}
(19,1,1) = {"
a
g
g
g
g
g
g
g
g
g
g
g
g
g
g
g
g
g
g
g
g
a
"}
(20,1,1) = {"
a
g
g
g
g
g
g
g
g
g
g
g
g
g
g
g
g
g
g
g
g
a
"}
(21,1,1) = {"
a
g
g
g
g
g
g
g
g
g
g
g
g
g
g
g
g
g
g
g
g
a
"}
(22,1,1) = {"
a
a
a
a
a
a
a
a
a
a
a
a
a
a
a
a
a
a
a
a
a
a
"}
