//MAP CONVERTED BY dmm2tgm.py THIS HEADER COMMENT PREVENTS RECONVERSION, DO NOT REMOVE
"a" = (
/turf/closed/mineral/random,
/area/halflife/indoors/sewer/cave)
"u" = (
/turf/open/floor/plating/ground/rockunder,
/area/halflife/indoors/sewer/cave)
"y" = (
/obj/effect/spawner/random/halflife/loot/clothing,
/turf/open/floor/plating/ground/rockunder,
/area/halflife/indoors/sewer/cave)
"G" = (
/mob/living/basic/halflife/headcrab,
/turf/open/floor/plating/ground/rockunder,
/area/halflife/indoors/sewer/cave)
"L" = (
/obj/effect/spawner/random/halflife/loot/rare,
/turf/open/floor/plating/ground/rockunder,
/area/halflife/indoors/sewer/cave)
"R" = (
/turf/template_noop,
/area/template_noop)
"X" = (
/obj/effect/spawner/random/halflife/loot/ammo,
/turf/open/floor/plating/ground/rockunder,
/area/halflife/indoors/sewer/cave)

(1,1,1) = {"
R
R
R
R
R
R
R
R
R
R
R
R
R
R
R
R
R
R
R
R
R
R
"}
(2,1,1) = {"
R
a
a
a
a
a
a
a
a
a
a
a
a
a
a
a
a
a
a
a
a
R
"}
(3,1,1) = {"
R
a
a
a
a
a
a
a
a
a
a
a
a
a
a
a
a
a
a
a
a
R
"}
(4,1,1) = {"
R
a
a
a
a
a
a
a
a
a
a
a
a
a
a
a
a
a
a
a
a
R
"}
(5,1,1) = {"
R
a
a
a
a
a
u
u
u
a
a
a
a
a
a
a
a
a
a
a
a
R
"}
(6,1,1) = {"
R
a
a
a
u
u
u
u
a
a
a
a
u
a
a
a
a
a
a
a
a
R
"}
(7,1,1) = {"
R
a
a
a
u
u
u
u
a
a
a
u
u
u
a
a
a
a
a
a
a
R
"}
(8,1,1) = {"
R
a
a
u
u
a
a
a
a
a
a
a
u
u
a
a
a
a
a
a
a
R
"}
(9,1,1) = {"
R
a
a
u
u
a
a
a
a
a
a
u
u
u
u
u
a
a
a
a
a
R
"}
(10,1,1) = {"
R
a
a
u
a
a
a
a
u
a
a
u
u
a
u
u
u
u
a
a
a
R
"}
(11,1,1) = {"
R
a
a
a
a
a
u
u
u
u
u
a
a
a
u
a
u
a
a
a
a
R
"}
(12,1,1) = {"
R
a
a
a
a
a
a
G
u
u
u
a
a
a
a
a
a
u
a
a
a
R
"}
(13,1,1) = {"
R
a
a
a
a
u
u
u
u
u
y
u
u
a
a
a
a
a
a
a
a
R
"}
(14,1,1) = {"
R
a
a
a
a
u
a
L
u
u
G
u
u
a
a
a
a
a
a
a
a
R
"}
(15,1,1) = {"
R
a
a
a
a
u
u
u
u
u
u
u
a
a
a
u
a
a
a
a
a
R
"}
(16,1,1) = {"
R
a
a
a
a
a
u
G
u
u
u
a
a
a
a
u
a
a
a
a
a
R
"}
(17,1,1) = {"
R
a
a
a
a
a
u
u
u
u
X
a
a
a
u
u
u
a
a
a
a
R
"}
(18,1,1) = {"
R
a
a
a
a
a
a
a
u
u
u
a
a
u
u
u
a
a
a
a
a
R
"}
(19,1,1) = {"
R
a
a
a
a
a
a
a
a
a
a
a
a
a
a
a
a
a
a
a
a
R
"}
(20,1,1) = {"
R
a
a
a
a
a
a
a
a
a
a
a
a
a
a
a
a
a
a
a
a
R
"}
(21,1,1) = {"
R
a
a
a
a
a
a
a
a
a
a
a
a
a
a
a
a
a
a
a
a
R
"}
(22,1,1) = {"
R
R
R
R
R
R
R
R
R
R
R
R
R
R
R
R
R
R
R
R
R
R
"}
