//MAP CONVERTED BY dmm2tgm.py THIS HEADER COMMENT PREVENTS RECONVERSION, DO NOT REMOVE
"a" = (
/turf/closed/mineral/random,
/area/halflife/indoors/sewer/cave)
"j" = (
/mob/living/basic/halflife/grub,
/turf/open/floor/plating/ground/rockunder,
/area/halflife/indoors/sewer/cave)
"u" = (
/turf/open/floor/plating/ground/rockunder,
/area/halflife/indoors/sewer/cave)
"C" = (
/mob/living/basic/halflife/grub{
	dir = 4
	},
/turf/open/floor/plating/ground/rockunder,
/area/halflife/indoors/sewer/cave)
"H" = (
/turf/template_noop,
/area/template_noop)
"R" = (
/obj/structure/flora/rock/style_random,
/turf/open/floor/plating/ground/rockunder,
/area/halflife/indoors/sewer/cave)
"S" = (
/mob/living/basic/halflife/grub{
	dir = 8
	},
/turf/open/floor/plating/ground/rockunder,
/area/halflife/indoors/sewer/cave)
"W" = (
/mob/living/simple_animal/hostile/halflife/antlion,
/turf/open/floor/plating/ground/rockunder,
/area/halflife/indoors/sewer/cave)

(1,1,1) = {"
H
H
H
H
H
H
H
H
H
H
H
H
H
H
H
H
H
H
H
H
H
H
"}
(2,1,1) = {"
H
a
a
a
a
a
a
a
a
a
a
a
a
a
a
a
a
a
a
a
a
H
"}
(3,1,1) = {"
H
a
a
a
a
a
u
a
a
a
a
a
a
a
a
a
a
a
a
a
a
H
"}
(4,1,1) = {"
H
a
a
u
u
u
u
a
a
a
a
a
a
a
a
a
a
a
a
a
a
H
"}
(5,1,1) = {"
H
a
a
R
u
u
a
a
a
a
a
a
a
a
a
a
a
a
a
a
a
H
"}
(6,1,1) = {"
H
a
a
a
u
a
a
a
a
a
a
a
a
a
a
a
u
u
a
a
a
H
"}
(7,1,1) = {"
H
a
a
u
u
u
a
a
a
a
a
a
a
a
a
a
a
u
u
a
a
H
"}
(8,1,1) = {"
H
a
a
u
u
a
a
u
u
u
a
a
a
a
u
a
a
u
u
a
a
H
"}
(9,1,1) = {"
H
a
a
a
a
a
a
u
u
u
u
u
a
C
u
a
a
a
a
a
a
H
"}
(10,1,1) = {"
H
a
a
a
a
a
a
a
S
u
u
u
u
u
u
a
a
a
a
a
a
H
"}
(11,1,1) = {"
H
a
a
a
a
a
a
a
u
u
W
u
u
u
a
a
a
a
a
a
a
H
"}
(12,1,1) = {"
H
a
a
a
a
a
a
a
u
u
u
u
R
a
a
a
a
a
a
a
a
H
"}
(13,1,1) = {"
H
a
a
a
a
a
a
u
a
j
u
u
u
a
a
a
a
a
a
a
a
H
"}
(14,1,1) = {"
H
a
a
a
a
a
u
u
a
a
u
u
a
a
u
u
u
a
a
a
a
H
"}
(15,1,1) = {"
H
a
a
a
a
a
u
u
u
u
u
a
a
a
a
u
u
a
a
a
a
H
"}
(16,1,1) = {"
H
a
a
u
a
a
a
u
u
a
u
a
a
a
a
u
u
u
a
a
a
H
"}
(17,1,1) = {"
H
a
a
u
u
a
a
a
a
a
a
a
a
a
a
u
u
u
a
a
a
H
"}
(18,1,1) = {"
H
a
a
a
u
u
u
a
a
a
a
a
a
a
a
u
a
a
a
a
a
H
"}
(19,1,1) = {"
H
a
a
a
a
a
a
a
a
a
a
a
a
a
a
a
a
a
a
a
a
H
"}
(20,1,1) = {"
H
a
a
a
a
a
a
a
a
a
a
a
a
a
a
a
a
a
a
a
a
H
"}
(21,1,1) = {"
H
a
a
a
a
a
a
a
a
a
a
a
a
a
a
a
a
a
a
a
a
H
"}
(22,1,1) = {"
H
H
H
H
H
H
H
H
H
H
H
H
H
H
H
H
H
H
H
H
H
H
"}
