//MAP CONVERTED BY dmm2tgm.py THIS HEADER COMMENT PREVENTS RECONVERSION, DO NOT REMOVE
"a" = (
/turf/closed/mineral/random,
/area/halflife/indoors/sewer/cave)
"c" = (
/obj/effect/spawner/random/halflife/loot,
/turf/open/floor/plating/ground/rockunder,
/area/halflife/indoors/sewer/cave)
"d" = (
/obj/structure/spawner/halflife/antlion/small,
/turf/open/floor/plating/ground/rockunder,
/area/halflife/indoors/sewer/cave)
"m" = (
/obj/structure/spawner/halflife/antlion/small/worker,
/turf/open/floor/plating/ground/rockunder,
/area/halflife/indoors/sewer/cave)
"t" = (
/mob/living/basic/halflife/grub,
/turf/open/floor/plating/ground/rockunder,
/area/halflife/indoors/sewer/cave)
"x" = (
/turf/open/floor/plating/ground/rockunder,
/area/halflife/indoors/sewer/cave)
"C" = (
/mob/living/basic/halflife/grub{
	dir = 4
	},
/turf/open/floor/plating/ground/rockunder,
/area/halflife/indoors/sewer/cave)
"I" = (
/mob/living/basic/halflife/grub{
	dir = 1
	},
/turf/open/floor/plating/ground/rockunder,
/area/halflife/indoors/sewer/cave)
"S" = (
/obj/effect/spawner/random/halflife/loot/uncommon,
/turf/open/floor/plating/ground/rockunder,
/area/halflife/indoors/sewer/cave)
"T" = (
/mob/living/basic/halflife/grub{
	dir = 8
	},
/turf/open/floor/plating/ground/rockunder,
/area/halflife/indoors/sewer/cave)
"V" = (
/turf/template_noop,
/area/template_noop)
"Z" = (
/obj/structure/flora/rock/style_random,
/turf/open/floor/plating/ground/rockunder,
/area/halflife/indoors/sewer/cave)

(1,1,1) = {"
V
V
V
V
V
V
V
V
V
V
V
V
V
V
V
V
V
V
V
V
V
V
"}
(2,1,1) = {"
V
a
a
a
a
a
a
a
a
a
a
a
a
a
a
a
a
a
a
a
a
V
"}
(3,1,1) = {"
V
a
a
a
a
a
a
a
a
a
a
a
a
a
a
a
a
a
a
a
a
V
"}
(4,1,1) = {"
V
a
a
a
a
a
a
a
a
a
a
a
a
a
x
x
a
a
a
a
a
V
"}
(5,1,1) = {"
V
a
a
a
a
a
x
x
x
x
x
x
x
a
x
x
x
a
a
a
a
V
"}
(6,1,1) = {"
V
a
a
a
a
x
x
c
C
x
x
x
x
Z
a
a
x
a
a
a
a
V
"}
(7,1,1) = {"
V
a
a
a
x
x
x
x
x
m
x
x
x
x
x
x
x
a
a
a
a
V
"}
(8,1,1) = {"
V
a
a
a
x
x
t
x
x
x
x
x
x
x
x
x
x
x
a
a
a
V
"}
(9,1,1) = {"
V
a
a
a
Z
x
x
x
x
x
a
c
x
x
x
c
x
x
a
a
a
V
"}
(10,1,1) = {"
V
a
a
a
x
x
x
d
x
a
a
a
a
x
x
I
x
x
x
a
a
V
"}
(11,1,1) = {"
V
a
a
a
x
x
c
x
x
x
S
a
x
x
d
x
x
x
x
a
a
V
"}
(12,1,1) = {"
V
a
a
a
x
x
x
x
a
T
c
a
x
x
x
x
x
x
Z
a
a
V
"}
(13,1,1) = {"
V
a
a
a
x
a
t
x
a
a
a
a
x
x
x
x
x
x
a
a
a
V
"}
(14,1,1) = {"
V
a
a
a
x
a
a
x
T
a
x
x
x
x
x
x
x
x
a
a
a
V
"}
(15,1,1) = {"
V
a
a
a
x
x
a
a
a
x
x
x
x
x
a
a
x
a
a
a
a
V
"}
(16,1,1) = {"
V
a
a
a
x
a
a
a
a
a
x
x
x
a
a
a
a
a
a
a
a
V
"}
(17,1,1) = {"
V
a
a
a
a
x
x
x
x
x
a
a
a
a
a
a
a
a
a
a
a
V
"}
(18,1,1) = {"
V
a
a
a
a
a
x
x
x
a
a
a
a
a
a
a
a
a
a
a
a
V
"}
(19,1,1) = {"
V
a
a
a
a
a
a
a
a
a
a
a
a
a
a
a
a
a
a
a
a
V
"}
(20,1,1) = {"
V
a
a
a
a
a
a
a
a
a
a
a
a
a
a
a
a
a
a
a
a
V
"}
(21,1,1) = {"
V
a
a
a
a
a
a
a
a
a
a
a
a
a
a
a
a
a
a
a
a
V
"}
(22,1,1) = {"
V
V
V
V
V
V
V
V
V
V
V
V
V
V
V
V
V
V
V
V
V
V
"}
