//MAP CONVERTED BY dmm2tgm.py THIS HEADER COMMENT PREVENTS RECONVERSION, DO NOT REMOVE
"a" = (
/turf/closed/mineral/random,
/area/halflife/indoors/sewer/cave)
"e" = (
/obj/structure/halflife/trash/wood{
	dir = 6
	},
/turf/open/floor/plating/ground/rockunder,
/area/halflife/indoors/sewer/cave)
"k" = (
/obj/structure/halflife/trash/wood{
	pixel_x = 0;
	pixel_y = 6
	},
/turf/open/floor/plating/ground/rockunder,
/area/halflife/indoors/sewer/cave)
"t" = (
/obj/structure/table/halflife/wood/constructed/cobbled,
/obj/effect/spawner/random/halflife/loot/consumables,
/turf/open/floor/plating/ground/rockunder,
/area/halflife/indoors/sewer/cave)
"u" = (
/obj/structure/halflife/trash/wood,
/turf/open/floor/plating/ground/rockunder,
/area/halflife/indoors/sewer/cave)
"x" = (
/turf/template_noop,
/area/template_noop)
"A" = (
/obj/item/clothing/head/utility/hardhat/halflife/mining,
/turf/open/floor/plating/ground/rockunder,
/area/halflife/indoors/sewer/cave)
"C" = (
/obj/effect/mob_spawn/corpse/human/citizen,
/turf/open/floor/plating/ground/rockunder,
/area/halflife/indoors/sewer/cave)
"F" = (
/obj/structure/halflife/trash/wood{
	dir = 1
	},
/turf/open/floor/plating/ground/rockunder,
/area/halflife/indoors/sewer/cave)
"H" = (
/obj/item/trash/halflife/nutrient_bar_waste/water,
/turf/open/floor/plating/ground/rockunder,
/area/halflife/indoors/sewer/cave)
"K" = (
/obj/item/reagent_containers/cup/soda_cans/breenwater/empty,
/turf/open/floor/plating/ground/rockunder,
/area/halflife/indoors/sewer/cave)
"Q" = (
/obj/modular_map_connector,
/turf/template_noop,
/area/template_noop)
"R" = (
/turf/open/floor/plating/ground/rockunder,
/area/halflife/indoors/sewer/cave)
"S" = (
/obj/item/pickaxe,
/obj/structure/table/halflife/wood/constructed/cobbled,
/turf/open/floor/plating/ground/rockunder,
/area/halflife/indoors/sewer/cave)
"Y" = (
/obj/structure/barricade/wooden/solid,
/turf/open/floor/plating/ground/rockunder,
/area/halflife/indoors/sewer/cave)

(1,1,1) = {"
x
x
x
x
x
x
x
x
x
x
x
x
x
x
x
x
x
x
x
x
x
Q
"}
(2,1,1) = {"
x
a
a
a
a
a
a
a
a
a
a
a
a
a
a
a
a
a
a
a
a
x
"}
(3,1,1) = {"
x
a
a
a
a
a
a
a
a
a
a
a
a
a
a
a
a
a
a
a
a
x
"}
(4,1,1) = {"
x
a
a
a
a
a
a
a
a
a
a
a
a
a
a
a
a
a
u
e
a
x
"}
(5,1,1) = {"
x
a
a
a
a
a
a
a
a
a
a
a
a
a
a
a
a
a
R
R
a
x
"}
(6,1,1) = {"
x
a
a
a
a
a
a
a
a
a
a
a
a
a
a
a
a
a
R
R
a
x
"}
(7,1,1) = {"
x
a
a
a
a
a
a
a
a
a
a
a
a
a
a
a
a
Y
R
R
a
x
"}
(8,1,1) = {"
x
a
a
a
a
a
a
u
a
a
a
k
a
a
a
a
a
a
R
R
a
x
"}
(9,1,1) = {"
x
a
a
a
a
a
R
R
a
a
u
R
R
a
a
a
a
R
R
R
a
x
"}
(10,1,1) = {"
x
a
a
a
a
a
R
R
F
a
a
Y
R
a
Y
a
R
R
R
a
a
x
"}
(11,1,1) = {"
x
a
a
a
a
Y
R
R
a
a
a
a
R
R
R
R
R
R
Y
a
a
x
"}
(12,1,1) = {"
x
a
a
a
a
R
R
Y
a
a
a
a
R
R
R
R
R
a
a
a
a
x
"}
(13,1,1) = {"
x
a
Y
K
R
R
R
a
a
a
a
a
S
t
R
a
a
a
a
a
a
x
"}
(14,1,1) = {"
x
a
R
R
R
R
H
a
a
a
a
a
a
a
a
a
a
a
a
a
a
x
"}
(15,1,1) = {"
x
a
R
C
R
R
R
Y
a
a
a
a
a
a
a
a
a
a
a
a
a
x
"}
(16,1,1) = {"
x
a
R
A
R
R
R
a
a
a
a
a
a
a
a
a
a
a
a
a
a
x
"}
(17,1,1) = {"
x
a
Y
R
H
R
R
a
a
a
a
a
a
a
a
a
a
a
a
a
a
x
"}
(18,1,1) = {"
x
a
a
R
R
R
a
a
a
a
a
a
a
a
a
a
a
a
a
a
a
x
"}
(19,1,1) = {"
x
a
a
Y
R
R
a
a
a
a
a
a
a
a
a
a
a
a
a
a
a
x
"}
(20,1,1) = {"
x
a
a
a
a
a
a
a
a
a
a
a
a
a
a
a
a
a
a
a
a
x
"}
(21,1,1) = {"
x
a
a
a
a
a
a
a
a
a
a
a
a
a
a
a
a
a
a
a
a
x
"}
(22,1,1) = {"
x
x
x
x
x
x
x
x
x
x
x
x
x
x
x
x
x
x
x
x
x
x
"}
