//MAP CONVERTED BY dmm2tgm.py THIS HEADER COMMENT PREVENTS RECONVERSION, DO NOT REMOVE
"a" = (
/turf/closed/mineral/random,
/area/halflife/indoors/sewer/cave)
"e" = (
/turf/open/floor/plating/ground/rockunder,
/area/halflife/indoors/sewer/cave)
"E" = (
/obj/effect/spawner/random/halflife/loot,
/turf/open/floor/plating/ground/rockunder,
/area/halflife/indoors/sewer/cave)
"F" = (
/turf/template_noop,
/area/template_noop)
"O" = (
/obj/structure/flora/rock/style_random,
/turf/open/floor/plating/ground/rockunder,
/area/halflife/indoors/sewer/cave)
"R" = (
/obj/modular_map_connector,
/turf/template_noop,
/area/template_noop)

(1,1,1) = {"
F
F
F
F
F
F
F
F
F
F
F
F
F
F
F
F
F
F
F
F
F
R
"}
(2,1,1) = {"
F
a
a
a
a
a
a
a
a
a
a
a
a
a
a
a
a
a
a
a
a
F
"}
(3,1,1) = {"
F
a
a
a
a
O
a
a
a
a
a
a
a
a
a
a
a
a
a
a
a
F
"}
(4,1,1) = {"
F
a
a
a
E
e
E
a
a
e
e
a
a
a
a
a
a
a
a
a
a
F
"}
(5,1,1) = {"
F
a
a
a
e
e
E
a
a
e
e
a
a
a
a
a
a
a
a
a
a
F
"}
(6,1,1) = {"
F
a
a
a
a
a
a
a
a
O
e
a
a
a
e
O
a
a
a
a
a
F
"}
(7,1,1) = {"
F
a
a
a
a
e
a
a
a
e
e
a
e
e
e
e
e
e
a
a
a
F
"}
(8,1,1) = {"
F
a
a
a
a
e
a
a
a
e
e
e
e
e
a
a
e
e
a
a
a
F
"}
(9,1,1) = {"
F
a
a
a
a
O
e
a
a
a
e
e
e
a
a
a
a
e
e
a
a
F
"}
(10,1,1) = {"
F
a
a
a
a
e
e
a
a
a
a
e
e
e
a
a
a
e
O
a
a
F
"}
(11,1,1) = {"
F
a
a
a
a
a
e
e
e
a
a
a
e
e
a
a
a
e
e
a
a
F
"}
(12,1,1) = {"
F
a
a
a
a
a
a
e
e
e
e
e
e
e
a
a
a
e
e
a
a
F
"}
(13,1,1) = {"
F
a
a
a
a
a
a
a
e
e
O
e
e
e
e
a
a
e
e
a
a
F
"}
(14,1,1) = {"
F
a
a
e
e
a
a
a
a
e
a
a
a
e
e
a
a
O
e
a
a
F
"}
(15,1,1) = {"
F
a
a
e
a
a
a
a
e
e
a
a
a
e
O
a
a
e
e
a
a
F
"}
(16,1,1) = {"
F
a
a
e
e
e
a
a
e
a
a
a
a
e
e
a
a
e
e
a
a
F
"}
(17,1,1) = {"
F
a
a
a
e
e
a
a
e
a
a
a
e
e
e
a
a
a
a
a
a
F
"}
(18,1,1) = {"
F
a
a
a
e
O
e
e
a
a
a
a
e
e
a
a
a
a
a
a
a
F
"}
(19,1,1) = {"
F
a
a
a
a
a
a
a
a
a
a
a
e
a
a
a
a
a
a
a
a
F
"}
(20,1,1) = {"
F
a
a
a
a
a
a
a
a
a
a
a
a
a
a
a
a
a
a
a
a
F
"}
(21,1,1) = {"
F
a
a
a
a
a
a
a
a
a
a
a
a
a
a
a
a
a
a
a
a
F
"}
(22,1,1) = {"
F
F
F
F
F
F
F
F
F
F
F
F
F
F
F
F
F
F
F
F
F
F
"}
