//MAP CONVERTED BY dmm2tgm.py THIS HEADER COMMENT PREVENTS RECONVERSION, DO NOT REMOVE
"a" = (
/obj/structure/halflife/storage/shelf,
/turf/open/floor/plating/indoor/concrete/small,
/area/halflife/indoors)
"c" = (
/turf/open/floor/plating/indoor/concrete/small,
/area/halflife/indoors)
"l" = (
/obj/modular_map_connector,
/turf/template_noop,
/area/template_noop)
"w" = (
/obj/structure/table/halflife/no_smooth/large/crafting/tinkerbench,
/turf/open/floor/plating/indoor/concrete,
/area/halflife/indoors)
"D" = (
/obj/machinery/light/small{
	dir = 4
	},
/turf/open/floor/plating/indoor/concrete/small,
/area/halflife/indoors)
"E" = (
/obj/machinery/light/small{
	dir = 8
	},
/turf/open/floor/plating/indoor/concrete/small,
/area/halflife/indoors)
"F" = (
/turf/closed/wall/halflife/brick,
/area/halflife/indoors)
"H" = (
/obj/structure/table/halflife/no_smooth/large/crafting/workbench,
/turf/open/floor/plating/indoor/concrete,
/area/halflife/indoors)
"J" = (
/obj/machinery/door/unpowered/halflife/seethrough/metal,
/turf/open/floor/plating/indoor/concrete/small,
/area/halflife/indoors)
"M" = (
/obj/effect/spawner/random/halflife/loot/crafting_bench,
/turf/open/floor/plating/indoor/concrete/small,
/area/halflife/indoors)
"T" = (
/turf/open/floor/plating/indoor/concrete,
/area/halflife/indoors)
"U" = (
/obj/structure/table/halflife/no_smooth/large/wood/desk{
	dir = 1
	},
/turf/open/floor/plating/indoor/concrete/small,
/area/halflife/indoors)
"W" = (
/turf/template_noop,
/area/template_noop)

(1,1,1) = {"
W
W
W
W
W
W
W
W
W
W
W
l
"}
(2,1,1) = {"
W
F
F
F
F
F
F
F
F
F
F
W
"}
(3,1,1) = {"
W
F
a
E
c
c
c
E
c
U
F
W
"}
(4,1,1) = {"
W
F
a
T
T
F
H
T
T
c
F
W
"}
(5,1,1) = {"
W
F
a
T
T
F
T
T
T
M
F
W
"}
(6,1,1) = {"
W
F
c
T
T
T
T
T
T
c
F
W
"}
(7,1,1) = {"
W
J
c
T
T
T
T
T
T
M
F
W
"}
(8,1,1) = {"
W
F
c
T
T
F
w
T
T
c
F
W
"}
(9,1,1) = {"
W
F
a
T
T
F
T
T
T
U
F
W
"}
(10,1,1) = {"
W
F
a
D
c
c
c
D
c
c
F
W
"}
(11,1,1) = {"
W
F
F
F
F
F
F
F
F
F
F
W
"}
(12,1,1) = {"
W
W
W
W
W
W
W
W
W
W
W
W
"}
