//MAP CONVERTED BY dmm2tgm.py THIS HEADER COMMENT PREVENTS RECONVERSION, DO NOT REMOVE
"a" = (
/turf/template_noop,
/area/template_noop)
"b" = (
/obj/structure/dresser,
/obj/structure/halflife/rug/red,
/turf/open/floor/plating/indoor/woodc,
/area/halflife/indoors)
"c" = (
/turf/open/floor/plating/indoor/woodc,
/area/halflife/indoors)
"e" = (
/obj/structure/table/halflife/no_smooth/wood/square,
/obj/structure/halflife/trash/glass/basic,
/turf/open/floor/plating/indoor/checkered,
/area/halflife/indoors)
"f" = (
/obj/structure/halflife/pot/plant,
/turf/open/floor/plating/indoor/woodc,
/area/halflife/indoors)
"g" = (
/obj/structure/halflife/trash/papers/three,
/turf/open/floor/plating/indoor/woodc,
/area/halflife/indoors)
"h" = (
/obj/structure/table/halflife/no_smooth/wood/square,
/obj/structure/halflife/trash/papers/two{
	pixel_x = 1;
	pixel_y = 5
	},
/turf/open/floor/plating/indoor/woodc,
/area/halflife/indoors)
"j" = (
/obj/structure/bed/halflife/bedframe/cot,
/obj/structure/bed/halflife/mattress/yellowed,
/obj/machinery/light/small/directional/south,
/turf/open/floor/plating/indoor/woodc,
/area/halflife/indoors)
"k" = (
/obj/structure/closet/halflife,
/obj/effect/spawner/random/halflife/loot,
/turf/open/floor/plating/indoor/woodc,
/area/halflife/indoors)
"m" = (
/obj/structure/sink/halflife,
/obj/structure/mirror/halflife{
	pixel_y = 32
	},
/turf/open/floor/plating/indoor/lino,
/area/halflife/indoors)
"o" = (
/obj/machinery/light/small/directional/east,
/obj/structure/closet/secure_closet/freezer/halflife,
/obj/effect/spawner/random/halflife/loot/consumables,
/turf/open/floor/plating/indoor/checkered,
/area/halflife/indoors)
"p" = (
/turf/open/floor/plating/indoor/checkered,
/area/halflife/indoors)
"q" = (
/obj/structure/halflife/toilet{
	pixel_y = 8
	},
/obj/machinery/light/small/directional/east,
/turf/open/floor/plating/indoor/lino,
/area/halflife/indoors)
"z" = (
/obj/structure/chair/halflife/wood{
	dir = 4
	},
/turf/open/floor/plating/indoor/woodc,
/area/halflife/indoors)
"A" = (
/obj/structure/table/halflife/no_smooth/wood/square,
/obj/structure/halflife/trash/food/misc,
/turf/open/floor/plating/indoor/checkered,
/area/halflife/indoors)
"E" = (
/obj/machinery/door/unpowered/halflife/seethrough/metal,
/turf/open/floor/plating/indoor/woodc,
/area/halflife/indoors)
"F" = (
/obj/machinery/door/unpowered/halflife/wood,
/turf/open/floor/plating/indoor/woodc,
/area/halflife/indoors)
"H" = (
/obj/machinery/light/small/directional/south,
/turf/open/floor/plating/indoor/woodc,
/area/halflife/indoors)
"I" = (
/obj/machinery/shower/halflife{
	dir = 8
	},
/obj/structure/fluff/shower_drain,
/turf/open/floor/plating/indoor/lino,
/area/halflife/indoors)
"K" = (
/obj/structure/table/halflife/no_smooth/wood/square,
/obj/machinery/light/small/directional/north,
/turf/open/floor/plating/indoor/woodc,
/area/halflife/indoors)
"L" = (
/turf/open/floor/plating/indoor/lino,
/area/halflife/indoors)
"O" = (
/obj/machinery/door/unpowered/halflife/wood{
	dir = 8
	},
/turf/open/floor/plating/indoor/lino,
/area/halflife/indoors)
"Q" = (
/obj/structure/window/fulltile/halflife/nosmooth/brick,
/turf/open/floor/plating/indoor/woodc,
/area/halflife/indoors)
"R" = (
/obj/structure/halflife/storage/large/clothing,
/turf/open/floor/plating/indoor/woodc,
/area/halflife/indoors)
"U" = (
/obj/structure/halflife/trash/papers/two{
	dir = 8
	},
/turf/open/floor/plating/indoor/woodc,
/area/halflife/indoors)
"W" = (
/turf/closed/wall/halflife/brick,
/area/halflife/indoors)
"X" = (
/obj/modular_map_connector,
/turf/template_noop,
/area/template_noop)
"Y" = (
/obj/structure/chair/halflife/wood{
	dir = 4
	},
/obj/machinery/light/small/directional/west,
/turf/open/floor/plating/indoor/woodc,
/area/halflife/indoors)

(1,1,1) = {"
a
a
a
a
a
a
a
a
a
a
a
X
"}
(2,1,1) = {"
a
W
W
W
W
W
W
W
W
W
W
a
"}
(3,1,1) = {"
a
W
f
c
z
Y
c
F
c
b
W
a
"}
(4,1,1) = {"
a
W
K
c
c
c
g
W
c
j
W
a
"}
(5,1,1) = {"
a
W
h
c
c
c
c
W
W
W
W
a
"}
(6,1,1) = {"
a
W
W
c
W
c
c
c
c
H
W
a
"}
(7,1,1) = {"
a
W
R
c
W
k
c
c
c
c
W
a
"}
(8,1,1) = {"
a
W
c
c
W
W
O
W
e
p
W
a
"}
(9,1,1) = {"
a
E
c
H
W
m
L
W
A
p
W
a
"}
(10,1,1) = {"
a
Q
U
c
W
q
I
W
o
p
W
a
"}
(11,1,1) = {"
a
W
W
W
W
W
W
W
W
W
W
a
"}
(12,1,1) = {"
a
a
a
a
a
a
a
a
a
a
a
a
"}
