//MAP CONVERTED BY dmm2tgm.py THIS HEADER COMMENT PREVENTS RECONVERSION, DO NOT REMOVE
"d" = (
/obj/structure/chair/halflife/metal{
	dir = 4
	},
/turf/open/floor/plating/indoor/grooved2,
/area/halflife/indoors)
"f" = (
/obj/structure/chair/halflife/metal{
	dir = 8
	},
/turf/open/floor/plating/indoor/grooved2,
/area/halflife/indoors)
"h" = (
/turf/open/floor/plating/indoor/grooved2,
/area/halflife/indoors)
"m" = (
/turf/template_noop,
/area/template_noop)
"p" = (
/turf/open/floor/plating/indoor/concrete/small,
/area/halflife/indoors)
"r" = (
/obj/machinery/washing_machine,
/turf/open/floor/plating/indoor/grooved2,
/area/halflife/indoors)
"t" = (
/obj/machinery/door/unpowered/halflife/seethrough/metal,
/turf/open/floor/plating/indoor/concrete/small,
/area/halflife/indoors)
"x" = (
/obj/structure/table/halflife/no_smooth/metal,
/obj/machinery/light/small,
/turf/open/floor/plating/indoor/grooved2,
/area/halflife/indoors)
"F" = (
/obj/machinery/light/small{
	dir = 1
	},
/turf/open/floor/plating/indoor/concrete/small,
/area/halflife/indoors)
"I" = (
/obj/machinery/light/small{
	dir = 4
	},
/turf/open/floor/plating/indoor/concrete/small,
/area/halflife/indoors)
"J" = (
/obj/structure/halflife/trash/garbage,
/turf/open/floor/plating/indoor/grooved2,
/area/halflife/indoors)
"K" = (
/obj/structure/table/halflife/no_smooth/metal,
/turf/open/floor/plating/indoor/grooved2,
/area/halflife/indoors)
"L" = (
/obj/modular_map_connector,
/turf/template_noop,
/area/template_noop)
"S" = (
/obj/structure/table/halflife/no_smooth/metal,
/obj/structure/halflife/trash/glass/cans,
/turf/open/floor/plating/indoor/grooved2,
/area/halflife/indoors)
"W" = (
/obj/machinery/light/small{
	dir = 8
	},
/turf/open/floor/plating/indoor/concrete/small,
/area/halflife/indoors)
"Y" = (
/turf/closed/wall/halflife/brick,
/area/halflife/indoors)

(1,1,1) = {"
m
m
m
m
m
m
m
m
m
m
m
L
"}
(2,1,1) = {"
m
Y
Y
Y
Y
Y
Y
Y
Y
Y
Y
m
"}
(3,1,1) = {"
m
Y
r
h
d
W
d
h
h
r
Y
m
"}
(4,1,1) = {"
m
Y
K
h
h
p
h
h
h
K
Y
m
"}
(5,1,1) = {"
m
Y
r
h
h
p
h
h
h
r
Y
m
"}
(6,1,1) = {"
m
Y
F
p
p
p
p
p
p
p
t
m
"}
(7,1,1) = {"
m
Y
r
h
h
p
h
h
h
r
Y
m
"}
(8,1,1) = {"
m
Y
K
h
h
p
h
h
h
x
Y
m
"}
(9,1,1) = {"
m
Y
K
h
h
p
h
h
h
S
Y
m
"}
(10,1,1) = {"
m
Y
r
h
f
I
f
J
h
r
Y
m
"}
(11,1,1) = {"
m
Y
Y
Y
Y
Y
Y
Y
Y
Y
Y
m
"}
(12,1,1) = {"
m
m
m
m
m
m
m
m
m
m
m
m
"}
