//MAP CONVERTED BY dmm2tgm.py THIS HEADER COMMENT PREVENTS RECONVERSION, DO NOT REMOVE
"a" = (
/turf/closed/wall/halflife/brick,
/area/halflife/indoors)
"b" = (
/obj/machinery/door/unpowered/halflife/wood,
/turf/open/floor/plating/indoor/concrete,
/area/halflife/indoors)
"g" = (
/obj/structure/table/halflife/no_smooth/wood/stand,
/turf/open/floor/plating/indoor/woodc/wide,
/area/halflife/indoors)
"h" = (
/obj/effect/spawner/random/halflife/loot/crafting_bench,
/turf/open/floor/plating/indoor/concrete,
/area/halflife/indoors)
"i" = (
/obj/modular_map_connector,
/turf/template_noop,
/area/template_noop)
"k" = (
/obj/machinery/light/small/directional/east,
/obj/structure/chair/office/halflife/blue{
	dir = 1
	},
/turf/open/floor/plating/indoor/woodc,
/area/halflife/indoors)
"l" = (
/obj/structure/table/halflife/no_smooth/large/wood/desk/alt,
/turf/open/floor/plating/indoor/woodc,
/area/halflife/indoors)
"r" = (
/obj/machinery/light/small/directional/north,
/turf/open/floor/plating/indoor/concrete,
/area/halflife/indoors)
"s" = (
/obj/machinery/light/small/directional/east,
/turf/open/floor/plating/indoor/woodc/wide,
/area/halflife/indoors)
"u" = (
/obj/structure/halflife/trash/papers,
/turf/open/floor/plating/indoor/concrete,
/area/halflife/indoors)
"v" = (
/obj/machinery/door/unpowered/halflife/wood{
	dir = 8
	},
/turf/open/floor/plating/indoor/concrete,
/area/halflife/indoors)
"w" = (
/obj/structure/bed/halflife/bedframe/wire,
/obj/structure/bed/halflife/mattress/old,
/turf/open/floor/plating/indoor/woodc/wide,
/area/halflife/indoors)
"x" = (
/obj/structure/halflife/trash/wood,
/turf/open/floor/plating/indoor/concrete,
/area/halflife/indoors)
"y" = (
/obj/structure/chair/office/halflife/blue{
	dir = 1
	},
/turf/open/floor/plating/indoor/woodc,
/area/halflife/indoors)
"B" = (
/turf/open/floor/plating/indoor/woodc,
/area/halflife/indoors)
"C" = (
/obj/machinery/light/small/directional/west,
/turf/open/floor/plating/indoor/woodc,
/area/halflife/indoors)
"F" = (
/turf/open/floor/plating/indoor/carpet,
/area/halflife/indoors)
"G" = (
/turf/template_noop,
/area/template_noop)
"I" = (
/turf/open/floor/plating/indoor/woodc/wide,
/area/halflife/indoors)
"L" = (
/obj/structure/halflife/trash/cardboard,
/turf/open/floor/plating/indoor/woodc,
/area/halflife/indoors)
"N" = (
/obj/structure/table/halflife/no_smooth/wood,
/turf/open/floor/plating/indoor/woodc,
/area/halflife/indoors)
"Q" = (
/turf/open/floor/plating/indoor/concrete,
/area/halflife/indoors)
"R" = (
/obj/structure/bed/halflife/bedframe/wire,
/obj/structure/bed/halflife/mattress/yellowed,
/turf/open/floor/plating/indoor/woodc/wide,
/area/halflife/indoors)
"T" = (
/obj/machinery/door/unpowered/halflife/metal,
/turf/open/floor/plating/indoor/woodc,
/area/halflife/indoors)
"U" = (
/obj/item/kirbyplants/random,
/turf/open/floor/plating/indoor/woodc/wide,
/area/halflife/indoors)
"W" = (
/obj/machinery/door/unpowered/halflife/wood{
	dir = 4
	},
/turf/open/floor/plating/indoor/woodc/wide,
/area/halflife/indoors)

(1,1,1) = {"
G
G
G
G
G
G
G
G
G
G
G
i
"}
(2,1,1) = {"
G
a
a
a
a
a
a
a
a
a
a
G
"}
(3,1,1) = {"
G
a
h
Q
a
l
y
B
C
L
a
G
"}
(4,1,1) = {"
G
a
Q
Q
a
B
F
F
F
B
T
G
"}
(5,1,1) = {"
G
a
r
Q
a
l
F
F
F
B
a
G
"}
(6,1,1) = {"
G
a
h
u
a
B
k
B
B
N
a
G
"}
(7,1,1) = {"
G
a
Q
Q
a
a
a
W
a
a
a
G
"}
(8,1,1) = {"
G
a
a
v
a
U
I
I
I
w
a
G
"}
(9,1,1) = {"
G
a
Q
Q
a
I
I
I
I
g
a
G
"}
(10,1,1) = {"
G
a
x
Q
b
I
I
s
I
R
a
G
"}
(11,1,1) = {"
G
a
a
a
a
a
a
a
a
a
a
G
"}
(12,1,1) = {"
G
G
G
G
G
G
G
G
G
G
G
G
"}
