//MAP CONVERTED BY dmm2tgm.py THIS HEADER COMMENT PREVENTS RECONVERSION, DO NOT REMOVE
"a" = (
/obj/structure/halflife/storage/shelf,
/turf/open/floor/plating/indoor/concrete/small,
/area/halflife/indoors)
"c" = (
/turf/open/floor/plating/indoor/concrete/small,
/area/halflife/indoors)
"w" = (
/obj/structure/table/halflife/no_smooth/large/crafting/tinkerbench,
/turf/open/floor/plating/indoor/concrete,
/area/halflife/indoors)
"D" = (
/obj/machinery/light/small{
	dir = 4
	},
/turf/open/floor/plating/indoor/concrete/small,
/area/halflife/indoors)
"E" = (
/obj/machinery/light/small{
	dir = 8
	},
/turf/open/floor/plating/indoor/concrete/small,
/area/halflife/indoors)
"F" = (
/turf/closed/wall/halflife/brick,
/area/halflife/indoors)
"H" = (
/obj/structure/table/halflife/no_smooth/large/crafting/workbench,
/turf/open/floor/plating/indoor/concrete,
/area/halflife/indoors)
"J" = (
/obj/machinery/door/unpowered/halflife/seethrough/metal,
/turf/open/floor/plating/indoor/concrete/small,
/area/halflife/indoors)
"T" = (
/turf/open/floor/plating/indoor/concrete,
/area/halflife/indoors)
"U" = (
/obj/structure/table/halflife/no_smooth/large/wood/desk{
	dir = 1
	},
/turf/open/floor/plating/indoor/concrete/small,
/area/halflife/indoors)

(1,1,1) = {"
F
F
F
F
F
F
F
F
F
F
"}
(2,1,1) = {"
F
a
E
c
c
c
E
c
U
F
"}
(3,1,1) = {"
F
a
T
T
F
H
T
T
c
F
"}
(4,1,1) = {"
F
a
T
T
F
T
T
T
c
F
"}
(5,1,1) = {"
F
c
T
T
T
T
T
T
c
F
"}
(6,1,1) = {"
J
c
T
T
T
T
T
T
c
F
"}
(7,1,1) = {"
F
c
T
T
F
w
T
T
c
F
"}
(8,1,1) = {"
F
a
T
T
F
T
T
T
U
F
"}
(9,1,1) = {"
F
a
D
c
c
c
D
c
c
F
"}
(10,1,1) = {"
F
F
F
F
F
F
F
F
F
F
"}
