//MAP CONVERTED BY dmm2tgm.py THIS HEADER COMMENT PREVENTS RECONVERSION, DO NOT REMOVE
"c" = (
/obj/structure/sign/poster/halflife/combine/three{
	pixel_y = 32
	},
/turf/open/floor/plating/indoor/concrete,
/area/halflife/indoors)
"d" = (
/turf/open/floor/plating/indoor/concrete,
/area/halflife/indoors)
"e" = (
/turf/closed/wall/halflife/brick,
/area/halflife/indoors)
"h" = (
/obj/structure/halflife/storage/large/shelf{
	dir = 8
	},
/turf/open/floor/plating/indoor/concrete/small,
/area/halflife/indoors)
"n" = (
/obj/structure/table/halflife/no_smooth/large/wood/desk,
/turf/open/floor/plating/indoor/concrete,
/area/halflife/indoors)
"p" = (
/obj/machinery/light/small,
/turf/open/floor/plating/indoor/concrete,
/area/halflife/indoors)
"w" = (
/obj/structure/sign/poster/halflife/combine/four{
	pixel_y = 32
	},
/turf/open/floor/plating/indoor/concrete,
/area/halflife/indoors)
"y" = (
/obj/structure/halflife/storage/shelf,
/turf/open/floor/plating/indoor/concrete/small,
/area/halflife/indoors)
"C" = (
/obj/modular_map_connector,
/turf/template_noop,
/area/template_noop)
"F" = (
/obj/machinery/light/small{
	dir = 4
	},
/turf/open/floor/plating/indoor/concrete,
/area/halflife/indoors)
"H" = (
/obj/structure/halflife/storage/shelf,
/obj/effect/spawner/random/halflife/loot,
/turf/open/floor/plating/indoor/concrete/small,
/area/halflife/indoors)
"I" = (
/obj/machinery/door/unpowered/halflife/wood{
	dir = 8
	},
/turf/open/floor/plating/indoor/concrete,
/area/halflife/indoors)
"J" = (
/obj/machinery/light/small{
	dir = 1
	},
/turf/open/floor/plating/indoor/concrete,
/area/halflife/indoors)
"N" = (
/obj/machinery/door/unpowered/halflife/seethrough/metal,
/turf/open/floor/plating/indoor/concrete,
/area/halflife/indoors)
"R" = (
/obj/structure/halflife/storage/large/shelf{
	dir = 4
	},
/obj/effect/spawner/random/halflife/loot,
/turf/open/floor/plating/indoor/concrete/small,
/area/halflife/indoors)
"T" = (
/obj/structure/halflife/storage/large/shelf{
	dir = 4
	},
/turf/open/floor/plating/indoor/concrete/small,
/area/halflife/indoors)
"W" = (
/turf/open/floor/plating/indoor/concrete/small,
/area/halflife/indoors)
"X" = (
/turf/template_noop,
/area/template_noop)

(1,1,1) = {"
X
X
X
X
X
X
X
X
X
X
X
C
"}
(2,1,1) = {"
X
e
e
e
e
e
e
e
e
e
e
X
"}
(3,1,1) = {"
X
e
W
R
W
W
T
W
W
R
e
X
"}
(4,1,1) = {"
X
e
J
d
d
d
d
d
d
d
e
X
"}
(5,1,1) = {"
X
e
c
d
d
d
d
F
d
d
e
X
"}
(6,1,1) = {"
X
N
d
W
h
d
d
e
e
I
e
X
"}
(7,1,1) = {"
X
e
d
W
R
d
d
n
d
d
e
X
"}
(8,1,1) = {"
X
e
w
d
d
d
d
d
d
d
e
X
"}
(9,1,1) = {"
X
e
d
d
d
d
d
e
y
p
e
X
"}
(10,1,1) = {"
X
e
W
h
F
d
d
e
H
d
e
X
"}
(11,1,1) = {"
X
e
e
e
e
e
e
e
e
e
e
X
"}
(12,1,1) = {"
X
X
X
X
X
X
X
X
X
X
X
X
"}
