//MAP CONVERTED BY dmm2tgm.py THIS HEADER COMMENT PREVENTS RECONVERSION, DO NOT REMOVE
"a" = (
/turf/template_noop,
/area/template_noop)
"b" = (
/obj/effect/spawner/random/halflife/loot/clothing,
/turf/open/floor/plating/indoor/woodc/mosaic,
/area/halflife/indoors)
"f" = (
/obj/structure/table/halflife/no_smooth/large/wood/desk{
	dir = 8
	},
/obj/machinery/light/small{
	dir = 4
	},
/turf/open/floor/plating/indoor/woodc/mosaic,
/area/halflife/indoors)
"g" = (
/obj/structure/chair/halflife/metal/red{
	dir = 4
	},
/turf/open/floor/plating/indoor/woodc/mosaic,
/area/halflife/indoors)
"h" = (
/obj/structure/halflife/storage/bookshelf,
/obj/effect/spawner/random/halflife/loot,
/turf/open/floor/plating/indoor/woodc/mosaic,
/area/halflife/indoors)
"j" = (
/obj/structure/halflife/storage/large/clothing,
/obj/effect/spawner/random/halflife/loot/clothing,
/turf/open/floor/plating/indoor/woodc/mosaic,
/area/halflife/indoors)
"k" = (
/obj/structure/halflife/storage/large/shelf/wood,
/turf/open/floor/plating/indoor/woodc/mosaic,
/area/halflife/indoors)
"l" = (
/turf/open/floor/plating/indoor/woodc/mosaic,
/area/halflife/indoors)
"m" = (
/obj/machinery/light/small{
	dir = 1
	},
/turf/open/floor/plating/indoor/woodc/mosaic,
/area/halflife/indoors)
"p" = (
/obj/machinery/door/unpowered/halflife/wood,
/turf/open/floor/plating/indoor/woodc/mosaic,
/area/halflife/indoors)
"s" = (
/obj/machinery/door/unpowered/halflife/seethrough/metal,
/turf/open/floor/plating/indoor/woodc/mosaic,
/area/halflife/indoors)
"u" = (
/obj/machinery/light/small,
/turf/open/floor/plating/indoor/woodc/mosaic,
/area/halflife/indoors)
"x" = (
/obj/structure/halflife/tv/tube/small{
	dir = 8
	},
/turf/open/floor/plating/indoor/woodc/mosaic,
/area/halflife/indoors)
"B" = (
/obj/machinery/door/unpowered/halflife/wood{
	dir = 8
	},
/turf/open/floor/plating/indoor/woodc/mosaic,
/area/halflife/indoors)
"D" = (
/obj/structure/halflife/storage/large/shelf/wood,
/obj/effect/spawner/random/halflife/loot/consumables,
/turf/open/floor/plating/indoor/woodc/mosaic,
/area/halflife/indoors)
"E" = (
/obj/machinery/light/small{
	dir = 8
	},
/turf/open/floor/plating/indoor/woodc/mosaic,
/area/halflife/indoors)
"J" = (
/obj/structure/halflife/storage/large/clothing,
/turf/open/floor/plating/indoor/woodc/mosaic,
/area/halflife/indoors)
"M" = (
/obj/machinery/light/small{
	dir = 4
	},
/turf/open/floor/plating/indoor/woodc/mosaic,
/area/halflife/indoors)
"N" = (
/obj/structure/table/halflife/no_smooth/large/wood/desk,
/turf/open/floor/plating/indoor/woodc/mosaic,
/area/halflife/indoors)
"O" = (
/obj/structure/halflife/rug/yellow,
/turf/open/floor/plating/indoor/woodc/mosaic,
/area/halflife/indoors)
"Q" = (
/obj/modular_map_connector,
/turf/template_noop,
/area/template_noop)
"W" = (
/turf/closed/wall/halflife/brick,
/area/halflife/indoors)
"X" = (
/obj/structure/halflife/rug/red,
/obj/structure/chair/halflife/metal/red{
	dir = 1
	},
/turf/open/floor/plating/indoor/woodc/mosaic,
/area/halflife/indoors)

(1,1,1) = {"
a
a
a
a
a
a
a
a
a
a
a
Q
"}
(2,1,1) = {"
a
W
W
W
W
W
W
W
W
W
W
a
"}
(3,1,1) = {"
a
W
D
E
l
k
l
p
l
l
W
a
"}
(4,1,1) = {"
a
W
l
l
l
l
u
W
l
l
W
a
"}
(5,1,1) = {"
a
W
k
l
l
k
O
N
X
u
W
a
"}
(6,1,1) = {"
a
W
l
l
l
l
l
l
l
l
W
a
"}
(7,1,1) = {"
a
s
l
l
l
l
l
W
W
B
W
a
"}
(8,1,1) = {"
a
W
m
l
l
l
u
W
h
l
W
a
"}
(9,1,1) = {"
a
W
J
l
l
j
l
W
g
l
W
a
"}
(10,1,1) = {"
a
W
b
M
l
l
l
W
x
f
W
a
"}
(11,1,1) = {"
a
W
W
W
W
W
W
W
W
W
W
a
"}
(12,1,1) = {"
a
a
a
a
a
a
a
a
a
a
a
a
"}
