//MAP CONVERTED BY dmm2tgm.py THIS HEADER COMMENT PREVENTS RECONVERSION, DO NOT REMOVE
"a" = (
/turf/open/floor/plating/indoor/carpet/violet,
/area/halflife/indoors)
"b" = (
/obj/machinery/light/small/directional/west,
/turf/open/floor/plating/indoor/woodc,
/area/halflife/indoors)
"c" = (
/turf/closed/wall/halflife/brick,
/area/halflife/indoors)
"h" = (
/obj/structure/bed/halflife/bedframe/metal,
/obj/structure/bed/halflife/mattress/old,
/obj/machinery/light/small/directional/east,
/turf/open/floor/plating/indoor/carpet/violet,
/area/halflife/indoors)
"i" = (
/obj/structure/bed/halflife/bedframe/metal,
/obj/structure/bed/halflife/mattress/dirty,
/obj/machinery/light/small/directional/west,
/turf/open/floor/plating/indoor/carpet,
/area/halflife/indoors)
"j" = (
/obj/machinery/door/unpowered/halflife/wood{
	dir = 4
	},
/turf/open/floor/plating/indoor/woodc,
/area/halflife/indoors)
"l" = (
/obj/modular_map_connector,
/turf/template_noop,
/area/template_noop)
"m" = (
/obj/machinery/light/small/directional/east,
/turf/open/floor/plating/indoor/woodc,
/area/halflife/indoors)
"n" = (
/obj/structure/table/halflife/no_smooth/wood/stand,
/turf/open/floor/plating/indoor/carpet/violet,
/area/halflife/indoors)
"p" = (
/turf/open/floor/plating/indoor/carpet,
/area/halflife/indoors)
"q" = (
/obj/structure/table/halflife/no_smooth/wood/stand,
/obj/machinery/light/small/directional/east,
/turf/open/floor/plating/indoor/carpet/shaggy/blue,
/area/halflife/indoors)
"t" = (
/obj/structure/table/halflife/wood,
/obj/effect/spawner/random/halflife/loot,
/turf/open/floor/plating/indoor/woodc,
/area/halflife/indoors)
"v" = (
/obj/structure/bed/halflife/bedframe/cot,
/obj/structure/bed/halflife/mattress/stale,
/obj/machinery/light/small/directional/east,
/turf/open/floor/plating/indoor/carpet/violet,
/area/halflife/indoors)
"z" = (
/obj/structure/closet/halflife,
/obj/effect/spawner/random/halflife/loot,
/turf/open/floor/plating/indoor/carpet/violet,
/area/halflife/indoors)
"A" = (
/obj/structure/table/halflife/no_smooth/wood/stand,
/turf/open/floor/plating/indoor/woodc,
/area/halflife/indoors)
"B" = (
/obj/machinery/door/unpowered/halflife/wood{
	dir = 8
	},
/turf/open/floor/plating/indoor/woodc,
/area/halflife/indoors)
"C" = (
/turf/template_noop,
/area/template_noop)
"D" = (
/turf/open/floor/plating/indoor/woodc,
/area/halflife/indoors)
"G" = (
/obj/machinery/door/unpowered/halflife/metal,
/turf/open/floor/plating/indoor/woodc,
/area/halflife/indoors)
"L" = (
/obj/machinery/light/small/directional/west,
/obj/structure/closet/halflife,
/turf/open/floor/plating/indoor/carpet/shaggy/green,
/area/halflife/indoors)
"U" = (
/obj/structure/bed/halflife/bedframe/wire,
/obj/structure/bed/halflife/mattress/yellowed,
/turf/open/floor/plating/indoor/carpet,
/area/halflife/indoors)
"W" = (
/obj/structure/bed/halflife/bedframe/wood,
/turf/open/floor/plating/indoor/carpet/shaggy/green,
/area/halflife/indoors)
"X" = (
/obj/item/kirbyplants/random,
/turf/open/floor/plating/indoor/woodc,
/area/halflife/indoors)
"Y" = (
/obj/structure/bed/halflife/bedframe/wire,
/turf/open/floor/plating/indoor/carpet/shaggy/blue,
/area/halflife/indoors)

(1,1,1) = {"
C
C
C
C
C
C
C
C
C
C
C
l
"}
(2,1,1) = {"
C
c
c
c
c
c
c
c
c
c
c
C
"}
(3,1,1) = {"
C
c
i
p
c
b
U
c
W
L
c
C
"}
(4,1,1) = {"
C
c
A
D
c
D
p
c
D
D
c
C
"}
(5,1,1) = {"
C
c
c
j
c
j
c
c
j
c
c
C
"}
(6,1,1) = {"
C
G
D
D
D
D
D
D
D
t
c
C
"}
(7,1,1) = {"
C
c
m
D
D
D
D
m
D
X
c
C
"}
(8,1,1) = {"
C
c
c
B
c
B
c
c
B
c
c
C
"}
(9,1,1) = {"
C
c
a
D
c
D
D
c
D
D
c
C
"}
(10,1,1) = {"
C
c
v
z
c
q
Y
c
n
h
c
C
"}
(11,1,1) = {"
C
c
c
c
c
c
c
c
c
c
c
C
"}
(12,1,1) = {"
C
C
C
C
C
C
C
C
C
C
C
C
"}
