//MAP CONVERTED BY dmm2tgm.py THIS HEADER COMMENT PREVENTS RECONVERSION, DO NOT REMOVE
"a" = (
/obj/modular_map_connector,
/turf/template_noop,
/area/template_noop)
"b" = (
/obj/structure/table/halflife/no_smooth/large/wood/desk{
	dir = 1
	},
/obj/effect/spawner/random/halflife/loot,
/turf/open/floor/plating/indoor/woodc/wide,
/area/halflife/indoors)
"d" = (
/turf/open/floor/plating/indoor/carpet,
/area/halflife/indoors)
"f" = (
/obj/structure/chair/comfy/halflife/armchair{
	dir = 1
	},
/turf/open/floor/plating/indoor/carpet,
/area/halflife/indoors)
"j" = (
/obj/structure/table/halflife/wood,
/turf/open/floor/plating/indoor/woodc/wide,
/area/halflife/indoors)
"m" = (
/obj/structure/halflife/storage/large/clothing,
/turf/open/floor/plating/indoor/woodc/wide,
/area/halflife/indoors)
"o" = (
/obj/structure/fireplace,
/turf/open/floor/plating/indoor/woodc/wide,
/area/halflife/indoors)
"p" = (
/obj/structure/halflife/storage/bookshelf,
/turf/open/floor/plating/indoor/woodc/wide,
/area/halflife/indoors)
"q" = (
/obj/structure/table/halflife/no_smooth/large/wood/stand{
	dir = 1
	},
/turf/open/floor/plating/indoor/woodc/wide,
/area/halflife/indoors)
"t" = (
/obj/machinery/door/unpowered/halflife/seethrough/metal,
/turf/open/floor/plating/indoor/woodc,
/area/halflife/indoors)
"v" = (
/obj/machinery/light/small{
	dir = 8
	},
/turf/open/floor/plating/indoor/carpet,
/area/halflife/indoors)
"w" = (
/obj/machinery/light/small,
/turf/open/floor/plating/indoor/woodc/wide,
/area/halflife/indoors)
"y" = (
/obj/structure/bed/halflife/bedframe/wood,
/turf/open/floor/plating/indoor/woodc/wide,
/area/halflife/indoors)
"D" = (
/obj/structure/table/halflife/wood,
/obj/structure/halflife/tv/tube,
/turf/open/floor/plating/indoor/woodc/wide,
/area/halflife/indoors)
"J" = (
/turf/closed/wall/halflife/brick,
/area/halflife/indoors)
"L" = (
/obj/machinery/door/unpowered/halflife/wood{
	dir = 8
	},
/turf/open/floor/plating/indoor/woodc/wide,
/area/halflife/indoors)
"M" = (
/obj/structure/table/halflife/no_smooth/wood/stand,
/turf/open/floor/plating/indoor/woodc/wide,
/area/halflife/indoors)
"O" = (
/obj/machinery/light/small{
	dir = 1
	},
/turf/open/floor/plating/indoor/woodc/wide,
/area/halflife/indoors)
"P" = (
/turf/open/floor/plating/indoor/woodc/wide,
/area/halflife/indoors)
"R" = (
/obj/structure/halflife/storage/shelf/wood/alt{
	dir = 4
	},
/turf/open/floor/plating/indoor/woodc/wide,
/area/halflife/indoors)
"X" = (
/turf/template_noop,
/area/template_noop)

(1,1,1) = {"
X
X
X
X
X
X
X
X
X
X
X
a
"}
(2,1,1) = {"
X
J
J
J
J
J
J
J
J
J
J
X
"}
(3,1,1) = {"
X
J
j
j
J
D
d
v
d
b
J
X
"}
(4,1,1) = {"
X
t
P
P
J
o
d
f
d
P
J
X
"}
(5,1,1) = {"
X
J
P
P
J
P
d
d
d
P
J
X
"}
(6,1,1) = {"
X
J
O
P
J
p
d
d
d
q
J
X
"}
(7,1,1) = {"
X
J
P
P
J
p
P
P
P
P
J
X
"}
(8,1,1) = {"
X
J
m
P
P
P
P
J
L
J
J
X
"}
(9,1,1) = {"
X
J
P
P
P
P
w
J
P
M
J
X
"}
(10,1,1) = {"
X
J
P
P
R
P
R
J
O
y
J
X
"}
(11,1,1) = {"
X
J
J
J
J
J
J
J
J
J
J
X
"}
(12,1,1) = {"
X
X
X
X
X
X
X
X
X
X
X
X
"}
