//MAP CONVERTED BY dmm2tgm.py THIS HEADER COMMENT PREVENTS RECONVERSION, DO NOT REMOVE
"b" = (
/obj/structure/table/halflife/wood/bar,
/turf/open/floor/plating/indoor/woodc/mosaic,
/area/halflife/indoors)
"c" = (
/obj/structure/table/halflife/no_smooth/dice/pristine,
/turf/open/floor/plating/indoor/carpet/violet,
/area/halflife/indoors)
"g" = (
/obj/modular_map_connector,
/turf/template_noop,
/area/template_noop)
"j" = (
/obj/machinery/light/small{
	dir = 4
	},
/turf/open/floor/plating/indoor/woodc,
/area/halflife/indoors)
"k" = (
/obj/machinery/door/unpowered/halflife/metal,
/turf/open/floor/plating/indoor/woodc,
/area/halflife/indoors)
"l" = (
/turf/template_noop,
/area/template_noop)
"n" = (
/obj/structure/window/fulltile,
/turf/open/floor/plating/indoor/woodc,
/area/halflife/indoors)
"p" = (
/obj/structure/table/halflife/wood/bar,
/obj/structure/halflife/trash/glass/basic,
/turf/open/floor/plating/indoor/woodc/mosaic,
/area/halflife/indoors)
"r" = (
/obj/machinery/light/small{
	dir = 8
	},
/turf/open/floor/plating/indoor/carpet/violet,
/area/halflife/indoors)
"u" = (
/obj/structure/halflife/trash/cardboard,
/turf/open/floor/plating/indoor/woodc/mosaic,
/area/halflife/indoors)
"x" = (
/obj/structure/chair/halflife/metal/stool,
/turf/open/floor/plating/indoor/carpet/violet,
/area/halflife/indoors)
"B" = (
/obj/machinery/light/small{
	dir = 4
	},
/turf/open/floor/plating/indoor/woodc/mosaic,
/area/halflife/indoors)
"E" = (
/obj/structure/chair/halflife/metal/red{
	dir = 1
	},
/turf/open/floor/plating/indoor/woodc,
/area/halflife/indoors)
"G" = (
/turf/closed/wall/halflife/brick,
/area/halflife/indoors)
"H" = (
/obj/structure/table/halflife/wood/bar,
/obj/item/cigarette/halflife,
/turf/open/floor/plating/indoor/woodc/mosaic,
/area/halflife/indoors)
"I" = (
/obj/machinery/light/small{
	dir = 8
	},
/obj/structure/chair/halflife/metal/stool,
/turf/open/floor/plating/indoor/carpet/violet,
/area/halflife/indoors)
"J" = (
/obj/structure/table/halflife/no_smooth/large/cards,
/obj/item/toy/cards/deck,
/turf/open/floor/plating/indoor/carpet/violet,
/area/halflife/indoors)
"M" = (
/obj/structure/chair/halflife/metal/stool,
/turf/open/floor/plating/indoor/woodc,
/area/halflife/indoors)
"P" = (
/turf/open/floor/plating/indoor/woodc,
/area/halflife/indoors)
"S" = (
/obj/machinery/jukebox,
/turf/open/floor/plating/indoor/woodc,
/area/halflife/indoors)
"V" = (
/turf/open/floor/plating/indoor/woodc/mosaic,
/area/halflife/indoors)
"Y" = (
/turf/open/floor/plating/indoor/carpet/violet,
/area/halflife/indoors)

(1,1,1) = {"
l
l
l
l
l
l
l
l
l
l
l
g
"}
(2,1,1) = {"
l
G
G
G
G
G
G
G
G
G
G
l
"}
(3,1,1) = {"
l
G
Y
I
Y
x
Y
r
Y
P
n
l
"}
(4,1,1) = {"
l
G
Y
c
Y
c
Y
J
Y
P
n
l
"}
(5,1,1) = {"
l
G
Y
x
Y
x
Y
Y
Y
P
G
l
"}
(6,1,1) = {"
l
G
Y
c
Y
c
Y
Y
Y
P
k
l
"}
(7,1,1) = {"
l
G
Y
x
Y
x
Y
Y
Y
E
G
l
"}
(8,1,1) = {"
l
G
b
p
H
p
M
P
P
E
G
l
"}
(9,1,1) = {"
l
G
u
V
V
b
M
P
P
P
G
l
"}
(10,1,1) = {"
l
G
V
B
V
V
P
j
P
S
G
l
"}
(11,1,1) = {"
l
G
G
G
G
G
G
G
G
G
G
l
"}
(12,1,1) = {"
l
l
l
l
l
l
l
l
l
l
l
l
"}
