//MAP CONVERTED BY dmm2tgm.py THIS HEADER COMMENT PREVENTS RECONVERSION, DO NOT REMOVE
"d" = (
/obj/structure/bed/halflife/bedframe/wire,
/turf/open/floor/plating/indoor/carpet/shaggy/violet,
/area/halflife/indoors)
"e" = (
/obj/machinery/light/small/broken{
	dir = 1
	},
/turf/open/floor/plating/indoor/woodc/wide,
/area/halflife/indoors)
"k" = (
/obj/structure/window/fulltile,
/obj/structure/barricade/wooden/crude,
/turf/open/floor/plating/indoor/woodc/mosaic,
/area/halflife/indoors)
"m" = (
/obj/modular_map_connector,
/turf/template_noop,
/area/template_noop)
"n" = (
/obj/machinery/door/unpowered/halflife/metal,
/turf/open/floor/plating/indoor/woodc/mosaic,
/area/halflife/indoors)
"o" = (
/obj/structure/table/halflife/no_smooth/wood,
/obj/structure/halflife/trash/glass/basic,
/turf/open/floor/plating/indoor/woodc/wide,
/area/halflife/indoors)
"s" = (
/obj/structure/halflife/trash/garbage,
/turf/open/floor/plating/indoor/woodc/mosaic,
/area/halflife/indoors)
"u" = (
/turf/open/floor/plating/indoor/woodc/mosaic,
/area/halflife/indoors)
"z" = (
/mob/living/basic/mouse/gray,
/turf/open/floor/plating/indoor/carpet/shaggy/violet,
/area/halflife/indoors)
"A" = (
/obj/structure/halflife/trash/wood,
/turf/open/floor/plating/indoor/woodc/mosaic,
/area/halflife/indoors)
"B" = (
/obj/machinery/door/unpowered/halflife/metal{
	dir = 8
	},
/turf/open/floor/plating/indoor/woodc/wide,
/area/halflife/indoors)
"D" = (
/turf/closed/wall/halflife/brick,
/area/halflife/indoors)
"F" = (
/obj/structure/halflife/trash/cardboard,
/turf/open/floor/plating/indoor/woodc/mosaic,
/area/halflife/indoors)
"G" = (
/obj/structure/halflife/trash/bricks,
/turf/open/floor/plating/indoor/woodc/mosaic,
/area/halflife/indoors)
"J" = (
/turf/template_noop,
/area/template_noop)
"L" = (
/obj/structure/halflife/trash/garbage,
/turf/open/floor/plating/indoor/woodc/wide,
/area/halflife/indoors)
"M" = (
/obj/structure/halflife/trash/garbage,
/turf/open/floor/plating/indoor/carpet/shaggy/violet,
/area/halflife/indoors)
"P" = (
/obj/machinery/light/small/broken{
	dir = 8
	},
/turf/open/floor/plating/indoor/woodc/mosaic,
/area/halflife/indoors)
"Q" = (
/obj/structure/halflife/trash/food/dinner,
/turf/open/floor/plating/indoor/woodc/mosaic,
/area/halflife/indoors)
"Y" = (
/turf/open/floor/plating/indoor/woodc/wide,
/area/halflife/indoors)

(1,1,1) = {"
J
J
J
J
J
J
J
J
J
J
J
m
"}
(2,1,1) = {"
J
D
D
D
D
D
D
D
D
D
D
J
"}
(3,1,1) = {"
J
D
u
D
u
u
D
s
u
G
D
J
"}
(4,1,1) = {"
J
D
u
u
G
s
D
u
u
u
k
J
"}
(5,1,1) = {"
J
D
s
u
u
u
D
D
u
s
D
J
"}
(6,1,1) = {"
J
D
u
u
u
u
P
A
u
u
n
J
"}
(7,1,1) = {"
J
D
D
B
D
D
u
u
u
s
D
J
"}
(8,1,1) = {"
J
D
o
Y
z
D
u
u
u
u
k
J
"}
(9,1,1) = {"
J
D
e
Y
M
D
u
u
u
D
D
J
"}
(10,1,1) = {"
J
D
L
Y
d
D
F
u
u
Q
D
J
"}
(11,1,1) = {"
J
D
D
D
D
D
D
D
D
D
D
J
"}
(12,1,1) = {"
J
J
J
J
J
J
J
J
J
J
J
J
"}
