//MAP CONVERTED BY dmm2tgm.py THIS HEADER COMMENT PREVENTS RECONVERSION, DO NOT REMOVE
"a" = (
/obj/structure/halflife/tank,
/turf/open/floor/plating/indoor/concrete/bricks,
/area/halflife/indoors)
"b" = (
/obj/machinery/light/small/directional/north,
/turf/open/floor/plating/indoor/concrete/bricks,
/area/halflife/indoors)
"d" = (
/obj/machinery/light/small/directional/south,
/mob/living/basic/halflife/headcrab/poison,
/turf/open/floor/plating/indoor/concrete/bricks,
/area/halflife/indoors)
"e" = (
/obj/machinery/light/small/directional/north,
/mob/living/basic/halflife/headcrab/poison,
/turf/open/floor/plating/indoor/concrete/bricks,
/area/halflife/indoors)
"f" = (
/obj/structure/halflife/fence/wire,
/turf/open/floor/plating/indoor/concrete/bricks,
/area/halflife/indoors)
"h" = (
/obj/structure/reagent_dispensers/fueltank,
/turf/open/floor/plating/indoor/concrete/bricks,
/area/halflife/indoors)
"k" = (
/obj/machinery/door/unpowered/halflife/metal{
	dir = 8
	},
/turf/open/floor/plating/indoor/concrete/bricks,
/area/halflife/indoors)
"l" = (
/obj/structure/table/halflife/metal/grate,
/turf/open/floor/plating/indoor/concrete/bricks,
/area/halflife/indoors)
"m" = (
/obj/machinery/door/unpowered/halflife/seethrough/fence/wire,
/turf/open/floor/plating/indoor/concrete/bricks,
/area/halflife/indoors)
"n" = (
/obj/machinery/door/unpowered/halflife/metal,
/turf/open/floor/plating/indoor/concrete/bricks,
/area/halflife/indoors)
"p" = (
/turf/template_noop,
/area/template_noop)
"q" = (
/obj/structure/halflife/storage/shelf,
/obj/item/stack/spacecash/c1{
	amount = 5
	},
/turf/open/floor/plating/indoor/concrete/bricks,
/area/halflife/indoors)
"r" = (
/turf/open/floor/plating/ground/dirt,
/area/template_noop)
"s" = (
/obj/effect/spawner/random/halflife/plant_spawner,
/turf/open/floor/plating/ground/dirt,
/area/template_noop)
"t" = (
/obj/structure/halflife/trash/cardboard{
	dir = 8;
	pixel_y = 7
	},
/obj/structure/table/halflife/metal/heavy,
/turf/open/floor/plating/indoor/concrete/bricks,
/area/halflife/indoors)
"u" = (
/turf/open/floor/plating/indoor/metal/pipe{
	dir = 1
	},
/area/halflife/indoors)
"v" = (
/turf/closed/wall/halflife/concrete,
/area/halflife/indoors)
"w" = (
/obj/machinery/light/small/directional/west,
/turf/open/floor/plating/indoor/concrete/bricks,
/area/halflife/indoors)
"x" = (
/obj/structure/halflife/trash/garbage/dumpster,
/turf/open/floor/plating/ground/dirt,
/area/template_noop)
"y" = (
/obj/machinery/light/small/directional/east,
/turf/open/floor/plating/indoor/concrete/bricks,
/area/halflife/indoors)
"z" = (
/obj/structure/halflife/trash/garbage/dumpster/crate,
/turf/open/floor/plating/indoor/concrete/bricks,
/area/halflife/indoors)
"A" = (
/obj/structure/closet/halflife/wall/firstaid,
/obj/effect/spawner/random/halflife/loot/heal,
/obj/effect/spawner/random/halflife/loot/heal,
/turf/open/floor/plating/indoor/concrete/bricks,
/area/halflife/indoors)
"C" = (
/turf/open/floor/plating/ground/grass,
/area/template_noop)
"D" = (
/turf/open/floor/plating/indoor/concrete/bricks,
/area/halflife/indoors)
"E" = (
/obj/machinery/light/small/directional/south,
/turf/open/floor/plating/indoor/concrete/bricks,
/area/halflife/indoors)
"F" = (
/obj/structure/halflife/trash/garbage,
/turf/open/floor/plating/ground/dirt,
/area/template_noop)
"G" = (
/mob/living/basic/halflife/headcrab/poison,
/turf/open/floor/plating/indoor/concrete/bricks,
/area/halflife/indoors)
"J" = (
/obj/structure/halflife/trash/bricks,
/turf/open/floor/plating/indoor/concrete/bricks,
/area/halflife/indoors)
"K" = (
/obj/structure/table/halflife/metal/grate,
/obj/item/stack/spacecash/c1{
	amount = 5
	},
/turf/open/floor/plating/indoor/concrete/bricks,
/area/halflife/indoors)
"L" = (
/obj/structure/halflife/trash/garbage,
/turf/open/floor/plating/indoor/concrete/bricks,
/area/halflife/indoors)
"M" = (
/obj/structure/table/halflife/metal/grate,
/obj/effect/spawner/random/halflife/loot/rare,
/turf/open/floor/plating/indoor/concrete/bricks,
/area/halflife/indoors)
"N" = (
/obj/effect/spawner/random/halflife/plant_spawner,
/obj/structure/halflife/trash/garbage,
/turf/open/floor/plating/ground/grass,
/area/template_noop)
"O" = (
/mob/living/basic/halflife/zombie/poison,
/turf/open/floor/plating/indoor/concrete/bricks,
/area/halflife/indoors)
"S" = (
/obj/modular_map_connector,
/turf/template_noop,
/area/template_noop)
"T" = (
/obj/machinery/door/unpowered/halflife/seethrough/grate{
	locked = 1;
	keylock = 1
	},
/turf/open/floor/plating/indoor/concrete/bricks,
/area/halflife/indoors)
"U" = (
/obj/structure/table/halflife/metal/grate,
/obj/item/stack/spacecash/c10,
/turf/open/floor/plating/indoor/concrete/bricks,
/area/halflife/indoors)
"V" = (
/obj/structure/table/halflife/metal/grate,
/obj/effect/spawner/random/halflife/loot,
/turf/open/floor/plating/indoor/concrete/bricks,
/area/halflife/indoors)
"W" = (
/obj/structure/table/halflife/metal/grate,
/obj/machinery/light/small/directional/west,
/obj/effect/spawner/random/halflife/loot/rare,
/turf/open/floor/plating/indoor/concrete/bricks,
/area/halflife/indoors)
"Y" = (
/obj/structure/halflife/storage/shelf,
/obj/effect/spawner/random/halflife/loot,
/turf/open/floor/plating/indoor/concrete/bricks,
/area/halflife/indoors)
"Z" = (
/obj/effect/spawner/random/halflife/plant_spawner,
/turf/open/floor/plating/ground/grass,
/area/template_noop)

(1,1,1) = {"
p
p
p
p
p
p
p
p
p
p
p
p
p
p
p
p
S
"}
(2,1,1) = {"
p
v
v
v
v
v
v
v
v
v
v
v
v
v
v
v
p
"}
(3,1,1) = {"
p
v
D
w
D
m
D
D
t
v
a
D
D
D
J
v
p
"}
(4,1,1) = {"
p
v
Y
D
D
f
D
D
D
v
a
D
D
D
D
n
p
"}
(5,1,1) = {"
p
v
v
v
v
v
a
D
d
v
a
D
D
D
D
v
p
"}
(6,1,1) = {"
p
v
u
u
u
v
A
D
D
v
e
D
D
D
E
v
p
"}
(7,1,1) = {"
p
v
z
G
D
T
D
D
D
v
D
D
D
D
D
v
p
"}
(8,1,1) = {"
p
v
b
D
D
v
a
D
D
n
D
D
D
D
V
v
p
"}
(9,1,1) = {"
p
v
Y
D
D
v
h
D
D
v
D
D
D
D
K
v
p
"}
(10,1,1) = {"
p
v
q
D
L
v
v
k
v
v
D
D
D
D
V
v
p
"}
(11,1,1) = {"
p
v
v
v
v
v
D
D
D
v
v
v
v
v
v
v
p
"}
(12,1,1) = {"
p
r
Z
C
v
l
D
D
D
O
l
W
v
x
N
C
p
"}
(13,1,1) = {"
p
r
C
C
v
l
D
D
D
D
D
U
v
F
C
C
p
"}
(14,1,1) = {"
p
r
r
Z
v
V
D
D
D
D
D
U
v
r
r
Z
p
"}
(15,1,1) = {"
p
r
s
C
v
D
O
y
D
D
l
M
v
r
s
C
p
"}
(16,1,1) = {"
p
r
r
r
v
v
v
v
v
v
v
v
v
r
r
r
p
"}
(17,1,1) = {"
p
p
p
p
p
p
p
p
p
p
p
p
p
p
p
p
p
"}
