//MAP CONVERTED BY dmm2tgm.py THIS HEADER COMMENT PREVENTS RECONVERSION, DO NOT REMOVE
"a" = (
/turf/template_noop,
/area/template_noop)
"b" = (
/obj/machinery/door/unpowered/halflife/metal,
/turf/open/floor/plating/indoor/metal/pipe{
	dir = 1
	},
/area/halflife/indoors)
"d" = (
/mob/living/basic/halflife/zombie/poison,
/turf/open/floor/plating/indoor/concrete/bricks,
/area/halflife/indoors)
"e" = (
/obj/effect/spawner/random/halflife/loot/heal,
/turf/open/floor/plating/indoor/metal/pipe{
	dir = 1
	},
/area/halflife/indoors)
"g" = (
/turf/closed/wall/halflife/concrete,
/area/halflife/indoors)
"i" = (
/obj/structure/halflife/trash/wood{
	dir = 6
	},
/turf/open/floor/plating/indoor/concrete/bricks,
/area/halflife/indoors)
"j" = (
/obj/structure/halflife/pipes/vent,
/obj/structure/halflife/barrel/double/yellow,
/turf/open/floor/plating/indoor/concrete/bricks,
/area/halflife/indoors)
"k" = (
/obj/structure/halflife/trash/garbage/dumpster/crate,
/turf/open/floor/plating/indoor/concrete/bricks,
/area/halflife/indoors)
"l" = (
/mob/living/basic/halflife/headcrab/poison,
/turf/open/floor/plating/indoor/metal/pipe{
	dir = 1
	},
/area/halflife/indoors)
"m" = (
/obj/effect/turf_decal/box,
/turf/open/floor/plating/indoor/concrete/bricks,
/area/halflife/indoors)
"n" = (
/turf/open/floor/plating/indoor/metal/walkway{
	dir = 1
	},
/area/halflife/indoors)
"o" = (
/turf/open/floor/plating/indoor/metal/pipe/corner{
	dir = 4
	},
/area/halflife/indoors)
"p" = (
/turf/open/floor/plating/indoor/metal/pipe,
/area/halflife/indoors)
"q" = (
/obj/effect/spawner/random/halflife/loot,
/turf/open/floor/plating/indoor/concrete/bricks,
/area/halflife/indoors)
"r" = (
/obj/effect/turf_decal/box,
/obj/structure/halflife/trash/garbage/dumpster/crate,
/turf/open/floor/plating/indoor/concrete/bricks,
/area/halflife/indoors)
"s" = (
/obj/structure/halflife/tank/chemical/container,
/turf/open/floor/plating/indoor/concrete/bricks,
/area/halflife/indoors)
"u" = (
/obj/structure/halflife/pipes/vent,
/turf/open/floor/plating/indoor/concrete/bricks,
/area/halflife/indoors)
"v" = (
/obj/effect/spawner/random/halflife/loot/crafting_bench,
/turf/open/floor/plating/indoor/concrete/bricks,
/area/halflife/indoors)
"w" = (
/obj/effect/turf_decal/box,
/obj/structure/reagent_dispensers/fueltank,
/turf/open/floor/plating/indoor/concrete/bricks,
/area/halflife/indoors)
"x" = (
/obj/machinery/light,
/turf/open/floor/plating/indoor/metal/pipe/intersection{
	dir = 1
	},
/area/halflife/indoors)
"z" = (
/obj/item/stack/spacecash/c1,
/turf/open/floor/plating/indoor/concrete/bricks,
/area/halflife/indoors)
"A" = (
/turf/open/floor/plating/indoor/metal/pipe/corner{
	dir = 1
	},
/area/halflife/indoors)
"B" = (
/obj/machinery/light{
	dir = 1
	},
/turf/open/floor/plating/indoor/concrete/bricks,
/area/halflife/indoors)
"C" = (
/obj/modular_map_connector,
/turf/template_noop,
/area/template_noop)
"D" = (
/obj/structure/halflife/trash/bricks{
	dir = 4
	},
/turf/open/floor/plating/indoor/concrete/bricks,
/area/halflife/indoors)
"E" = (
/turf/open/floor/plating/indoor/metal/pipe/intersection,
/area/halflife/indoors)
"F" = (
/obj/structure/halflife/pallet,
/obj/item/stack/spacecash/c1,
/turf/open/floor/plating/indoor/concrete/bricks,
/area/halflife/indoors)
"G" = (
/obj/structure/halflife/tank/chemical/container/broken,
/turf/open/floor/plating/indoor/concrete/bricks,
/area/halflife/indoors)
"H" = (
/obj/structure/halflife/trash/cardboard{
	dir = 8
	},
/obj/effect/spawner/random/halflife/loot/trash,
/turf/open/floor/plating/indoor/concrete/bricks,
/area/halflife/indoors)
"I" = (
/obj/machinery/door/unpowered/halflife/metal,
/turf/open/floor/plating/indoor/concrete/bricks,
/area/halflife/indoors)
"K" = (
/obj/structure/halflife/trash/bricks,
/turf/open/floor/plating/indoor/concrete/bricks,
/area/halflife/indoors)
"L" = (
/turf/open/floor/plating/indoor/metal/pipe{
	dir = 1
	},
/area/halflife/indoors)
"M" = (
/obj/structure/halflife/barrel/double/yellow,
/turf/open/floor/plating/indoor/concrete/bricks,
/area/halflife/indoors)
"N" = (
/obj/structure/halflife/tank/chemical/huge,
/turf/open/floor/plating/indoor/concrete/bricks,
/area/halflife/indoors)
"O" = (
/obj/effect/spawner/random/halflife/loot/consumables,
/turf/open/floor/plating/indoor/concrete/bricks,
/area/halflife/indoors)
"P" = (
/obj/structure/closet/halflife,
/obj/item/stack/spacecash/c10,
/turf/open/floor/plating/indoor/concrete/bricks,
/area/halflife/indoors)
"Q" = (
/obj/effect/spawner/random/halflife/loot,
/turf/open/floor/plating/indoor/metal/pipe/corner{
	dir = 8
	},
/area/halflife/indoors)
"R" = (
/turf/open/floor/plating/indoor/metal/plate,
/area/halflife/indoors)
"S" = (
/turf/open/floor/plating/indoor/metal/pipe/corner,
/area/halflife/indoors)
"T" = (
/obj/effect/spawner/random/halflife/loot/ammo,
/turf/open/floor/plating/indoor/concrete/bricks,
/area/halflife/indoors)
"V" = (
/turf/open/floor/plating/indoor/concrete/bricks,
/area/halflife/indoors)
"W" = (
/obj/machinery/light/small/directional/north,
/turf/open/floor/plating/indoor/metal/pipe,
/area/halflife/indoors)
"Y" = (
/obj/structure/halflife/pallet/stack,
/turf/open/floor/plating/indoor/concrete/bricks,
/area/halflife/indoors)

(1,1,1) = {"
a
a
a
a
a
a
a
a
a
a
a
a
a
a
a
a
C
"}
(2,1,1) = {"
a
g
g
g
g
g
g
g
g
g
g
g
g
g
g
g
a
"}
(3,1,1) = {"
a
g
S
q
V
V
g
B
R
R
R
R
L
L
S
g
a
"}
(4,1,1) = {"
a
g
W
r
m
O
g
u
n
V
V
V
F
V
p
g
a
"}
(5,1,1) = {"
a
g
p
m
m
V
g
D
n
V
V
V
V
V
R
I
a
"}
(6,1,1) = {"
a
g
p
w
r
V
g
V
n
V
V
V
V
V
p
g
a
"}
(7,1,1) = {"
a
g
E
L
L
L
b
L
n
L
L
L
S
M
p
g
a
"}
(8,1,1) = {"
a
g
g
g
g
g
g
V
n
V
V
V
E
L
x
g
a
"}
(9,1,1) = {"
a
g
E
l
L
L
b
L
n
L
L
L
A
G
p
g
a
"}
(10,1,1) = {"
a
g
p
N
V
V
g
V
n
V
V
V
V
V
p
g
a
"}
(11,1,1) = {"
a
g
W
V
V
Y
g
s
n
V
V
V
z
V
p
g
a
"}
(12,1,1) = {"
a
g
p
z
d
O
g
V
n
F
v
V
V
k
p
g
a
"}
(13,1,1) = {"
a
g
p
T
V
K
g
i
n
V
V
V
V
H
p
g
a
"}
(14,1,1) = {"
a
g
p
V
V
P
g
j
n
V
V
V
o
L
A
g
a
"}
(15,1,1) = {"
a
g
Q
L
L
e
g
L
n
L
L
L
A
F
V
g
a
"}
(16,1,1) = {"
a
g
g
g
g
g
g
g
g
g
g
g
g
g
g
g
a
"}
(17,1,1) = {"
a
a
a
a
a
a
a
a
a
a
a
a
a
a
a
a
a
"}
