//MAP CONVERTED BY dmm2tgm.py THIS HEADER COMMENT PREVENTS RECONVERSION, DO NOT REMOVE
"a" = (
/turf/open/floor/plating/indoor/carpet/green,
/area/halflife/indoors)
"b" = (
/turf/template_noop,
/area/template_noop)
"c" = (
/obj/machinery/light/small/red/directional/west,
/turf/open/floor/plating/indoor/woodc,
/area/halflife/indoors)
"f" = (
/obj/structure/halflife/trash/books/pile,
/turf/open/floor/plating/indoor/woodc/fancy,
/area/halflife/indoors)
"g" = (
/obj/structure/halflife/storage/large/clothing,
/turf/open/floor/plating/indoor/carpet/green,
/area/halflife/indoors)
"h" = (
/mob/living/basic/halflife/zombie,
/turf/open/floor/plating/indoor/concrete/bricks,
/area/halflife/indoors)
"i" = (
/obj/structure/halflife/trash/cardboard{
	dir = 4
	},
/turf/open/floor/plating/indoor/carpet/green,
/area/halflife/indoors)
"j" = (
/obj/structure/chair/office/halflife/blue{
	dir = 8
	},
/turf/open/floor/plating/indoor/woodc/fancy,
/area/halflife/indoors)
"l" = (
/turf/closed/wall/halflife/concrete/alt,
/area/halflife/indoors)
"m" = (
/obj/structure/halflife/storage/large/clothing,
/obj/effect/spawner/random/halflife/loot,
/turf/open/floor/plating/indoor/carpet/green,
/area/halflife/indoors)
"o" = (
/obj/structure/halflife/trash/cardboard{
	dir = 8
	},
/turf/open/floor/plating/indoor/woodc,
/area/halflife/indoors)
"p" = (
/obj/structure/halflife/pallet/stack,
/turf/open/floor/plating/indoor/concrete/bricks,
/area/halflife/indoors)
"q" = (
/obj/structure/table/halflife/wood,
/obj/item/stack/spacecash/c1,
/turf/open/floor/plating/indoor/woodc/fancy,
/area/halflife/indoors)
"t" = (
/obj/machinery/light/small/red/directional/east,
/turf/open/floor/plating/indoor/woodc/fancy,
/area/halflife/indoors)
"u" = (
/obj/structure/table/halflife/no_smooth/wood,
/obj/item/stack/spacecash/c1{
	amount = 5
	},
/turf/open/floor/plating/indoor/concrete/bricks,
/area/halflife/indoors)
"v" = (
/obj/structure/table/halflife/metal/grate,
/turf/open/floor/plating/indoor/concrete/bricks,
/area/halflife/indoors)
"w" = (
/obj/structure/window/fulltile/halflife/nosmooth/brick,
/obj/structure/barricade/wooden/crude,
/turf/open/floor/plating/indoor/woodc,
/area/halflife/indoors)
"z" = (
/obj/machinery/door/unpowered/halflife/metal{
	dir = 8
	},
/turf/open/floor/plating/indoor/woodc/fancy,
/area/halflife/indoors)
"C" = (
/obj/structure/halflife/trash/cardboard,
/turf/open/floor/plating/indoor/carpet/green,
/area/halflife/indoors)
"E" = (
/turf/open/floor/plating/indoor/woodc,
/area/halflife/indoors)
"F" = (
/obj/machinery/door/unpowered/halflife/metal,
/turf/open/floor/plating/indoor/concrete/bricks,
/area/halflife/indoors)
"G" = (
/obj/structure/halflife/storage/large/clothing,
/turf/open/floor/plating/indoor/concrete/bricks,
/area/halflife/indoors)
"H" = (
/obj/item/stack/spacecash/c1,
/turf/open/floor/plating/indoor/carpet/green,
/area/halflife/indoors)
"K" = (
/turf/open/floor/plating/indoor/woodc/fancy,
/area/halflife/indoors)
"L" = (
/obj/modular_map_connector,
/turf/template_noop,
/area/template_noop)
"M" = (
/obj/machinery/light/small/red/directional/east,
/turf/open/floor/plating/indoor/woodc,
/area/halflife/indoors)
"N" = (
/obj/effect/spawner/random/halflife/loot,
/turf/open/floor/plating/indoor/carpet/green,
/area/halflife/indoors)
"P" = (
/obj/structure/table/halflife/no_smooth/large/wood/desk{
	dir = 8
	},
/obj/structure/halflife/rug/yellow,
/turf/open/floor/plating/indoor/woodc/fancy,
/area/halflife/indoors)
"Q" = (
/obj/machinery/door/unpowered/halflife/metal,
/turf/open/floor/plating/indoor/woodc,
/area/halflife/indoors)
"R" = (
/obj/structure/table/halflife/metal/grate,
/obj/item/stack/spacecash/c1,
/turf/open/floor/plating/indoor/concrete/bricks,
/area/halflife/indoors)
"S" = (
/obj/structure/table/halflife/metal/grate,
/obj/structure/halflife/trash/cardboard{
	dir = 4
	},
/obj/effect/spawner/random/halflife/loot,
/turf/open/floor/plating/indoor/concrete/bricks,
/area/halflife/indoors)
"T" = (
/obj/structure/halflife/storage/large/clothing,
/obj/item/stack/spacecash/c1,
/turf/open/floor/plating/indoor/carpet/green,
/area/halflife/indoors)
"V" = (
/obj/structure/table/halflife/wood,
/turf/open/floor/plating/indoor/woodc/fancy,
/area/halflife/indoors)
"W" = (
/obj/structure/halflife/pallet,
/obj/machinery/light/small/red/directional/east,
/turf/open/floor/plating/indoor/concrete/bricks,
/area/halflife/indoors)
"X" = (
/turf/open/floor/plating/indoor/concrete/bricks,
/area/halflife/indoors)

(1,1,1) = {"
b
b
b
b
b
b
b
b
b
b
b
b
b
b
b
b
L
"}
(2,1,1) = {"
b
l
l
l
l
l
l
l
l
l
l
l
l
l
l
l
b
"}
(3,1,1) = {"
b
l
E
E
c
E
E
E
E
E
c
E
E
l
l
l
b
"}
(4,1,1) = {"
b
Q
E
a
m
a
T
a
g
a
T
a
E
l
l
l
b
"}
(5,1,1) = {"
b
l
E
a
a
a
a
a
a
a
a
C
E
l
l
l
b
"}
(6,1,1) = {"
b
l
E
a
T
a
g
a
g
a
m
a
E
l
l
l
b
"}
(7,1,1) = {"
b
l
E
a
a
a
N
a
a
a
H
a
E
l
l
l
b
"}
(8,1,1) = {"
b
l
E
E
E
E
E
E
E
E
E
E
E
l
l
l
b
"}
(9,1,1) = {"
b
w
E
a
T
a
g
a
T
a
g
a
E
l
l
l
b
"}
(10,1,1) = {"
b
w
E
a
a
i
a
a
N
a
a
a
E
l
l
l
b
"}
(11,1,1) = {"
b
l
o
E
M
E
E
E
E
E
E
E
E
l
l
l
b
"}
(12,1,1) = {"
b
l
l
l
l
l
l
l
z
l
l
f
P
l
l
l
b
"}
(13,1,1) = {"
b
l
G
X
S
v
R
l
K
K
K
K
j
l
l
l
b
"}
(14,1,1) = {"
b
l
X
X
h
X
X
F
K
K
K
K
K
l
l
l
b
"}
(15,1,1) = {"
b
l
u
X
W
X
p
l
q
V
t
q
q
l
l
l
b
"}
(16,1,1) = {"
b
l
l
l
l
l
l
l
l
l
l
l
l
l
l
l
b
"}
(17,1,1) = {"
b
b
b
b
b
b
b
b
b
b
b
b
b
b
b
b
b
"}
