//MAP CONVERTED BY dmm2tgm.py THIS HEADER COMMENT PREVENTS RECONVERSION, DO NOT REMOVE
"a" = (
/turf/template_noop,
/area/template_noop)
"b" = (
/obj/machinery/light/small/directional/south,
/turf/open/floor/plating/indoor/woodc/wide,
/area/halflife/indoors)
"c" = (
/obj/structure/flora/xen/leafy,
/turf/open/floor/plating/indoor/woodc,
/area/halflife/indoors)
"e" = (
/obj/structure/flora/xen/tinyshrooms,
/turf/open/floor/plating/indoor/woodc,
/area/halflife/indoors)
"f" = (
/obj/modular_map_connector,
/turf/template_noop,
/area/template_noop)
"h" = (
/turf/closed/wall/halflife/brick,
/area/halflife/indoors)
"k" = (
/turf/open/floor/plating/indoor/woodc,
/area/halflife/indoors)
"l" = (
/obj/effect/spawner/random/halflife/loot/rare,
/turf/open/floor/plating/indoor/woodc/wide,
/area/halflife/indoors)
"m" = (
/mob/living/basic/halflife/headcrab/armored,
/turf/open/floor/plating/indoor/woodc,
/area/halflife/indoors)
"q" = (
/obj/structure/table/halflife/no_smooth/large/wood/square,
/obj/effect/spawner/random/halflife/loot/ammo,
/turf/open/floor/plating/indoor/woodc/wide,
/area/halflife/indoors)
"r" = (
/obj/structure/alien/weeds/node,
/turf/open/floor/plating/indoor/woodc,
/area/halflife/indoors)
"s" = (
/obj/structure/halflife/trash/wood,
/turf/open/floor/plating/indoor/woodc,
/area/halflife/indoors)
"w" = (
/obj/machinery/light/small/directional/north,
/turf/open/floor/plating/indoor/woodc,
/area/halflife/indoors)
"x" = (
/obj/structure/table/halflife/no_smooth/large/wood/desk{
	dir = 1
	},
/turf/open/floor/plating/indoor/woodc,
/area/halflife/indoors)
"y" = (
/obj/machinery/light/small/directional/east,
/turf/open/floor/plating/indoor/woodc,
/area/halflife/indoors)
"A" = (
/obj/effect/spawner/random/halflife/loot/ammo,
/turf/open/floor/plating/indoor/woodc,
/area/halflife/indoors)
"B" = (
/obj/machinery/door/unpowered/halflife/metal{
	dir = 4
	},
/turf/open/floor/plating/indoor/woodc,
/area/halflife/indoors)
"C" = (
/turf/open/floor/plating/indoor/woodc/wide,
/area/halflife/indoors)
"D" = (
/obj/structure/halflife/trash/garbage,
/turf/open/floor/plating/indoor/woodc,
/area/halflife/indoors)
"E" = (
/obj/machinery/light/small/directional/south,
/turf/open/floor/plating/indoor/woodc,
/area/halflife/indoors)
"F" = (
/mob/living/basic/halflife/headcrab/armored,
/turf/open/floor/plating/indoor/woodc/wide,
/area/halflife/indoors)
"G" = (
/obj/structure/halflife/storage/shelf/wood/alt,
/obj/item/stack/spacecash/c1{
	amount = 20
	},
/turf/open/floor/plating/indoor/woodc,
/area/halflife/indoors)
"I" = (
/mob/living/basic/halflife/zombie/fungal,
/turf/open/floor/plating/indoor/woodc,
/area/halflife/indoors)
"K" = (
/obj/structure/halflife/storage/shelf/wood/alt,
/obj/effect/spawner/random/halflife/loot/ammo,
/turf/open/floor/plating/indoor/woodc,
/area/halflife/indoors)
"M" = (
/obj/machinery/door/unpowered/halflife/metal,
/turf/open/floor/plating/indoor/woodc/wide,
/area/halflife/indoors)
"N" = (
/obj/structure/halflife/storage/shelf/wood/alt,
/obj/effect/spawner/random/halflife/loot/heal,
/turf/open/floor/plating/indoor/woodc,
/area/halflife/indoors)
"P" = (
/obj/structure/halflife/storage/large/shelf/wood/alt,
/turf/open/floor/plating/indoor/woodc,
/area/halflife/indoors)
"Q" = (
/obj/machinery/door/unpowered/halflife/metal,
/turf/open/floor/plating/indoor/woodc,
/area/halflife/indoors)
"R" = (
/obj/structure/flora/xen/mound,
/turf/open/floor/plating/indoor/woodc,
/area/halflife/indoors)
"S" = (
/obj/effect/spawner/random/halflife/loot/heal,
/turf/open/floor/plating/indoor/woodc,
/area/halflife/indoors)
"U" = (
/obj/machinery/light/small/directional/west,
/turf/open/floor/plating/indoor/woodc,
/area/halflife/indoors)
"V" = (
/obj/structure/flora/ash/stem_shroom,
/turf/open/floor/plating/indoor/woodc,
/area/halflife/indoors)
"W" = (
/obj/structure/halflife/storage/shelf/wood/alt,
/obj/item/stack/spacecash/c1{
	amount = 20
	},
/turf/open/floor/plating/indoor/woodc/wide,
/area/halflife/indoors)

(1,1,1) = {"
a
a
a
a
a
a
a
a
a
a
a
a
a
a
a
a
f
"}
(2,1,1) = {"
a
h
h
h
h
h
h
h
h
h
h
h
h
h
h
h
a
"}
(3,1,1) = {"
a
h
h
h
h
G
k
I
k
k
k
M
C
C
C
h
a
"}
(4,1,1) = {"
a
h
h
h
h
w
e
k
k
k
c
h
C
C
F
h
a
"}
(5,1,1) = {"
a
h
h
h
h
K
I
r
k
k
I
h
C
C
b
h
a
"}
(6,1,1) = {"
a
h
h
h
h
h
k
k
k
k
k
h
F
C
q
h
a
"}
(7,1,1) = {"
a
h
h
h
h
K
k
k
k
k
e
h
W
C
l
h
a
"}
(8,1,1) = {"
a
h
h
h
h
w
m
R
k
r
k
h
h
h
h
h
a
"}
(9,1,1) = {"
a
h
h
h
h
N
k
k
k
k
k
h
h
h
h
h
a
"}
(10,1,1) = {"
a
h
h
h
h
h
h
h
B
h
h
h
h
h
h
h
a
"}
(11,1,1) = {"
a
h
k
k
k
k
k
e
k
k
U
k
k
k
e
h
a
"}
(12,1,1) = {"
a
h
k
k
k
m
r
k
R
k
k
k
k
k
k
h
a
"}
(13,1,1) = {"
a
h
w
k
h
w
k
s
k
k
e
D
h
k
E
h
a
"}
(14,1,1) = {"
a
h
k
c
h
P
V
k
k
k
r
x
h
k
k
Q
a
"}
(15,1,1) = {"
a
h
k
k
h
A
k
k
c
m
y
S
h
k
k
h
a
"}
(16,1,1) = {"
a
h
h
h
h
h
h
h
h
h
h
h
h
h
h
h
a
"}
(17,1,1) = {"
a
a
a
a
a
a
a
a
a
a
a
a
a
a
a
a
a
"}
