//MAP CONVERTED BY dmm2tgm.py THIS HEADER COMMENT PREVENTS RECONVERSION, DO NOT REMOVE
"bj" = (
/obj/structure/table/halflife/wood,
/obj/item/reagent_containers/condiment/saltshaker,
/turf/open/floor/plating/indoor/carpet,
/area/halflife/indoors)
"bN" = (
/obj/machinery/deepfryer,
/turf/open/floor/plating/indoor/tile/kitchen,
/area/halflife/indoors)
"cd" = (
/obj/structure/chair/halflife/metal/blue{
	dir = 4
	},
/obj/structure/railing/halflife/solo,
/obj/structure/railing/halflife/solo{
	dir = 8
	},
/turf/open/floor/plating/ground/sidewalk/inner,
/area/template_noop)
"ci" = (
/turf/open/floor/plating/indoor/metal/plate,
/area/halflife/indoors)
"dt" = (
/obj/machinery/gibber,
/turf/open/floor/plating/indoor/tile/kitchen,
/area/halflife/indoors)
"eA" = (
/obj/structure/chair/halflife/metal/blue{
	dir = 4
	},
/turf/open/floor/plating/ground/sidewalk/inner,
/area/template_noop)
"ho" = (
/obj/effect/turf_decal/halflife/covering/paint/white,
/turf/closed/wall/halflife/brick,
/area/halflife/indoors)
"jY" = (
/obj/machinery/door/unpowered/halflife/metal{
	dir = 4
	},
/turf/open/floor/plating/indoor/metal/plate,
/area/halflife/indoors)
"kW" = (
/obj/structure/table/halflife/wood/bar,
/obj/machinery/jukebox/radio,
/turf/open/floor/plating/indoor/woodc/wide,
/area/halflife/indoors)
"lb" = (
/turf/open/floor/plating/ground/sidewalk/inner,
/area/template_noop)
"lG" = (
/obj/machinery/processor,
/obj/machinery/light/small/directional/east,
/obj/structure/table/halflife/metal/small,
/turf/open/floor/plating/indoor/tile/kitchen,
/area/halflife/indoors)
"lJ" = (
/turf/open/floor/plating/indoor/woodc/wide,
/area/halflife/indoors)
"nx" = (
/turf/open/floor/plating/indoor/carpet,
/area/halflife/indoors)
"oL" = (
/obj/machinery/door/unpowered/halflife/seethrough/metal{
	keylock = 1;
	lockid = "kitchen";
	dir = 8
	},
/turf/open/floor/plating/indoor/woodc,
/area/halflife/indoors)
"qA" = (
/obj/modular_map_connector,
/turf/template_noop,
/area/template_noop)
"qW" = (
/obj/structure/sink/halflife{
	dir = 4
	},
/turf/open/floor/plating/indoor/tile/kitchen,
/area/halflife/indoors)
"ra" = (
/obj/item/stack/spacecash/c1{
	amount = 5
	},
/obj/structure/table/halflife/no_smooth/large/metal/desk,
/turf/open/floor/plating/indoor/metal/plate,
/area/halflife/indoors)
"rp" = (
/obj/structure/window/fulltile/halflife/nosmooth/brick,
/turf/open/floor/plating/indoor/woodc,
/area/halflife/indoors)
"rT" = (
/obj/structure/table/halflife/no_smooth/metal,
/turf/open/floor/plating/ground/sidewalk/inner,
/area/template_noop)
"rY" = (
/obj/structure/chair/halflife/metal/blue{
	dir = 8
	},
/turf/open/floor/plating/ground/sidewalk/inner,
/area/template_noop)
"sf" = (
/turf/template_noop,
/area/template_noop)
"sQ" = (
/obj/machinery/door/unpowered/halflife/metal{
	dir = 4
	},
/turf/open/floor/plating/indoor/tile/kitchen,
/area/halflife/indoors)
"td" = (
/turf/open/floor/plating/indoor/tile/kitchen,
/area/halflife/indoors)
"uT" = (
/obj/machinery/microwave{
	pixel_y = 4
	},
/obj/machinery/light/small/directional/west,
/turf/open/floor/plating/indoor/tile/kitchen,
/area/halflife/indoors)
"vr" = (
/obj/structure/table/halflife/wood,
/obj/structure/halflife/trash/food/dinner,
/obj/item/stack/spacecash/c1,
/obj/item/stack/spacecash/c1,
/turf/open/floor/plating/indoor/carpet,
/area/halflife/indoors)
"ye" = (
/obj/structure/table/halflife/wood/bar,
/obj/structure/halflife/trash/glass/basic,
/turf/open/floor/plating/indoor/woodc/wide,
/area/halflife/indoors)
"zo" = (
/obj/structure/kitchenspike,
/turf/open/floor/plating/indoor/tile/kitchen,
/area/halflife/indoors)
"Ab" = (
/obj/structure/table/halflife/wood,
/obj/item/reagent_containers/condiment/peppermill,
/turf/open/floor/plating/indoor/carpet,
/area/halflife/indoors)
"BU" = (
/obj/structure/table/halflife/metal,
/obj/item/reagent_containers/condiment/enzyme{
	pixel_x = 9;
	pixel_y = 3
	},
/obj/item/reagent_containers/cup/soup_pot,
/turf/open/floor/plating/indoor/tile/kitchen,
/area/halflife/indoors)
"BZ" = (
/obj/structure/chair/halflife/wood/padded{
	dir = 8
	},
/turf/open/floor/plating/indoor/carpet,
/area/halflife/indoors)
"EG" = (
/obj/structure/table/halflife/no_smooth/metal,
/obj/structure/railing/halflife/solo,
/turf/open/floor/plating/ground/sidewalk/inner,
/area/template_noop)
"EQ" = (
/obj/structure/table/halflife/wood/bar,
/obj/item/plate,
/obj/item/reagent_containers/cup/rag,
/turf/open/floor/plating/indoor/woodc/wide,
/area/halflife/indoors)
"Fs" = (
/obj/machinery/oven/range,
/turf/open/floor/plating/indoor/tile/kitchen,
/area/halflife/indoors)
"FR" = (
/obj/machinery/light/small/directional/west,
/turf/open/floor/plating/indoor/woodc/wide,
/area/halflife/indoors)
"FS" = (
/obj/structure/chair/halflife/wood/padded{
	dir = 4
	},
/turf/open/floor/plating/indoor/carpet,
/area/halflife/indoors)
"Ho" = (
/obj/machinery/griddle,
/turf/open/floor/plating/indoor/tile/kitchen,
/area/halflife/indoors)
"HQ" = (
/obj/structure/table/halflife/wood/bar,
/obj/structure/desk_bell,
/turf/open/floor/plating/indoor/woodc/wide,
/area/halflife/indoors)
"HV" = (
/obj/structure/chair/halflife/wood/padded{
	dir = 4
	},
/obj/machinery/light/small/directional/south,
/turf/open/floor/plating/indoor/carpet,
/area/halflife/indoors)
"Ia" = (
/obj/structure/table/halflife/no_smooth/metal,
/obj/structure/railing/halflife/solo,
/obj/structure/halflife/trash/glass/basic,
/turf/open/floor/plating/ground/sidewalk/inner,
/area/template_noop)
"Jo" = (
/obj/structure/chair/halflife/metal/blue{
	dir = 4
	},
/obj/structure/railing/halflife/solo{
	dir = 8
	},
/turf/open/floor/plating/ground/sidewalk/inner,
/area/template_noop)
"JN" = (
/obj/structure/table/halflife/metal/small,
/obj/item/knife/kitchen,
/obj/item/kitchen/rollingpin,
/obj/item/kitchen/rollingpin,
/turf/open/floor/plating/indoor/tile/kitchen,
/area/halflife/indoors)
"JP" = (
/obj/structure/chair/halflife/metal/blue{
	dir = 4
	},
/obj/structure/railing/halflife/solo,
/turf/open/floor/plating/ground/sidewalk/inner,
/area/template_noop)
"MH" = (
/obj/machinery/light/small/directional/east,
/obj/structure/chair/office/halflife/blue{
	dir = 1
	},
/turf/open/floor/plating/indoor/metal/plate,
/area/halflife/indoors)
"Nq" = (
/obj/machinery/door/unpowered/halflife/metal,
/turf/open/floor/plating/indoor/tile/kitchen,
/area/halflife/indoors)
"NM" = (
/obj/structure/chair/halflife/metal/blue{
	dir = 8
	},
/obj/structure/railing/halflife/solo,
/turf/open/floor/plating/ground/sidewalk/inner,
/area/template_noop)
"NN" = (
/turf/closed/wall/halflife/brick,
/area/halflife/indoors)
"Pn" = (
/obj/structure/table/halflife/no_smooth/large/metal{
	dir = 4
	},
/obj/machinery/reagentgrinder,
/obj/item/reagent_containers/cup/soda_cans/breenwater{
	pixel_x = -10;
	pixel_y = 9
	},
/obj/item/reagent_containers/cup/soda_cans/breenwater{
	pixel_x = -10
	},
/turf/open/floor/plating/indoor/tile/kitchen,
/area/halflife/indoors)
"QS" = (
/obj/machinery/door/unpowered/halflife/seethrough/metal{
	keylock = 1;
	lockid = "kitchen"
	},
/turf/open/floor/plating/indoor/woodc,
/area/halflife/indoors)
"RF" = (
/obj/item/reagent_containers/condiment/mayonnaise,
/obj/item/storage/fancy/egg_box,
/obj/structure/closet/secure_closet/freezer/halflife,
/obj/item/reagent_containers/condiment/milk,
/obj/machinery/light/small/directional/east,
/turf/open/floor/plating/indoor/tile/kitchen,
/area/halflife/indoors)
"RN" = (
/obj/structure/extinguisher_cabinet/directional/west,
/turf/open/floor/plating/indoor/tile/kitchen,
/area/halflife/indoors)
"Tl" = (
/obj/machinery/light/small/directional/west,
/turf/open/floor/plating/indoor/woodc,
/area/halflife/indoors)
"Um" = (
/obj/structure/table/halflife/wood,
/obj/structure/halflife/trash/food/glass,
/obj/item/stack/spacecash/c1,
/obj/item/stack/spacecash/c1,
/turf/open/floor/plating/indoor/carpet,
/area/halflife/indoors)
"UP" = (
/turf/open/floor/plating/indoor/woodc,
/area/halflife/indoors)
"UW" = (
/obj/structure/railing/halflife/solo,
/turf/open/floor/plating/ground/sidewalk/inner,
/area/template_noop)
"Wk" = (
/obj/effect/turf_decal/halflife/covering/wallpaper/red,
/turf/closed/wall/halflife/brick,
/area/halflife/indoors)
"WB" = (
/obj/structure/chair/halflife/wood/padded{
	dir = 8
	},
/obj/machinery/light/small/directional/east,
/turf/open/floor/plating/indoor/carpet,
/area/halflife/indoors)
"WN" = (
/obj/structure/table/halflife/metal,
/obj/item/reagent_containers/condiment/rice,
/obj/item/reagent_containers/cup/bowl,
/obj/item/reagent_containers/cup/bowl,
/turf/open/floor/plating/indoor/tile/kitchen,
/area/halflife/indoors)
"Xf" = (
/obj/structure/table/halflife/wood,
/obj/item/plate/small,
/obj/item/stack/spacecash/c1,
/obj/item/stack/spacecash/c1,
/turf/open/floor/plating/indoor/carpet,
/area/halflife/indoors)
"Xl" = (
/obj/item/food/meat/slab/chicken,
/obj/item/food/meat/slab/chicken,
/obj/item/food/meat/slab/human,
/obj/structure/closet/secure_closet/freezer/halflife,
/obj/item/food/meat/slab/human,
/obj/item/food/meat/slab/synthmeat,
/obj/machinery/light/small/directional/west,
/turf/open/floor/plating/indoor/tile/kitchen,
/area/halflife/indoors)
"Xw" = (
/obj/machinery/grill,
/obj/machinery/light/small/directional/west,
/turf/open/floor/plating/indoor/tile/kitchen,
/area/halflife/indoors)
"Xz" = (
/obj/structure/halflife/rug/mat,
/turf/open/floor/plating/ground/sidewalk/inner,
/area/template_noop)

(1,1,1) = {"
sf
sf
sf
sf
sf
sf
sf
sf
sf
sf
sf
sf
sf
sf
sf
sf
qA
"}
(2,1,1) = {"
sf
NN
NN
NN
NN
NN
NN
NN
NN
NN
NN
NN
Jo
lb
cd
lb
sf
"}
(3,1,1) = {"
sf
ho
qW
Xl
dt
ho
RN
Xw
JN
uT
Pn
NN
rT
lb
EG
lb
sf
"}
(4,1,1) = {"
sf
ho
td
td
td
Nq
td
td
td
td
WN
NN
rY
lb
NM
lb
sf
"}
(5,1,1) = {"
sf
ho
zo
td
td
ho
Ho
td
td
td
BU
NN
lb
lb
UW
lb
sf
"}
(6,1,1) = {"
sf
ho
zo
td
RF
ho
Fs
td
lG
td
bN
NN
eA
lb
JP
lb
sf
"}
(7,1,1) = {"
sf
NN
NN
jY
NN
NN
NN
sQ
NN
sQ
NN
NN
rT
lb
Ia
lb
sf
"}
(8,1,1) = {"
sf
NN
ci
ci
NN
Wk
UP
lJ
FR
lJ
lJ
rp
rY
lb
NM
lb
sf
"}
(9,1,1) = {"
sf
NN
ra
ci
NN
Wk
UP
kW
ye
EQ
HQ
NN
NN
oL
NN
lb
sf
"}
(10,1,1) = {"
sf
NN
ci
MH
NN
Wk
UP
UP
UP
UP
UP
UP
Tl
UP
QS
Xz
sf
"}
(11,1,1) = {"
sf
NN
NN
NN
NN
Wk
UP
UP
UP
UP
UP
UP
UP
UP
NN
NN
sf
"}
(12,1,1) = {"
sf
NN
NN
NN
NN
Wk
UP
FS
FS
nx
FS
FS
UP
nx
nx
rp
sf
"}
(13,1,1) = {"
sf
NN
NN
NN
NN
Wk
UP
Ab
Xf
nx
vr
bj
UP
FS
HV
NN
sf
"}
(14,1,1) = {"
sf
NN
NN
NN
NN
Wk
UP
WB
BZ
nx
WB
BZ
UP
bj
Um
rp
sf
"}
(15,1,1) = {"
sf
NN
NN
NN
NN
NN
NN
NN
NN
NN
NN
NN
NN
NN
NN
NN
sf
"}
(16,1,1) = {"
sf
NN
NN
NN
NN
NN
NN
NN
NN
NN
NN
NN
NN
NN
NN
NN
sf
"}
(17,1,1) = {"
sf
sf
sf
sf
sf
sf
sf
sf
sf
sf
sf
sf
sf
sf
sf
sf
sf
"}
