//MAP CONVERTED BY dmm2tgm.py THIS HEADER COMMENT PREVENTS RECONVERSION, DO NOT REMOVE
"a" = (
/turf/closed/wall/halflife/brick,
/area/halflife/indoors)
"b" = (
/obj/machinery/door/unpowered/halflife/metal,
/turf/open/floor/plating/indoor/woodc,
/area/halflife/indoors)
"f" = (
/obj/structure/table/halflife/wood,
/obj/item/knife/kitchen,
/turf/open/floor/plating/indoor/woodc,
/area/halflife/indoors)
"g" = (
/obj/structure/halflife/trash/wood{
	dir = 1
	},
/turf/open/floor/plating/indoor/woodc,
/area/halflife/indoors)
"h" = (
/obj/structure/halflife/trash/garbage/dumpster/crate,
/turf/open/floor/plating/indoor/woodc,
/area/halflife/indoors)
"j" = (
/obj/structure/halflife/storage/shelf/wood/alt,
/turf/open/floor/plating/indoor/woodc,
/area/halflife/indoors)
"k" = (
/obj/structure/flora/xen/mound,
/turf/open/floor/plating/indoor/woodc,
/area/halflife/indoors)
"l" = (
/obj/structure/sign/warning/biohazard/directional/north,
/obj/structure/alien/weeds,
/turf/open/floor/plating/indoor/woodc,
/area/halflife/indoors)
"o" = (
/obj/structure/table/halflife/wood,
/turf/open/floor/plating/indoor/woodc,
/area/halflife/indoors)
"p" = (
/obj/structure/flora/xen/tinyshrooms,
/turf/open/floor/plating/indoor/woodc,
/area/halflife/indoors)
"q" = (
/obj/structure/sign/warning/biohazard/directional/north,
/turf/open/floor/plating/indoor/woodc,
/area/halflife/indoors)
"s" = (
/obj/structure/alien/weeds,
/turf/open/floor/plating/indoor/woodc,
/area/halflife/indoors)
"u" = (
/obj/machinery/door/unpowered/halflife/seethrough/metal,
/turf/open/floor/plating/indoor/woodc,
/area/halflife/indoors)
"x" = (
/obj/structure/alien/weeds/node,
/turf/open/floor/plating/indoor/woodc,
/area/halflife/indoors)
"z" = (
/turf/template_noop,
/area/template_noop)
"B" = (
/turf/open/floor/plating/indoor/woodc,
/area/halflife/indoors)
"C" = (
/obj/structure/halflife/storage/shelf/wood/alt,
/obj/effect/spawner/random/halflife/loot,
/turf/open/floor/plating/indoor/woodc,
/area/halflife/indoors)
"G" = (
/mob/living/basic/halflife/headcrab/armored,
/turf/open/floor/plating/indoor/woodc,
/area/halflife/indoors)
"H" = (
/obj/structure/table/halflife/no_smooth/cable_reel,
/turf/open/floor/plating/indoor/woodc,
/area/halflife/indoors)
"I" = (
/mob/living/basic/halflife/zombie/gonome/complete{
	name = "Cash-gorged Gonome";
	desc = "A massive, grotesque abomination of flesh and fungas. A horror, which should not be. This one has for some reason gorged itself on loads of cash. A butcher should be able to get out the cash.";
	butcher_results = list(/obj/item/food/meat/slab/halflife/zombie = 3, /obj/item/stack/sheet/animalhide/goliath_hide = 3, /obj/item/stack/spacecash/c100 = 1)
	},
/turf/open/floor/plating/indoor/woodc,
/area/halflife/indoors)
"J" = (
/obj/structure/table/halflife/no_smooth/cable_reel,
/obj/effect/spawner/random/halflife/loot,
/turf/open/floor/plating/indoor/woodc,
/area/halflife/indoors)
"N" = (
/obj/structure/halflife/storage/shelf/wood/alt,
/obj/item/stack/spacecash/c1,
/turf/open/floor/plating/indoor/woodc,
/area/halflife/indoors)
"P" = (
/obj/structure/flora/xen/leafy,
/turf/open/floor/plating/indoor/woodc,
/area/halflife/indoors)
"Q" = (
/obj/item/stack/spacecash/c1,
/turf/open/floor/plating/indoor/woodc,
/area/halflife/indoors)
"W" = (
/obj/structure/table/halflife/no_smooth/cable_reel,
/obj/item/stack/spacecash/c1,
/turf/open/floor/plating/indoor/woodc,
/area/halflife/indoors)
"Y" = (
/obj/modular_map_connector,
/turf/template_noop,
/area/template_noop)

(1,1,1) = {"
z
z
z
z
z
z
z
z
z
z
z
z
z
z
z
z
Y
"}
(2,1,1) = {"
z
a
a
a
a
a
a
a
a
a
a
a
a
a
a
a
z
"}
(3,1,1) = {"
z
a
H
B
h
a
B
B
B
B
B
x
B
B
C
a
z
"}
(4,1,1) = {"
z
a
B
B
B
u
B
B
Q
B
k
B
B
B
j
a
z
"}
(5,1,1) = {"
z
a
W
B
B
a
o
B
B
B
B
B
P
B
C
a
z
"}
(6,1,1) = {"
z
a
h
B
h
a
o
p
x
B
G
B
B
B
H
a
z
"}
(7,1,1) = {"
z
a
a
a
a
a
o
B
B
B
B
Q
x
B
o
a
z
"}
(8,1,1) = {"
z
a
l
s
B
a
B
B
B
Q
B
B
B
B
f
a
z
"}
(9,1,1) = {"
z
u
s
B
B
b
B
B
B
B
I
B
B
B
o
a
z
"}
(10,1,1) = {"
z
a
q
s
s
a
B
B
B
x
B
B
B
B
o
a
z
"}
(11,1,1) = {"
z
a
a
a
a
a
o
B
p
B
Q
B
B
x
o
a
z
"}
(12,1,1) = {"
z
a
H
B
h
a
o
B
x
B
B
G
B
Q
H
a
z
"}
(13,1,1) = {"
z
a
B
B
h
a
o
B
B
B
B
x
B
B
N
a
z
"}
(14,1,1) = {"
z
a
B
B
B
u
B
g
B
p
B
B
k
B
P
a
z
"}
(15,1,1) = {"
z
a
B
J
h
a
B
Q
B
B
B
B
B
B
j
a
z
"}
(16,1,1) = {"
z
a
a
a
a
a
a
a
a
a
a
a
a
a
a
a
z
"}
(17,1,1) = {"
z
z
z
z
z
z
z
z
z
z
z
z
z
z
z
z
z
"}
