//MAP CONVERTED BY dmm2tgm.py THIS HEADER COMMENT PREVENTS RECONVERSION, DO NOT REMOVE
"a" = (
/turf/closed/wall/halflife/concrete,
/area/halflife/indoors)
"b" = (
/obj/structure/halflife/tank,
/turf/open/floor/plating/indoor/concrete/bricks,
/area/halflife/indoors)
"d" = (
/obj/structure/halflife/trash/garbage,
/turf/open/floor/plating/indoor/concrete/bricks,
/area/halflife/indoors)
"e" = (
/obj/structure/halflife/trash/cardboard{
	dir = 8;
	pixel_y = 7
	},
/obj/structure/table/halflife/metal/heavy,
/turf/open/floor/plating/indoor/concrete/bricks,
/area/halflife/indoors)
"f" = (
/turf/open/floor/plating/ground/dirt,
/area/template_noop)
"g" = (
/mob/living/basic/halflife/zombie/poison,
/turf/open/floor/plating/indoor/concrete/bricks,
/area/halflife/indoors)
"i" = (
/obj/machinery/light/small/directional/west,
/turf/open/floor/plating/indoor/concrete/bricks,
/area/halflife/indoors)
"k" = (
/obj/structure/halflife/trash/bricks,
/turf/open/floor/plating/indoor/concrete/bricks,
/area/halflife/indoors)
"l" = (
/obj/structure/table/halflife/metal/grate,
/obj/effect/spawner/random/halflife/loot/rare,
/turf/open/floor/plating/indoor/concrete/bricks,
/area/halflife/indoors)
"m" = (
/turf/open/floor/plating/ground/grass,
/area/template_noop)
"n" = (
/obj/effect/spawner/random/halflife/plant_spawner,
/obj/structure/halflife/trash/garbage,
/turf/open/floor/plating/ground/grass,
/area/template_noop)
"o" = (
/obj/machinery/light/small/directional/north,
/mob/living/basic/halflife/headcrab/poison,
/turf/open/floor/plating/indoor/concrete/bricks,
/area/halflife/indoors)
"q" = (
/obj/machinery/door/unpowered/halflife/seethrough/grate{
	locked = 1;
	keylock = 1
	},
/turf/open/floor/plating/indoor/concrete/bricks,
/area/halflife/indoors)
"r" = (
/obj/effect/spawner/random/halflife/plant_spawner,
/turf/open/floor/plating/ground/dirt,
/area/template_noop)
"s" = (
/obj/structure/table/halflife/metal/grate,
/obj/effect/spawner/random/halflife/loot,
/turf/open/floor/plating/indoor/concrete/bricks,
/area/halflife/indoors)
"t" = (
/obj/structure/closet/halflife/wall/firstaid,
/obj/effect/spawner/random/halflife/loot/heal,
/obj/effect/spawner/random/halflife/loot/heal,
/turf/open/floor/plating/indoor/concrete/bricks,
/area/halflife/indoors)
"v" = (
/obj/modular_map_connector,
/turf/template_noop,
/area/template_noop)
"w" = (
/turf/open/floor/plating/indoor/concrete/bricks,
/area/halflife/indoors)
"x" = (
/obj/effect/spawner/random/halflife/plant_spawner,
/turf/open/floor/plating/ground/grass,
/area/template_noop)
"z" = (
/obj/structure/table/halflife/metal/grate,
/turf/open/floor/plating/indoor/concrete/bricks,
/area/halflife/indoors)
"A" = (
/obj/structure/halflife/trash/garbage,
/turf/open/floor/plating/ground/dirt,
/area/template_noop)
"B" = (
/obj/machinery/light/small/directional/south,
/mob/living/basic/halflife/headcrab/poison,
/turf/open/floor/plating/indoor/concrete/bricks,
/area/halflife/indoors)
"C" = (
/obj/structure/halflife/trash/garbage/dumpster,
/turf/open/floor/plating/ground/dirt,
/area/template_noop)
"D" = (
/mob/living/basic/halflife/headcrab/poison,
/turf/open/floor/plating/indoor/concrete/bricks,
/area/halflife/indoors)
"E" = (
/obj/structure/reagent_dispensers/fueltank,
/turf/open/floor/plating/indoor/concrete/bricks,
/area/halflife/indoors)
"F" = (
/turf/open/floor/plating/indoor/metal/pipe{
	dir = 1
	},
/area/halflife/indoors)
"I" = (
/turf/template_noop,
/area/template_noop)
"L" = (
/obj/machinery/door/unpowered/halflife/metal,
/turf/open/floor/plating/indoor/concrete/bricks,
/area/halflife/indoors)
"M" = (
/obj/structure/halflife/fence/wire,
/turf/open/floor/plating/indoor/concrete/bricks,
/area/halflife/indoors)
"N" = (
/obj/machinery/light/small/directional/north,
/turf/open/floor/plating/indoor/concrete/bricks,
/area/halflife/indoors)
"P" = (
/obj/machinery/door/unpowered/halflife/metal{
	dir = 8
	},
/turf/open/floor/plating/indoor/concrete/bricks,
/area/halflife/indoors)
"Q" = (
/obj/structure/table/halflife/metal/grate,
/obj/machinery/light/small/directional/west,
/obj/effect/spawner/random/halflife/loot/rare,
/turf/open/floor/plating/indoor/concrete/bricks,
/area/halflife/indoors)
"R" = (
/obj/structure/halflife/storage/shelf,
/obj/effect/spawner/random/halflife/loot,
/turf/open/floor/plating/indoor/concrete/bricks,
/area/halflife/indoors)
"S" = (
/obj/structure/table/halflife/metal/grate,
/obj/item/stack/spacecash/c10,
/turf/open/floor/plating/indoor/concrete/bricks,
/area/halflife/indoors)
"U" = (
/obj/machinery/light/small/directional/south,
/turf/open/floor/plating/indoor/concrete/bricks,
/area/halflife/indoors)
"V" = (
/obj/structure/table/halflife/metal/grate,
/obj/item/stack/spacecash/c1{
	amount = 5
	},
/turf/open/floor/plating/indoor/concrete/bricks,
/area/halflife/indoors)
"W" = (
/obj/machinery/light/small/directional/east,
/turf/open/floor/plating/indoor/concrete/bricks,
/area/halflife/indoors)
"X" = (
/obj/machinery/door/unpowered/halflife/seethrough/fence/wire,
/turf/open/floor/plating/indoor/concrete/bricks,
/area/halflife/indoors)
"Y" = (
/obj/structure/halflife/trash/garbage/dumpster/crate,
/turf/open/floor/plating/indoor/concrete/bricks,
/area/halflife/indoors)
"Z" = (
/obj/structure/halflife/storage/shelf,
/obj/item/stack/spacecash/c1{
	amount = 5
	},
/turf/open/floor/plating/indoor/concrete/bricks,
/area/halflife/indoors)

(1,1,1) = {"
I
I
I
I
I
I
I
I
I
I
I
I
I
I
I
I
v
"}
(2,1,1) = {"
I
a
a
a
a
a
a
a
a
a
a
a
a
a
a
a
I
"}
(3,1,1) = {"
I
L
w
i
w
X
w
w
e
a
b
w
w
w
k
a
I
"}
(4,1,1) = {"
I
a
R
w
w
M
w
w
w
a
b
w
w
w
w
a
I
"}
(5,1,1) = {"
I
a
a
a
a
a
b
w
B
a
b
w
w
w
w
a
I
"}
(6,1,1) = {"
I
a
F
F
F
a
t
w
w
a
o
w
w
w
U
a
I
"}
(7,1,1) = {"
I
a
Y
D
w
q
w
w
w
a
w
w
w
w
w
a
I
"}
(8,1,1) = {"
I
a
N
w
w
a
b
w
w
L
w
w
w
w
s
a
I
"}
(9,1,1) = {"
I
a
R
w
w
a
E
w
w
a
w
w
w
w
V
a
I
"}
(10,1,1) = {"
I
a
Z
w
d
a
a
P
a
a
w
w
w
w
s
a
I
"}
(11,1,1) = {"
I
a
a
a
a
a
w
w
w
a
a
a
a
a
a
a
I
"}
(12,1,1) = {"
I
f
x
m
a
z
w
w
w
g
z
Q
a
C
n
m
I
"}
(13,1,1) = {"
I
f
m
m
a
z
w
w
w
w
w
S
a
A
m
m
I
"}
(14,1,1) = {"
I
f
f
x
a
s
w
w
w
w
w
S
a
f
f
x
I
"}
(15,1,1) = {"
I
f
r
m
a
w
g
W
w
w
z
l
a
f
r
m
I
"}
(16,1,1) = {"
I
f
f
f
a
a
a
a
a
a
a
a
a
f
f
f
I
"}
(17,1,1) = {"
I
I
I
I
I
I
I
I
I
I
I
I
I
I
I
I
I
"}
