//MAP CONVERTED BY dmm2tgm.py THIS HEADER COMMENT PREVENTS RECONVERSION, DO NOT REMOVE
"a" = (
/obj/structure/table/halflife/no_smooth/large/metal,
/obj/effect/spawner/random/halflife/loot/rare,
/turf/open/floor/plating/indoor/metal/combine,
/area/halflife/indoors)
"b" = (
/mob/living/basic/halflife/zombie/zombine/elite,
/turf/open/floor/plating/indoor/metal/smooth,
/area/halflife/indoors)
"e" = (
/obj/structure/table/halflife/no_smooth/large/metal{
	dir = 8
	},
/turf/open/floor/plating/indoor/metal/combine/alt2,
/area/halflife/indoors)
"f" = (
/obj/structure/table/halflife/no_smooth/large/metal,
/obj/effect/spawner/random/halflife/loot/ammo,
/turf/open/floor/plating/indoor/metal/combine,
/area/halflife/indoors)
"g" = (
/turf/open/floor/plating/indoor/metal/smooth,
/area/halflife/indoors)
"m" = (
/obj/structure/table/halflife/no_smooth/large/metal{
	dir = 8
	},
/obj/machinery/combine_walllight/directional/west,
/turf/open/floor/plating/indoor/metal/smooth,
/area/halflife/indoors)
"n" = (
/obj/structure/table/halflife/no_smooth/large/metal,
/turf/open/floor/plating/indoor/metal/smooth,
/area/halflife/indoors)
"o" = (
/obj/machinery/door/airlock/highsecurity/combine,
/turf/open/floor/plating/indoor/metal/combine,
/area/halflife/indoors)
"p" = (
/obj/machinery/combine_walllight/directional/north,
/turf/open/floor/plating/indoor/metal/combine,
/area/halflife/indoors)
"q" = (
/obj/effect/spawner/random/halflife/loot/ammo,
/turf/open/floor/plating/indoor/metal/combine,
/area/halflife/indoors)
"r" = (
/obj/item/storage/backpack/halflife/satchel/civilprotection,
/turf/open/floor/plating/indoor/metal/combine,
/area/halflife/indoors)
"t" = (
/obj/machinery/door/airlock/highsecurity/combine,
/turf/open/floor/plating/indoor/metal/smooth,
/area/halflife/indoors)
"u" = (
/obj/effect/spawner/random/halflife/loot/rare,
/turf/open/floor/plating/indoor/metal/smooth,
/area/halflife/indoors)
"v" = (
/obj/item/stack/spacecash/c10,
/turf/open/floor/plating/indoor/metal/smooth,
/area/halflife/indoors)
"w" = (
/obj/structure/table/halflife/no_smooth/large/metal,
/obj/item/storage/backpack/halflife/satchel/civilprotection,
/turf/open/floor/plating/indoor/metal/combine,
/area/halflife/indoors)
"x" = (
/turf/open/floor/plating/indoor/metal/combine/alt2,
/area/halflife/indoors)
"z" = (
/mob/living/basic/halflife/zombie/zombine,
/turf/open/floor/plating/indoor/metal/smooth,
/area/halflife/indoors)
"D" = (
/obj/machinery/combine_walllight/directional/south,
/turf/open/floor/plating/indoor/metal/smooth,
/area/halflife/indoors)
"E" = (
/obj/machinery/combine_walllight/directional/north,
/turf/open/floor/plating/indoor/metal/smooth,
/area/halflife/indoors)
"F" = (
/turf/open/floor/plating/indoor/metal/combine,
/area/halflife/indoors)
"G" = (
/obj/modular_map_connector,
/turf/template_noop,
/area/template_noop)
"I" = (
/obj/structure/bed/halflife/bedframe/wire,
/obj/structure/bed/halflife/mattress/stained,
/turf/open/floor/plating/indoor/metal/smooth,
/area/halflife/indoors)
"J" = (
/mob/living/basic/halflife/zombie/zombine,
/turf/open/floor/plating/indoor/metal/combine,
/area/halflife/indoors)
"K" = (
/obj/effect/spawner/random/halflife/loot/rare,
/turf/open/floor/plating/indoor/metal/combine,
/area/halflife/indoors)
"M" = (
/obj/structure/bed/halflife/bedframe/wire,
/obj/structure/bed/halflife/mattress/stained,
/obj/item/stack/spacecash/c10,
/turf/open/floor/plating/indoor/metal/smooth,
/area/halflife/indoors)
"O" = (
/obj/item/stack/spacecash/c10,
/turf/open/floor/plating/indoor/metal/combine,
/area/halflife/indoors)
"P" = (
/obj/structure/table/halflife/no_smooth/large/metal,
/obj/item/stack/spacecash/c10,
/turf/open/floor/plating/indoor/metal/combine,
/area/halflife/indoors)
"Q" = (
/turf/closed/wall/halflife/metal,
/area/halflife/indoors)
"R" = (
/turf/template_noop,
/area/template_noop)
"V" = (
/mob/living/basic/halflife/zombie/zombie_grunt,
/turf/open/floor/plating/indoor/metal/smooth,
/area/halflife/indoors)

(1,1,1) = {"
R
R
R
R
R
R
R
R
R
R
R
R
R
R
R
R
G
"}
(2,1,1) = {"
R
Q
Q
Q
Q
Q
Q
Q
Q
Q
Q
Q
Q
Q
Q
Q
R
"}
(3,1,1) = {"
R
Q
g
g
g
g
Q
g
g
g
Q
g
g
g
I
Q
R
"}
(4,1,1) = {"
R
t
g
g
g
g
t
g
g
g
t
g
g
g
I
Q
R
"}
(5,1,1) = {"
R
Q
g
g
g
g
Q
g
g
g
Q
g
g
g
E
Q
R
"}
(6,1,1) = {"
R
Q
x
e
Q
Q
Q
D
g
g
Q
g
g
g
I
Q
R
"}
(7,1,1) = {"
R
Q
g
g
g
g
Q
g
g
V
Q
n
g
g
I
Q
R
"}
(8,1,1) = {"
R
Q
g
z
g
g
t
g
g
g
Q
g
g
g
g
Q
R
"}
(9,1,1) = {"
R
Q
v
m
g
g
Q
g
g
g
Q
g
g
g
b
Q
R
"}
(10,1,1) = {"
R
Q
Q
Q
Q
Q
Q
Q
o
Q
Q
n
g
g
g
Q
R
"}
(11,1,1) = {"
R
Q
w
F
P
F
a
J
F
F
Q
u
g
g
g
Q
R
"}
(12,1,1) = {"
R
Q
K
F
F
F
q
F
F
F
Q
I
g
g
I
Q
R
"}
(13,1,1) = {"
R
Q
F
F
F
F
F
F
F
p
Q
I
g
g
E
Q
R
"}
(14,1,1) = {"
R
Q
f
J
a
F
P
F
F
F
Q
M
g
g
I
Q
R
"}
(15,1,1) = {"
R
Q
O
F
F
F
r
F
F
F
Q
I
g
g
M
Q
R
"}
(16,1,1) = {"
R
Q
Q
Q
Q
Q
Q
Q
Q
Q
Q
Q
Q
Q
Q
Q
R
"}
(17,1,1) = {"
R
R
R
R
R
R
R
R
R
R
R
R
R
R
R
R
R
"}
