//MAP CONVERTED BY dmm2tgm.py THIS HEADER COMMENT PREVENTS RECONVERSION, DO NOT REMOVE
"a" = (
/turf/template_noop,
/area/template_noop)
"c" = (
/obj/structure/halflife/pot/plant,
/turf/open/floor/plating/indoor/woodc/mosaic,
/area/halflife/indoors)
"e" = (
/obj/structure/chair/office/halflife/blue{
	dir = 1
	},
/turf/open/floor/plating/indoor/woodc/fancy,
/area/halflife/indoors)
"f" = (
/turf/closed/wall/halflife/concrete/alt,
/area/halflife/indoors)
"g" = (
/obj/structure/table/halflife/wood,
/obj/item/stack/spacecash/c10,
/turf/open/floor/plating/indoor/woodc/fancy,
/area/halflife/indoors)
"h" = (
/mob/living/basic/halflife/grub,
/turf/open/floor/plating/indoor/woodc,
/area/halflife/indoors)
"k" = (
/obj/structure/chair/office/halflife/blue{
	dir = 8
	},
/turf/open/floor/plating/indoor/carpet,
/area/halflife/indoors)
"m" = (
/obj/modular_map_connector,
/turf/template_noop,
/area/template_noop)
"n" = (
/obj/structure/table/halflife/wood,
/turf/open/floor/plating/indoor/woodc/mosaic,
/area/halflife/indoors)
"p" = (
/turf/open/floor/plating/indoor/woodc,
/area/halflife/indoors)
"q" = (
/obj/structure/chair/office/halflife/blue,
/turf/open/floor/plating/indoor/woodc/fancy,
/area/halflife/indoors)
"r" = (
/obj/machinery/door/unpowered/halflife/wood{
	dir = 8
	},
/turf/open/floor/plating/indoor/woodc,
/area/halflife/indoors)
"s" = (
/obj/structure/alien/weeds,
/obj/machinery/light/small/broken/directional/east,
/turf/open/floor/plating/indoor/woodc,
/area/halflife/indoors)
"t" = (
/mob/living/basic/halflife/grub{
	dir = 8
	},
/turf/open/floor/plating/indoor/woodc,
/area/halflife/indoors)
"u" = (
/obj/structure/table/halflife/wood,
/obj/item/stack/spacecash/c10,
/obj/structure/alien/weeds,
/turf/open/floor/plating/indoor/woodc/fancy,
/area/halflife/indoors)
"v" = (
/obj/structure/spawner/halflife/antlion/small,
/turf/open/floor/plating/indoor/woodc,
/area/halflife/indoors)
"x" = (
/obj/machinery/light/small/broken/directional/east,
/turf/open/floor/plating/indoor/woodc,
/area/halflife/indoors)
"z" = (
/obj/machinery/door/unpowered/halflife/wood,
/turf/open/floor/plating/indoor/woodc,
/area/halflife/indoors)
"A" = (
/obj/structure/flora/xen/leafy,
/obj/structure/alien/weeds,
/turf/open/floor/plating/indoor/woodc,
/area/halflife/indoors)
"C" = (
/obj/structure/table/halflife/wood,
/turf/open/floor/plating/indoor/carpet,
/area/halflife/indoors)
"D" = (
/mob/living/basic/halflife/grub{
	dir = 4
	},
/obj/structure/alien/weeds,
/turf/open/floor/plating/indoor/woodc,
/area/halflife/indoors)
"F" = (
/obj/machinery/light/small/directional/east,
/turf/open/floor/plating/indoor/woodc,
/area/halflife/indoors)
"G" = (
/obj/structure/spawner/halflife/antlion/small/worker,
/turf/open/floor/plating/indoor/woodc,
/area/halflife/indoors)
"K" = (
/obj/machinery/light/small/directional/west,
/turf/open/floor/plating/indoor/woodc/mosaic,
/area/halflife/indoors)
"L" = (
/obj/structure/table/halflife/wood,
/obj/effect/spawner/random/halflife/loot,
/turf/open/floor/plating/indoor/woodc/mosaic,
/area/halflife/indoors)
"M" = (
/obj/structure/table/halflife/wood,
/turf/open/floor/plating/indoor/woodc,
/area/halflife/indoors)
"R" = (
/obj/structure/table/halflife/wood,
/obj/structure/alien/weeds,
/turf/open/floor/plating/indoor/woodc,
/area/halflife/indoors)
"S" = (
/turf/open/floor/plating/indoor/carpet,
/area/halflife/indoors)
"T" = (
/turf/open/floor/plating/indoor/woodc/mosaic,
/area/halflife/indoors)
"U" = (
/obj/structure/alien/weeds,
/turf/open/floor/plating/indoor/woodc,
/area/halflife/indoors)
"X" = (
/mob/living/basic/halflife/grub{
	dir = 4
	},
/turf/open/floor/plating/indoor/carpet,
/area/halflife/indoors)

(1,1,1) = {"
a
a
a
a
a
a
a
a
a
a
a
a
a
a
a
a
m
"}
(2,1,1) = {"
a
f
f
f
f
f
f
f
f
f
f
f
f
f
f
f
a
"}
(3,1,1) = {"
a
f
n
L
c
K
T
T
T
T
T
K
c
L
n
f
a
"}
(4,1,1) = {"
a
f
p
p
p
p
p
p
p
p
p
p
p
p
p
z
a
"}
(5,1,1) = {"
a
f
p
p
p
p
p
p
p
p
p
p
p
p
p
f
a
"}
(6,1,1) = {"
a
f
f
f
f
f
f
f
r
f
f
f
f
f
f
f
a
"}
(7,1,1) = {"
a
f
p
p
p
p
U
U
p
p
p
p
p
A
U
f
a
"}
(8,1,1) = {"
a
f
p
p
A
p
F
p
p
p
F
p
p
p
U
f
a
"}
(9,1,1) = {"
a
f
p
p
p
M
f
C
C
C
f
R
p
p
p
f
a
"}
(10,1,1) = {"
a
f
v
p
p
M
f
S
k
X
f
M
p
p
p
f
a
"}
(11,1,1) = {"
a
f
U
p
p
p
p
v
p
A
p
p
p
v
p
f
a
"}
(12,1,1) = {"
a
f
U
U
p
p
p
p
p
p
p
D
p
p
p
f
a
"}
(13,1,1) = {"
a
f
u
p
G
p
p
p
p
p
U
U
p
p
g
f
a
"}
(14,1,1) = {"
a
f
g
p
p
p
h
p
p
p
p
p
p
p
g
f
a
"}
(15,1,1) = {"
a
f
q
p
s
A
p
U
U
t
p
v
x
p
e
f
a
"}
(16,1,1) = {"
a
f
f
f
f
f
f
f
f
f
f
f
f
f
f
f
a
"}
(17,1,1) = {"
a
a
a
a
a
a
a
a
a
a
a
a
a
a
a
a
a
"}
