//MAP CONVERTED BY dmm2tgm.py THIS HEADER COMMENT PREVENTS RECONVERSION, DO NOT REMOVE
"a" = (
/turf/open/floor/plating/indoor/woodc,
/area/halflife/indoors)
"b" = (
/obj/structure/halflife/storage/shelf/wood/alt,
/obj/item/stack/spacecash/c1{
	amount = 20
	},
/turf/open/floor/plating/indoor/woodc,
/area/halflife/indoors)
"d" = (
/obj/machinery/light/small/directional/north,
/turf/open/floor/plating/indoor/woodc,
/area/halflife/indoors)
"f" = (
/obj/machinery/light/small/directional/south,
/turf/open/floor/plating/indoor/woodc/wide,
/area/halflife/indoors)
"h" = (
/mob/living/basic/halflife/zombie/fungal,
/turf/open/floor/plating/indoor/woodc,
/area/halflife/indoors)
"j" = (
/obj/structure/alien/weeds/node,
/turf/open/floor/plating/indoor/woodc,
/area/halflife/indoors)
"k" = (
/obj/structure/halflife/trash/garbage,
/turf/open/floor/plating/indoor/woodc,
/area/halflife/indoors)
"l" = (
/obj/structure/halflife/storage/shelf/wood/alt,
/obj/item/stack/spacecash/c1{
	amount = 20
	},
/turf/open/floor/plating/indoor/woodc/wide,
/area/halflife/indoors)
"m" = (
/turf/closed/wall/halflife/brick,
/area/halflife/indoors)
"n" = (
/obj/structure/flora/xen/tinyshrooms,
/turf/open/floor/plating/indoor/woodc,
/area/halflife/indoors)
"p" = (
/obj/machinery/light/small/directional/south,
/turf/open/floor/plating/indoor/woodc,
/area/halflife/indoors)
"q" = (
/obj/effect/spawner/random/halflife/loot/rare,
/turf/open/floor/plating/indoor/woodc/wide,
/area/halflife/indoors)
"s" = (
/obj/structure/flora/xen/leafy,
/turf/open/floor/plating/indoor/woodc,
/area/halflife/indoors)
"t" = (
/obj/structure/halflife/storage/shelf/wood/alt,
/obj/effect/spawner/random/halflife/loot/ammo,
/turf/open/floor/plating/indoor/woodc,
/area/halflife/indoors)
"v" = (
/obj/structure/flora/ash/stem_shroom,
/turf/open/floor/plating/indoor/woodc,
/area/halflife/indoors)
"x" = (
/obj/structure/halflife/storage/shelf/wood/alt,
/obj/effect/spawner/random/halflife/loot/heal,
/turf/open/floor/plating/indoor/woodc,
/area/halflife/indoors)
"z" = (
/obj/machinery/light/small/directional/east,
/turf/open/floor/plating/indoor/woodc,
/area/halflife/indoors)
"A" = (
/obj/machinery/light/small/directional/west,
/turf/open/floor/plating/indoor/woodc,
/area/halflife/indoors)
"B" = (
/obj/effect/spawner/random/halflife/loot/heal,
/turf/open/floor/plating/indoor/woodc,
/area/halflife/indoors)
"C" = (
/mob/living/basic/halflife/headcrab/armored,
/turf/open/floor/plating/indoor/woodc/wide,
/area/halflife/indoors)
"E" = (
/obj/structure/table/halflife/no_smooth/large/wood/square,
/obj/effect/spawner/random/halflife/loot/ammo,
/turf/open/floor/plating/indoor/woodc/wide,
/area/halflife/indoors)
"K" = (
/obj/structure/halflife/trash/wood,
/turf/open/floor/plating/indoor/woodc,
/area/halflife/indoors)
"L" = (
/obj/machinery/door/unpowered/halflife/metal{
	dir = 4
	},
/turf/open/floor/plating/indoor/woodc,
/area/halflife/indoors)
"M" = (
/obj/effect/spawner/random/halflife/loot/ammo,
/turf/open/floor/plating/indoor/woodc,
/area/halflife/indoors)
"O" = (
/turf/open/floor/plating/indoor/woodc/wide,
/area/halflife/indoors)
"R" = (
/mob/living/basic/halflife/headcrab/armored,
/turf/open/floor/plating/indoor/woodc,
/area/halflife/indoors)
"S" = (
/turf/template_noop,
/area/template_noop)
"T" = (
/obj/machinery/door/unpowered/halflife/metal,
/turf/open/floor/plating/indoor/woodc,
/area/halflife/indoors)
"U" = (
/obj/modular_map_connector,
/turf/template_noop,
/area/template_noop)
"V" = (
/obj/machinery/door/unpowered/halflife/metal,
/turf/open/floor/plating/indoor/woodc/wide,
/area/halflife/indoors)
"W" = (
/obj/structure/halflife/storage/large/shelf/wood/alt,
/turf/open/floor/plating/indoor/woodc,
/area/halflife/indoors)
"X" = (
/obj/structure/flora/xen/mound,
/turf/open/floor/plating/indoor/woodc,
/area/halflife/indoors)
"Z" = (
/obj/structure/table/halflife/no_smooth/large/wood/desk{
	dir = 1
	},
/turf/open/floor/plating/indoor/woodc,
/area/halflife/indoors)

(1,1,1) = {"
S
S
S
S
S
S
S
S
S
S
S
S
S
S
S
S
U
"}
(2,1,1) = {"
S
m
m
m
m
m
m
m
m
m
m
m
m
m
m
m
S
"}
(3,1,1) = {"
S
m
m
m
m
b
a
h
a
a
a
V
O
O
O
m
S
"}
(4,1,1) = {"
S
m
m
m
m
d
n
a
a
a
s
m
O
O
C
m
S
"}
(5,1,1) = {"
S
m
m
m
m
t
h
j
a
a
h
m
O
O
f
m
S
"}
(6,1,1) = {"
S
m
m
m
m
m
a
a
a
a
a
m
C
O
E
m
S
"}
(7,1,1) = {"
S
m
m
m
m
t
a
a
a
a
n
m
l
O
q
m
S
"}
(8,1,1) = {"
S
m
m
m
m
d
R
X
a
j
a
m
m
m
m
m
S
"}
(9,1,1) = {"
S
m
m
m
m
x
a
a
a
a
a
m
m
m
m
m
S
"}
(10,1,1) = {"
S
m
m
m
m
m
m
m
L
m
m
m
m
m
m
m
S
"}
(11,1,1) = {"
S
m
a
a
a
a
a
n
a
a
A
a
a
a
n
m
S
"}
(12,1,1) = {"
S
m
a
a
a
R
j
a
X
a
a
a
a
a
a
m
S
"}
(13,1,1) = {"
S
m
d
a
m
d
a
K
a
a
n
k
m
a
p
m
S
"}
(14,1,1) = {"
S
T
a
s
m
W
v
a
a
a
j
Z
m
a
a
m
S
"}
(15,1,1) = {"
S
m
a
a
m
M
a
a
s
R
z
B
m
a
a
m
S
"}
(16,1,1) = {"
S
m
m
m
m
m
m
m
m
m
m
m
m
m
m
m
S
"}
(17,1,1) = {"
S
S
S
S
S
S
S
S
S
S
S
S
S
S
S
S
S
"}
