//MAP CONVERTED BY dmm2tgm.py THIS HEADER COMMENT PREVENTS RECONVERSION, DO NOT REMOVE
"a" = (
/turf/closed/wall/halflife/concrete/alt,
/area/halflife/indoors)
"b" = (
/obj/structure/halflife/pot/plant,
/turf/open/floor/plating/indoor/woodc/mosaic,
/area/halflife/indoors)
"d" = (
/obj/structure/table/halflife/wood,
/turf/open/floor/plating/indoor/carpet,
/area/halflife/indoors)
"f" = (
/obj/structure/table/halflife/wood,
/obj/structure/alien/weeds,
/turf/open/floor/plating/indoor/woodc,
/area/halflife/indoors)
"g" = (
/obj/structure/alien/weeds,
/turf/open/floor/plating/indoor/woodc,
/area/halflife/indoors)
"h" = (
/obj/machinery/light/small/directional/east,
/turf/open/floor/plating/indoor/woodc,
/area/halflife/indoors)
"i" = (
/mob/living/basic/halflife/grub{
	dir = 8
	},
/turf/open/floor/plating/indoor/woodc,
/area/halflife/indoors)
"j" = (
/obj/structure/table/halflife/wood,
/turf/open/floor/plating/indoor/woodc,
/area/halflife/indoors)
"l" = (
/obj/machinery/light/small/broken/directional/east,
/turf/open/floor/plating/indoor/woodc,
/area/halflife/indoors)
"m" = (
/obj/modular_map_connector,
/turf/template_noop,
/area/template_noop)
"q" = (
/obj/machinery/door/unpowered/halflife/wood,
/turf/open/floor/plating/indoor/woodc,
/area/halflife/indoors)
"r" = (
/obj/structure/table/halflife/wood,
/obj/item/stack/spacecash/c10,
/turf/open/floor/plating/indoor/woodc/fancy,
/area/halflife/indoors)
"t" = (
/obj/structure/spawner/halflife/antlion/small/worker,
/turf/open/floor/plating/indoor/woodc,
/area/halflife/indoors)
"u" = (
/obj/machinery/door/unpowered/halflife/wood{
	dir = 8
	},
/turf/open/floor/plating/indoor/woodc,
/area/halflife/indoors)
"w" = (
/obj/structure/chair/office/halflife/blue{
	dir = 1
	},
/turf/open/floor/plating/indoor/woodc/fancy,
/area/halflife/indoors)
"x" = (
/obj/structure/table/halflife/wood,
/turf/open/floor/plating/indoor/woodc/mosaic,
/area/halflife/indoors)
"y" = (
/mob/living/basic/halflife/grub{
	dir = 4
	},
/turf/open/floor/plating/indoor/carpet,
/area/halflife/indoors)
"A" = (
/obj/machinery/light/small/directional/west,
/turf/open/floor/plating/indoor/woodc/mosaic,
/area/halflife/indoors)
"B" = (
/mob/living/basic/halflife/grub,
/turf/open/floor/plating/indoor/woodc,
/area/halflife/indoors)
"E" = (
/obj/structure/chair/office/halflife/blue{
	dir = 8
	},
/turf/open/floor/plating/indoor/carpet,
/area/halflife/indoors)
"F" = (
/obj/structure/chair/office/halflife/blue,
/turf/open/floor/plating/indoor/woodc/fancy,
/area/halflife/indoors)
"G" = (
/obj/structure/table/halflife/wood,
/obj/item/stack/spacecash/c10,
/obj/structure/alien/weeds,
/turf/open/floor/plating/indoor/woodc/fancy,
/area/halflife/indoors)
"K" = (
/obj/structure/alien/weeds,
/obj/machinery/light/small/broken/directional/east,
/turf/open/floor/plating/indoor/woodc,
/area/halflife/indoors)
"L" = (
/obj/structure/spawner/halflife/antlion/small,
/turf/open/floor/plating/indoor/woodc,
/area/halflife/indoors)
"O" = (
/turf/open/floor/plating/indoor/woodc/mosaic,
/area/halflife/indoors)
"Q" = (
/turf/open/floor/plating/indoor/carpet,
/area/halflife/indoors)
"S" = (
/turf/template_noop,
/area/template_noop)
"T" = (
/mob/living/basic/halflife/grub{
	dir = 4
	},
/obj/structure/alien/weeds,
/turf/open/floor/plating/indoor/woodc,
/area/halflife/indoors)
"V" = (
/obj/structure/flora/xen/leafy,
/obj/structure/alien/weeds,
/turf/open/floor/plating/indoor/woodc,
/area/halflife/indoors)
"W" = (
/obj/structure/table/halflife/wood,
/obj/effect/spawner/random/halflife/loot,
/turf/open/floor/plating/indoor/woodc/mosaic,
/area/halflife/indoors)
"X" = (
/turf/open/floor/plating/indoor/woodc,
/area/halflife/indoors)

(1,1,1) = {"
S
S
S
S
S
S
S
S
S
S
S
S
S
S
S
S
m
"}
(2,1,1) = {"
S
a
a
a
a
a
a
a
a
a
a
a
a
a
a
a
S
"}
(3,1,1) = {"
S
a
x
W
b
A
O
O
O
O
O
A
b
W
x
a
S
"}
(4,1,1) = {"
S
q
X
X
X
X
X
X
X
X
X
X
X
X
X
a
S
"}
(5,1,1) = {"
S
a
X
X
X
X
X
X
X
X
X
X
X
X
X
a
S
"}
(6,1,1) = {"
S
a
a
a
a
a
a
a
u
a
a
a
a
a
a
a
S
"}
(7,1,1) = {"
S
a
X
X
X
X
g
g
X
X
X
X
X
V
g
a
S
"}
(8,1,1) = {"
S
a
X
X
V
X
h
X
X
X
h
X
X
X
g
a
S
"}
(9,1,1) = {"
S
a
X
X
X
j
a
d
d
d
a
f
X
X
X
a
S
"}
(10,1,1) = {"
S
a
L
X
X
j
a
Q
E
y
a
j
X
X
X
a
S
"}
(11,1,1) = {"
S
a
g
X
X
X
X
L
X
V
X
X
X
L
X
a
S
"}
(12,1,1) = {"
S
a
g
g
X
X
X
X
X
X
X
T
X
X
X
a
S
"}
(13,1,1) = {"
S
a
G
X
t
X
X
X
X
X
g
g
X
X
r
a
S
"}
(14,1,1) = {"
S
a
r
X
X
X
B
X
X
X
X
X
X
X
r
a
S
"}
(15,1,1) = {"
S
a
F
X
K
V
X
g
g
i
X
L
l
X
w
a
S
"}
(16,1,1) = {"
S
a
a
a
a
a
a
a
a
a
a
a
a
a
a
a
S
"}
(17,1,1) = {"
S
S
S
S
S
S
S
S
S
S
S
S
S
S
S
S
S
"}
