//MAP CONVERTED BY dmm2tgm.py THIS HEADER COMMENT PREVENTS RECONVERSION, DO NOT REMOVE
"a" = (
/turf/open/floor/plating/indoor/sterilesquares,
/area/halflife/indoors)
"b" = (
/obj/machinery/light/small/broken/directional/east,
/turf/open/floor/plating/indoor/sterilesquares,
/area/halflife/indoors)
"c" = (
/obj/structure/table/halflife/no_smooth/large/metal,
/obj/item/reagent_containers/hypospray/medipen/healthpen,
/turf/open/floor/plating/indoor/metal/plate,
/area/halflife/indoors)
"d" = (
/obj/structure/halflife/trash/papers/three{
	dir = 8;
	pixel_y = 8
	},
/turf/open/floor/plating/indoor/sterilesquares,
/area/halflife/indoors)
"e" = (
/obj/structure/chair/office/halflife/blue{
	dir = 8
	},
/turf/open/floor/plating/indoor/sterilesquares,
/area/halflife/indoors)
"f" = (
/obj/structure/halflife/sign/clinic{
	pixel_y = 0
	},
/obj/effect/turf_decal/halflife/covering/tiles/white,
/turf/closed/wall/halflife/brick/grey,
/area/halflife/indoors)
"g" = (
/obj/structure/halflife/storage/large/medical,
/turf/open/floor/plating/indoor/sterilesquares,
/area/halflife/indoors)
"h" = (
/turf/closed/wall/halflife/brick/grey,
/area/halflife/indoors)
"i" = (
/obj/structure/halflife/trash/papers/two{
	dir = 1
	},
/turf/open/floor/plating/indoor/tiled9,
/area/halflife/indoors)
"j" = (
/obj/effect/turf_decal/halflife/covering/tiles/white,
/turf/closed/wall/halflife/brick/grey,
/area/halflife/indoors)
"l" = (
/obj/item/chair/halflife/metal/blue,
/turf/open/floor/plating/indoor/tiled9,
/area/halflife/indoors)
"m" = (
/obj/structure/bed/halflife/bedframe/wood,
/obj/structure/bed/halflife/mattress/stained,
/obj/item/stack/spacecash/c1,
/turf/open/floor/plating/indoor/sterilesquares,
/area/halflife/indoors)
"n" = (
/obj/structure/table/halflife/no_smooth/large/metal{
	dir = 8
	},
/turf/open/floor/plating/indoor/sterilesquares,
/area/halflife/indoors)
"o" = (
/obj/machinery/light/small/directional/south,
/turf/open/floor/plating/indoor/sterilesquares,
/area/halflife/indoors)
"p" = (
/mob/living/basic/halflife/headcrab/poison,
/turf/open/floor/plating/indoor/sterilesquares,
/area/halflife/indoors)
"q" = (
/obj/structure/closet/halflife/wall/firstaid,
/obj/item/reagent_containers/pill/patch/medkit,
/obj/item/reagent_containers/pill/patch/medkit,
/turf/open/floor/plating/indoor/metal/plate,
/area/halflife/indoors)
"r" = (
/turf/template_noop,
/area/template_noop)
"s" = (
/obj/machinery/light/small/directional/east,
/turf/open/floor/plating/indoor/metal/plate,
/area/halflife/indoors)
"t" = (
/obj/machinery/door/unpowered/halflife/metal,
/turf/open/floor/plating/indoor/metal/plate,
/area/halflife/indoors)
"u" = (
/obj/structure/table/halflife/no_smooth/metal,
/turf/open/floor/plating/indoor/sterilesquares,
/area/halflife/indoors)
"v" = (
/obj/structure/halflife/trash/papers/three,
/turf/open/floor/plating/indoor/sterilesquares,
/area/halflife/indoors)
"w" = (
/obj/machinery/light/small/directional/west,
/turf/open/floor/plating/indoor/sterilesquares,
/area/halflife/indoors)
"x" = (
/obj/structure/halflife/trash/papers/three{
	dir = 8
	},
/turf/open/floor/plating/indoor/sterilesquares,
/area/halflife/indoors)
"y" = (
/obj/structure/table/halflife/no_smooth/large/metal,
/turf/open/floor/plating/indoor/metal/plate,
/area/halflife/indoors)
"z" = (
/obj/structure/bed/halflife/mattress/stained,
/turf/open/floor/plating/indoor/sterilesquares,
/area/halflife/indoors)
"A" = (
/obj/structure/table/optable,
/obj/effect/decal/cleanable/blood/old,
/obj/item/stack/spacecash/c10,
/turf/open/floor/plating/indoor/sterilesquares,
/area/halflife/indoors)
"B" = (
/turf/open/floor/plating/indoor/tiled9,
/area/halflife/indoors)
"C" = (
/obj/machinery/light/small/directional/east,
/turf/open/floor/plating/indoor/sterilesquares,
/area/halflife/indoors)
"D" = (
/obj/structure/bed/halflife/bedframe/wood,
/turf/open/floor/plating/indoor/sterilesquares,
/area/halflife/indoors)
"E" = (
/mob/living/basic/halflife/headcrab,
/turf/open/floor/plating/indoor/sterilesquares,
/area/halflife/indoors)
"F" = (
/obj/machinery/light/small/directional/west,
/turf/open/floor/plating/indoor/tiled9,
/area/halflife/indoors)
"G" = (
/obj/machinery/door/unpowered/halflife/seethrough/metal,
/turf/open/floor/plating/indoor/sterilesquares,
/area/halflife/indoors)
"I" = (
/obj/machinery/door/unpowered/halflife/seethrough/metal,
/turf/open/floor/plating/indoor/tiled9,
/area/halflife/indoors)
"K" = (
/turf/open/floor/plating/indoor/metal/plate,
/area/halflife/indoors)
"L" = (
/obj/structure/table/halflife/no_smooth/large/metal,
/obj/item/reagent_containers/pill/antitox,
/turf/open/floor/plating/indoor/metal/plate,
/area/halflife/indoors)
"M" = (
/obj/structure/chair/halflife/metal/blue{
	dir = 4
	},
/turf/open/floor/plating/indoor/tiled9,
/area/halflife/indoors)
"N" = (
/obj/machinery/door/unpowered/halflife/metal,
/turf/open/floor/plating/indoor/sterilesquares,
/area/halflife/indoors)
"O" = (
/obj/modular_map_connector,
/turf/template_noop,
/area/template_noop)
"P" = (
/obj/machinery/light/small/directional/west,
/turf/open/floor/plating/indoor/metal/plate,
/area/halflife/indoors)
"Q" = (
/obj/structure/table/halflife/no_smooth/metal,
/obj/item/stack/spacecash/c1,
/turf/open/floor/plating/indoor/sterilesquares,
/area/halflife/indoors)
"T" = (
/obj/item/stack/spacecash/c1,
/turf/open/floor/plating/indoor/sterilesquares,
/area/halflife/indoors)
"U" = (
/obj/structure/table/halflife/no_smooth/metal,
/obj/item/storage/wallet,
/turf/open/floor/plating/indoor/sterilesquares,
/area/halflife/indoors)
"V" = (
/mob/living/basic/halflife/zombie/fast,
/turf/open/floor/plating/indoor/sterilesquares,
/area/halflife/indoors)
"W" = (
/obj/item/stack/medical/suture,
/turf/open/floor/plating/indoor/metal/plate,
/area/halflife/indoors)
"X" = (
/obj/structure/bed/halflife/bedframe/wood,
/obj/structure/bed/halflife/mattress/stained,
/turf/open/floor/plating/indoor/sterilesquares,
/area/halflife/indoors)
"Y" = (
/obj/structure/halflife/trash/papers/two{
	dir = 8
	},
/turf/open/floor/plating/indoor/sterilesquares,
/area/halflife/indoors)

(1,1,1) = {"
r
r
r
r
r
r
r
r
r
r
r
r
r
r
r
r
O
"}
(2,1,1) = {"
r
h
h
h
h
h
h
h
h
h
h
h
h
h
h
j
r
"}
(3,1,1) = {"
r
j
D
a
w
X
a
a
a
a
j
M
F
M
l
f
r
"}
(4,1,1) = {"
r
j
g
a
a
a
E
a
a
a
I
i
B
B
B
I
r
"}
(5,1,1) = {"
r
j
a
a
a
a
a
a
d
a
j
B
B
B
B
j
r
"}
(6,1,1) = {"
r
j
m
a
a
D
a
a
a
o
j
B
B
B
B
j
r
"}
(7,1,1) = {"
r
j
g
a
x
a
a
z
a
a
j
a
n
h
h
j
r
"}
(8,1,1) = {"
r
j
a
E
a
a
a
a
a
a
G
a
e
a
u
j
r
"}
(9,1,1) = {"
r
j
X
a
C
m
a
a
a
a
j
a
a
Y
a
j
r
"}
(10,1,1) = {"
r
h
h
h
h
h
j
a
a
a
j
a
C
a
Q
j
r
"}
(11,1,1) = {"
r
j
L
P
c
K
j
a
a
a
h
h
h
h
h
j
r
"}
(12,1,1) = {"
r
j
K
K
K
K
j
a
p
o
j
a
T
a
U
j
r
"}
(13,1,1) = {"
r
j
q
K
K
K
t
a
a
a
N
a
a
a
A
j
r
"}
(14,1,1) = {"
r
j
y
K
L
K
j
g
a
a
j
a
V
v
T
j
r
"}
(15,1,1) = {"
r
j
W
s
K
K
j
a
a
a
j
a
a
b
a
j
r
"}
(16,1,1) = {"
r
h
h
h
h
h
h
h
h
h
h
h
h
h
h
j
r
"}
(17,1,1) = {"
r
r
r
r
r
r
r
r
r
r
r
r
r
r
r
r
r
"}
