//MAP CONVERTED BY dmm2tgm.py THIS HEADER COMMENT PREVENTS RECONVERSION, DO NOT REMOVE
"aU" = (
/turf/open/floor/plating/indoor/metal/plate,
/area/halflife/indoors)
"bE" = (
/turf/open/floor/plating/indoor/woodc,
/area/halflife/indoors)
"dm" = (
/obj/machinery/processor,
/obj/machinery/light/small/directional/east,
/obj/structure/table/halflife/metal/small,
/turf/open/floor/plating/indoor/tile/kitchen,
/area/halflife/indoors)
"fO" = (
/obj/machinery/microwave{
	pixel_y = 4
	},
/obj/machinery/light/small/directional/west,
/turf/open/floor/plating/indoor/tile/kitchen,
/area/halflife/indoors)
"hC" = (
/obj/machinery/grill,
/obj/machinery/light/small/directional/west,
/turf/open/floor/plating/indoor/tile/kitchen,
/area/halflife/indoors)
"jN" = (
/obj/structure/table/halflife/wood,
/turf/open/floor/plating/indoor/carpet,
/area/halflife/indoors)
"kD" = (
/obj/item/stack/spacecash/c1{
	amount = 5
	},
/obj/structure/table/halflife/no_smooth/large/metal/desk,
/turf/open/floor/plating/indoor/metal/plate,
/area/halflife/indoors)
"ni" = (
/obj/structure/chair/halflife/wood/padded{
	dir = 4
	},
/obj/machinery/light/small/directional/south,
/turf/open/floor/plating/indoor/carpet,
/area/halflife/indoors)
"nU" = (
/obj/machinery/oven/range,
/turf/open/floor/plating/indoor/tile/kitchen,
/area/halflife/indoors)
"oh" = (
/obj/machinery/door/unpowered/halflife/seethrough/metal{
	keylock = 1;
	lockid = "kitchen";
	dir = 8
	},
/turf/open/floor/plating/indoor/woodc,
/area/halflife/indoors)
"pj" = (
/obj/machinery/deepfryer,
/turf/open/floor/plating/indoor/tile/kitchen,
/area/halflife/indoors)
"qX" = (
/obj/machinery/light/small/directional/west,
/turf/open/floor/plating/indoor/woodc/wide,
/area/halflife/indoors)
"sK" = (
/obj/modular_map_connector,
/turf/template_noop,
/area/template_noop)
"ti" = (
/obj/structure/table/halflife/wood,
/obj/item/plate/small,
/obj/item/stack/spacecash/c1,
/obj/item/stack/spacecash/c1,
/turf/open/floor/plating/indoor/carpet,
/area/halflife/indoors)
"ty" = (
/turf/template_noop,
/area/template_noop)
"up" = (
/obj/machinery/light/small/directional/east,
/obj/structure/chair/office/halflife/blue{
	dir = 1
	},
/turf/open/floor/plating/indoor/metal/plate,
/area/halflife/indoors)
"vE" = (
/obj/structure/table/halflife/wood/bar,
/obj/machinery/jukebox/radio,
/turf/open/floor/plating/indoor/woodc/wide,
/area/halflife/indoors)
"xC" = (
/obj/structure/chair/halflife/wood/padded{
	dir = 8
	},
/turf/open/floor/plating/indoor/carpet,
/area/halflife/indoors)
"xF" = (
/obj/structure/table/halflife/wood,
/obj/item/reagent_containers/condiment/peppermill,
/turf/open/floor/plating/indoor/carpet,
/area/halflife/indoors)
"xJ" = (
/obj/machinery/gibber,
/turf/open/floor/plating/indoor/tile/kitchen,
/area/halflife/indoors)
"xV" = (
/obj/structure/table/halflife/wood/bar,
/obj/item/plate,
/obj/item/reagent_containers/cup/rag,
/turf/open/floor/plating/indoor/woodc/wide,
/area/halflife/indoors)
"zp" = (
/obj/structure/table/halflife/wood,
/obj/item/reagent_containers/condiment/saltshaker,
/turf/open/floor/plating/indoor/carpet,
/area/halflife/indoors)
"Ax" = (
/obj/structure/halflife/trash/glass/basic,
/obj/machinery/light/small/directional/south,
/obj/structure/table/halflife/wood,
/turf/open/floor/plating/indoor/carpet,
/area/halflife/indoors)
"BM" = (
/obj/item/reagent_containers/condiment/mayonnaise,
/obj/item/storage/fancy/egg_box,
/obj/structure/closet/secure_closet/freezer/halflife,
/obj/item/reagent_containers/condiment/milk,
/obj/machinery/light/small/directional/east,
/turf/open/floor/plating/indoor/tile/kitchen,
/area/halflife/indoors)
"Cf" = (
/obj/machinery/light/small/directional/west,
/turf/open/floor/plating/indoor/woodc,
/area/halflife/indoors)
"DX" = (
/obj/structure/table/halflife/wood,
/turf/open/floor/plating/indoor/woodc,
/area/halflife/indoors)
"Eg" = (
/turf/open/floor/plating/indoor/carpet,
/area/halflife/indoors)
"Hc" = (
/obj/machinery/light/small/directional/east,
/turf/open/floor/plating/indoor/woodc,
/area/halflife/indoors)
"Hw" = (
/turf/open/floor/plating/indoor/woodc/wide,
/area/halflife/indoors)
"HG" = (
/turf/closed/wall/halflife/brick,
/area/halflife/indoors)
"HY" = (
/obj/structure/table/halflife/metal,
/obj/item/reagent_containers/condiment/enzyme{
	pixel_x = 9;
	pixel_y = 3
	},
/obj/item/reagent_containers/cup/soup_pot,
/turf/open/floor/plating/indoor/tile/kitchen,
/area/halflife/indoors)
"IE" = (
/obj/structure/table/halflife/wood,
/obj/structure/halflife/trash/food/glass,
/obj/item/stack/spacecash/c1,
/obj/item/stack/spacecash/c1,
/turf/open/floor/plating/indoor/carpet,
/area/halflife/indoors)
"Kx" = (
/obj/structure/table/halflife/no_smooth/large/metal{
	dir = 4
	},
/obj/machinery/reagentgrinder,
/obj/item/reagent_containers/cup/soda_cans/breenwater{
	pixel_x = -10;
	pixel_y = 9
	},
/obj/item/reagent_containers/cup/soda_cans/breenwater{
	pixel_x = -10
	},
/turf/open/floor/plating/indoor/tile/kitchen,
/area/halflife/indoors)
"Lp" = (
/obj/structure/chair/halflife/wood/padded{
	dir = 8
	},
/obj/machinery/light/small/directional/east,
/turf/open/floor/plating/indoor/carpet,
/area/halflife/indoors)
"LA" = (
/obj/item/food/meat/slab/chicken,
/obj/item/food/meat/slab/chicken,
/obj/item/food/meat/slab/human,
/obj/structure/closet/secure_closet/freezer/halflife,
/obj/item/food/meat/slab/human,
/obj/item/food/meat/slab/synthmeat,
/obj/machinery/light/small/directional/west,
/turf/open/floor/plating/indoor/tile/kitchen,
/area/halflife/indoors)
"MT" = (
/obj/effect/turf_decal/halflife/covering/paint/white,
/turf/closed/wall/halflife/brick,
/area/halflife/indoors)
"Ni" = (
/obj/structure/sink/halflife{
	dir = 4
	},
/turf/open/floor/plating/indoor/tile/kitchen,
/area/halflife/indoors)
"Oy" = (
/obj/machinery/griddle,
/turf/open/floor/plating/indoor/tile/kitchen,
/area/halflife/indoors)
"OF" = (
/obj/structure/extinguisher_cabinet/directional/west,
/turf/open/floor/plating/indoor/tile/kitchen,
/area/halflife/indoors)
"OZ" = (
/obj/machinery/door/unpowered/halflife/metal{
	keylock = 1;
	locked = 1;
	lockid = "kitchen"
	},
/turf/open/floor/plating/indoor/tile/kitchen,
/area/halflife/indoors)
"Qa" = (
/obj/effect/turf_decal/halflife/covering/wallpaper/red,
/turf/closed/wall/halflife/brick,
/area/halflife/indoors)
"Qm" = (
/obj/structure/kitchenspike,
/turf/open/floor/plating/indoor/tile/kitchen,
/area/halflife/indoors)
"QH" = (
/obj/structure/table/halflife/metal,
/obj/item/reagent_containers/condiment/rice,
/obj/item/reagent_containers/cup/bowl,
/obj/item/reagent_containers/cup/bowl,
/turf/open/floor/plating/indoor/tile/kitchen,
/area/halflife/indoors)
"RB" = (
/obj/structure/window/fulltile/halflife/nosmooth/brick,
/turf/open/floor/plating/indoor/woodc,
/area/halflife/indoors)
"Sp" = (
/obj/machinery/door/unpowered/halflife/seethrough/metal{
	keylock = 1;
	lockid = "kitchen"
	},
/turf/open/floor/plating/indoor/woodc,
/area/halflife/indoors)
"TP" = (
/obj/structure/chair/halflife/wood/padded{
	dir = 4
	},
/turf/open/floor/plating/indoor/carpet,
/area/halflife/indoors)
"Ue" = (
/obj/structure/table/halflife/wood,
/obj/structure/halflife/trash/food/dinner,
/obj/item/stack/spacecash/c1,
/obj/item/stack/spacecash/c1,
/turf/open/floor/plating/indoor/carpet,
/area/halflife/indoors)
"Ux" = (
/obj/structure/table/halflife/wood/bar,
/obj/structure/desk_bell,
/turf/open/floor/plating/indoor/woodc/wide,
/area/halflife/indoors)
"Wl" = (
/obj/structure/table/halflife/wood/bar,
/obj/structure/halflife/trash/glass/basic,
/turf/open/floor/plating/indoor/woodc/wide,
/area/halflife/indoors)
"WX" = (
/obj/machinery/door/unpowered/halflife/metal{
	keylock = 1;
	locked = 1;
	lockid = "kitchen";
	dir = 4
	},
/turf/open/floor/plating/indoor/metal/plate,
/area/halflife/indoors)
"XB" = (
/obj/structure/table/halflife/metal/small,
/obj/item/knife/kitchen,
/obj/item/kitchen/rollingpin,
/obj/item/kitchen/rollingpin,
/turf/open/floor/plating/indoor/tile/kitchen,
/area/halflife/indoors)
"Zy" = (
/obj/machinery/door/unpowered/halflife/metal{
	keylock = 1;
	locked = 1;
	lockid = "kitchen";
	dir = 4
	},
/turf/open/floor/plating/indoor/tile/kitchen,
/area/halflife/indoors)
"Zz" = (
/turf/open/floor/plating/indoor/tile/kitchen,
/area/halflife/indoors)

(1,1,1) = {"
ty
ty
ty
ty
ty
ty
ty
ty
ty
ty
ty
ty
ty
ty
ty
ty
sK
"}
(2,1,1) = {"
ty
HG
HG
HG
HG
HG
HG
HG
HG
HG
HG
HG
HG
HG
HG
HG
ty
"}
(3,1,1) = {"
ty
MT
Ni
LA
xJ
MT
OF
hC
XB
fO
Kx
HG
jN
Cf
jN
HG
ty
"}
(4,1,1) = {"
ty
MT
Zz
Zz
Zz
OZ
Zz
Zz
Zz
Zz
QH
HG
xC
bE
xC
HG
ty
"}
(5,1,1) = {"
ty
MT
Qm
Zz
Zz
MT
Oy
Zz
Zz
Zz
HY
HG
Eg
bE
Eg
HG
ty
"}
(6,1,1) = {"
ty
MT
Qm
Zz
BM
MT
nU
Zz
dm
Zz
pj
HG
TP
bE
TP
HG
ty
"}
(7,1,1) = {"
ty
HG
HG
WX
HG
HG
HG
Zy
HG
Zy
HG
HG
jN
bE
Ax
HG
ty
"}
(8,1,1) = {"
ty
HG
aU
aU
HG
Qa
bE
Hw
qX
Hw
Hw
RB
xC
bE
xC
HG
ty
"}
(9,1,1) = {"
ty
HG
kD
aU
HG
Qa
bE
vE
Wl
xV
Ux
HG
HG
oh
HG
HG
ty
"}
(10,1,1) = {"
ty
HG
aU
up
HG
Qa
bE
bE
bE
bE
bE
bE
Cf
bE
bE
HG
ty
"}
(11,1,1) = {"
ty
HG
HG
HG
HG
Qa
bE
bE
bE
bE
bE
bE
bE
bE
bE
HG
ty
"}
(12,1,1) = {"
ty
Qa
bE
bE
bE
bE
bE
TP
TP
Eg
TP
TP
bE
Eg
Eg
HG
ty
"}
(13,1,1) = {"
ty
Sp
bE
bE
bE
bE
bE
xF
ti
Eg
Ue
zp
bE
TP
ni
HG
ty
"}
(14,1,1) = {"
ty
Qa
bE
Hc
DX
bE
bE
Lp
xC
Eg
Lp
xC
bE
zp
IE
HG
ty
"}
(15,1,1) = {"
ty
HG
HG
HG
HG
HG
HG
HG
HG
HG
HG
HG
HG
HG
HG
HG
ty
"}
(16,1,1) = {"
ty
HG
HG
HG
HG
HG
HG
HG
HG
HG
HG
HG
HG
HG
HG
HG
ty
"}
(17,1,1) = {"
ty
ty
ty
ty
ty
ty
ty
ty
ty
ty
ty
ty
ty
ty
ty
ty
ty
"}
