//MAP CONVERTED BY dmm2tgm.py THIS HEADER COMMENT PREVENTS RECONVERSION, DO NOT REMOVE
"a" = (
/obj/structure/table/halflife/no_smooth/wood/stand,
/obj/item/stack/spacecash/c1,
/obj/item/stack/spacecash/c1,
/turf/open/floor/plating/indoor/carpet,
/area/halflife/indoors)
"b" = (
/obj/machinery/door/unpowered/halflife/wood,
/turf/open/floor/plating/indoor/woodc/wide,
/area/halflife/indoors)
"c" = (
/obj/item/stack/spacecash/c1,
/obj/item/stack/spacecash/c1,
/turf/open/floor/plating/indoor/lino,
/area/halflife/indoors)
"d" = (
/obj/structure/closet/secure_closet/freezer/halflife,
/obj/effect/spawner/random/halflife/loot/consumables,
/turf/open/floor/plating/indoor/checkered,
/area/halflife/indoors)
"f" = (
/obj/machinery/light/small/directional/east,
/turf/open/floor/plating/indoor/woodc/mosaic,
/area/halflife/indoors)
"h" = (
/obj/structure/halflife/toilet,
/turf/open/floor/plating/indoor/lino,
/area/halflife/indoors)
"i" = (
/obj/machinery/light/small/directional/west,
/turf/open/floor/plating/indoor/carpet,
/area/halflife/indoors)
"j" = (
/obj/machinery/light/small/directional/west,
/turf/open/floor/plating/indoor/lino,
/area/halflife/indoors)
"l" = (
/obj/machinery/shower/halflife{
	dir = 4
	},
/obj/structure/fluff/shower_drain,
/turf/open/floor/plating/indoor/lino,
/area/halflife/indoors)
"m" = (
/obj/structure/halflife/trash/papers/three,
/turf/open/floor/plating/indoor/woodc/wide,
/area/halflife/indoors)
"n" = (
/turf/open/floor/plating/indoor/carpet,
/area/halflife/indoors)
"o" = (
/obj/structure/bed/halflife/bedframe/wood,
/obj/structure/bed/halflife/mattress/filthy,
/turf/open/floor/plating/indoor/carpet,
/area/halflife/indoors)
"p" = (
/obj/structure/halflife/storage/shelf/wood,
/turf/open/floor/plating/indoor/woodc/wide,
/area/halflife/indoors)
"r" = (
/obj/machinery/light/small/directional/east,
/turf/open/floor/plating/indoor/woodc/wide,
/area/halflife/indoors)
"s" = (
/obj/machinery/light/small/directional/south,
/turf/open/floor/plating/indoor/checkered,
/area/halflife/indoors)
"t" = (
/turf/open/floor/plating/ground/grass,
/area/template_noop)
"u" = (
/obj/machinery/light/small/directional/south,
/turf/open/floor/plating/indoor/woodc/wide,
/area/halflife/indoors)
"v" = (
/obj/structure/halflife/trash/papers/two,
/turf/open/floor/plating/indoor/woodc/wide,
/area/halflife/indoors)
"w" = (
/turf/open/floor/plating/indoor/woodc/wide,
/area/halflife/indoors)
"x" = (
/obj/modular_map_connector,
/turf/template_noop,
/area/template_noop)
"z" = (
/turf/open/floor/plating/ground/sidewalk,
/area/template_noop)
"A" = (
/obj/structure/bed/halflife/bedframe/wood,
/obj/structure/bed/halflife/mattress/stained,
/turf/open/floor/plating/indoor/carpet,
/area/halflife/indoors)
"D" = (
/turf/template_noop,
/area/template_noop)
"E" = (
/turf/open/floor/plating/indoor/checkered,
/area/halflife/indoors)
"F" = (
/obj/machinery/light/small/directional/north,
/turf/open/floor/plating/indoor/woodc/wide,
/area/halflife/indoors)
"G" = (
/obj/machinery/door/unpowered/halflife/wood,
/turf/open/floor/plating/indoor/woodc/mosaic,
/area/halflife/indoors)
"H" = (
/obj/structure/halflife/trash/cardboard,
/turf/open/floor/plating/indoor/woodc/wide,
/area/halflife/indoors)
"K" = (
/turf/open/floor/plating/indoor/lino,
/area/halflife/indoors)
"M" = (
/obj/machinery/light/small/directional/north,
/turf/open/floor/plating/ground/grass,
/area/template_noop)
"N" = (
/obj/structure/table/halflife/no_smooth/large/wood,
/turf/open/floor/plating/indoor/checkered,
/area/halflife/indoors)
"P" = (
/obj/machinery/door/unpowered/halflife/wood{
	dir = 4
	},
/turf/open/floor/plating/indoor/lino,
/area/halflife/indoors)
"R" = (
/obj/structure/halflife/storage/bookshelf,
/turf/open/floor/plating/indoor/woodc/wide,
/area/halflife/indoors)
"S" = (
/turf/open/floor/plating/indoor/woodc/mosaic,
/area/halflife/indoors)
"U" = (
/obj/structure/sink/halflife,
/obj/structure/mirror/halflife{
	pixel_y = 32
	},
/turf/open/floor/plating/indoor/lino,
/area/halflife/indoors)
"X" = (
/obj/structure/halflife/trash/cardboard,
/obj/item/stack/spacecash/c1,
/obj/item/stack/spacecash/c1,
/turf/open/floor/plating/indoor/woodc/mosaic,
/area/halflife/indoors)
"Z" = (
/turf/closed/wall/halflife/brick,
/area/halflife/indoors)

(1,1,1) = {"
D
D
D
D
D
D
D
D
D
D
D
D
D
D
D
D
x
"}
(2,1,1) = {"
D
Z
Z
Z
Z
Z
Z
Z
Z
Z
Z
Z
Z
Z
Z
t
D
"}
(3,1,1) = {"
D
Z
Z
Z
Z
Z
Z
Z
Z
Z
Z
Z
Z
Z
Z
t
D
"}
(4,1,1) = {"
D
Z
Z
Z
Z
Z
Z
Z
Z
Z
h
j
l
Z
Z
t
D
"}
(5,1,1) = {"
D
Z
Z
Z
Z
Z
Z
Z
Z
Z
U
K
c
Z
Z
t
D
"}
(6,1,1) = {"
D
Z
Z
Z
Z
Z
Z
Z
Z
Z
Z
P
Z
Z
Z
t
D
"}
(7,1,1) = {"
D
Z
Z
Z
Z
Z
Z
Z
Z
Z
R
w
w
d
Z
t
D
"}
(8,1,1) = {"
D
Z
Z
Z
Z
Z
Z
o
i
Z
F
w
w
s
Z
t
D
"}
(9,1,1) = {"
D
Z
Z
Z
Z
Z
Z
S
S
Z
R
m
w
N
Z
t
D
"}
(10,1,1) = {"
D
Z
Z
Z
Z
Z
Z
X
S
G
w
w
w
E
Z
t
D
"}
(11,1,1) = {"
D
Z
Z
Z
Z
Z
Z
Z
Z
Z
p
w
w
Z
Z
M
D
"}
(12,1,1) = {"
D
Z
Z
Z
Z
Z
Z
n
S
Z
p
w
w
u
Z
z
D
"}
(13,1,1) = {"
D
Z
Z
Z
Z
Z
Z
A
S
G
w
w
w
w
b
z
D
"}
(14,1,1) = {"
D
Z
Z
Z
Z
Z
Z
a
f
Z
w
r
v
H
Z
z
D
"}
(15,1,1) = {"
D
Z
Z
Z
Z
Z
Z
Z
Z
Z
Z
Z
Z
Z
Z
M
D
"}
(16,1,1) = {"
D
Z
Z
Z
Z
Z
Z
Z
Z
Z
Z
Z
Z
Z
Z
t
D
"}
(17,1,1) = {"
D
D
D
D
D
D
D
D
D
D
D
D
D
D
D
D
D
"}
