//MAP CONVERTED BY dmm2tgm.py THIS HEADER COMMENT PREVENTS RECONVERSION, DO NOT REMOVE
"a" = (
/turf/open/floor/plating/indoor/metal/smooth,
/area/halflife/indoors)
"b" = (
/obj/effect/spawner/random/halflife/loot/rare,
/turf/open/floor/plating/indoor/metal/combine,
/area/halflife/indoors)
"c" = (
/turf/template_noop,
/area/template_noop)
"d" = (
/obj/machinery/combine_walllight/directional/south,
/turf/open/floor/plating/indoor/metal/smooth,
/area/halflife/indoors)
"e" = (
/obj/structure/table/halflife/no_smooth/large/metal{
	dir = 8
	},
/turf/open/floor/plating/indoor/metal/combine/alt2,
/area/halflife/indoors)
"f" = (
/obj/structure/table/halflife/no_smooth/large/metal,
/turf/open/floor/plating/indoor/metal/smooth,
/area/halflife/indoors)
"h" = (
/turf/closed/wall/halflife/metal,
/area/halflife/indoors)
"i" = (
/obj/item/storage/backpack/halflife/satchel/civilprotection,
/turf/open/floor/plating/indoor/metal/combine,
/area/halflife/indoors)
"j" = (
/mob/living/basic/halflife/zombie/zombine,
/turf/open/floor/plating/indoor/metal/smooth,
/area/halflife/indoors)
"k" = (
/obj/structure/table/halflife/no_smooth/large/metal,
/obj/effect/spawner/random/halflife/loot/rare,
/turf/open/floor/plating/indoor/metal/combine,
/area/halflife/indoors)
"o" = (
/obj/structure/table/halflife/no_smooth/large/metal,
/obj/effect/spawner/random/halflife/loot/ammo,
/turf/open/floor/plating/indoor/metal/smooth,
/area/halflife/indoors)
"p" = (
/obj/machinery/door/airlock/highsecurity/combine,
/turf/closed/wall/halflife/metal,
/area/halflife/indoors)
"q" = (
/mob/living/basic/halflife/zombie/zombine,
/turf/open/floor/plating/indoor/metal/combine,
/area/halflife/indoors)
"r" = (
/obj/modular_map_connector,
/turf/template_noop,
/area/template_noop)
"s" = (
/obj/machinery/door/airlock/highsecurity/combine,
/turf/open/floor/plating/indoor/metal/combine,
/area/halflife/indoors)
"t" = (
/obj/effect/spawner/random/halflife/loot/rare,
/turf/open/floor/plating/indoor/metal/smooth,
/area/halflife/indoors)
"u" = (
/obj/structure/table/halflife/no_smooth/large/metal{
	dir = 8
	},
/obj/item/stack/spacecash/c10,
/turf/open/floor/plating/indoor/metal/smooth,
/area/halflife/indoors)
"w" = (
/obj/machinery/combine_walllight/directional/north,
/turf/open/floor/plating/indoor/metal/combine,
/area/halflife/indoors)
"x" = (
/turf/open/floor/plating/indoor/metal/combine/alt2,
/area/halflife/indoors)
"z" = (
/obj/machinery/combine_walllight/directional/west,
/turf/open/floor/plating/indoor/metal/smooth,
/area/halflife/indoors)
"D" = (
/mob/living/basic/halflife/zombie/zombine/elite,
/turf/open/floor/plating/indoor/metal/smooth,
/area/halflife/indoors)
"H" = (
/obj/structure/table/halflife/no_smooth/large/metal,
/obj/effect/spawner/random/halflife/loot/ammo,
/turf/open/floor/plating/indoor/metal/combine,
/area/halflife/indoors)
"K" = (
/obj/structure/bed/halflife/bedframe/wire,
/obj/structure/bed/halflife/mattress/stained,
/turf/open/floor/plating/indoor/metal/smooth,
/area/halflife/indoors)
"M" = (
/obj/machinery/door/airlock/highsecurity/combine,
/turf/open/floor/plating/indoor/metal/smooth,
/area/halflife/indoors)
"N" = (
/obj/machinery/combine_walllight/directional/north,
/turf/open/floor/plating/indoor/metal/smooth,
/area/halflife/indoors)
"O" = (
/obj/structure/table/halflife/no_smooth/large/metal,
/obj/item/stack/spacecash/c10,
/turf/open/floor/plating/indoor/metal/combine,
/area/halflife/indoors)
"Q" = (
/obj/structure/table/halflife/no_smooth/large/metal,
/obj/item/storage/backpack/halflife/satchel/civilprotection,
/turf/open/floor/plating/indoor/metal/combine,
/area/halflife/indoors)
"S" = (
/obj/structure/bed/halflife/bedframe/wire,
/obj/structure/bed/halflife/mattress/stained,
/obj/item/stack/spacecash/c10,
/turf/open/floor/plating/indoor/metal/smooth,
/area/halflife/indoors)
"T" = (
/obj/effect/spawner/random/halflife/loot/ammo,
/turf/open/floor/plating/indoor/metal/combine,
/area/halflife/indoors)
"U" = (
/turf/open/floor/plating/indoor/metal/combine,
/area/halflife/indoors)
"V" = (
/obj/item/stack/spacecash/c10,
/turf/open/floor/plating/indoor/metal/combine,
/area/halflife/indoors)
"X" = (
/mob/living/basic/halflife/zombie/zombie_grunt,
/turf/open/floor/plating/indoor/metal/smooth,
/area/halflife/indoors)

(1,1,1) = {"
c
c
c
c
c
c
c
c
c
c
c
c
c
c
c
c
r
"}
(2,1,1) = {"
c
h
h
h
h
h
h
h
h
h
h
h
h
h
h
h
c
"}
(3,1,1) = {"
c
h
a
a
a
K
h
a
a
a
h
a
a
a
a
h
c
"}
(4,1,1) = {"
c
h
a
a
a
K
h
a
a
a
M
a
a
a
a
M
c
"}
(5,1,1) = {"
c
h
a
a
a
N
h
a
a
a
h
a
a
a
a
h
c
"}
(6,1,1) = {"
c
h
a
a
a
K
h
d
a
a
h
x
e
h
h
h
c
"}
(7,1,1) = {"
c
h
o
a
a
K
h
a
a
X
h
a
a
a
a
h
c
"}
(8,1,1) = {"
c
h
a
a
a
a
M
a
a
a
p
a
j
a
a
h
c
"}
(9,1,1) = {"
c
h
a
a
a
a
h
a
a
a
h
a
z
a
u
h
c
"}
(10,1,1) = {"
c
h
f
a
a
a
h
h
s
h
h
h
h
h
h
h
c
"}
(11,1,1) = {"
c
h
t
a
D
a
h
U
U
q
Q
U
O
U
k
h
c
"}
(12,1,1) = {"
c
h
K
a
a
K
h
U
U
U
b
U
U
U
T
h
c
"}
(13,1,1) = {"
c
h
K
a
a
N
h
U
U
U
U
U
U
U
w
h
c
"}
(14,1,1) = {"
c
h
S
a
a
K
h
U
U
U
H
q
k
U
O
h
c
"}
(15,1,1) = {"
c
h
K
a
a
S
h
U
U
U
V
U
U
U
i
h
c
"}
(16,1,1) = {"
c
h
h
h
h
h
h
h
h
h
h
h
h
h
h
h
c
"}
(17,1,1) = {"
c
c
c
c
c
c
c
c
c
c
c
c
c
c
c
c
c
"}
