//MAP CONVERTED BY dmm2tgm.py THIS HEADER COMMENT PREVENTS RECONVERSION, DO NOT REMOVE
"a" = (
/turf/closed/wall/halflife/concrete/alt,
/area/halflife/indoors)
"d" = (
/obj/structure/halflife/trash/papers/two{
	dir = 8
	},
/turf/open/floor/plating/indoor/woodc,
/area/halflife/indoors)
"e" = (
/obj/structure/halflife/pot/plant,
/turf/open/floor/plating/indoor/woodc,
/area/halflife/indoors)
"f" = (
/obj/structure/table/halflife/no_smooth/wood/square,
/turf/open/floor/plating/indoor/woodc,
/area/halflife/indoors)
"h" = (
/obj/machinery/door/unpowered/halflife/seethrough/metal,
/turf/open/floor/plating/indoor/woodc,
/area/halflife/indoors)
"j" = (
/obj/structure/closet/halflife,
/obj/effect/spawner/random/halflife/loot,
/obj/item/stack/spacecash/c1,
/turf/open/floor/plating/indoor/woodc,
/area/halflife/indoors)
"l" = (
/obj/structure/chair/halflife/wood{
	dir = 8
	},
/turf/open/floor/plating/indoor/woodc,
/area/halflife/indoors)
"m" = (
/turf/open/floor/plating/indoor/woodc,
/area/halflife/indoors)
"o" = (
/obj/structure/bed/halflife/bedframe/cot,
/obj/structure/bed/halflife/mattress/yellowed,
/obj/machinery/light/small/directional/south,
/turf/open/floor/plating/indoor/woodc,
/area/halflife/indoors)
"r" = (
/obj/structure/barricade/sandbags,
/turf/open/floor/plating/indoor/woodc,
/area/halflife/indoors)
"s" = (
/turf/template_noop,
/area/template_noop)
"t" = (
/obj/structure/table/halflife/no_smooth/wood/low,
/obj/effect/spawner/random/halflife/loot,
/turf/open/floor/plating/indoor/woodc,
/area/halflife/indoors)
"y" = (
/obj/structure/table/halflife/no_smooth/wood/low,
/obj/item/stack/spacecash/c1,
/turf/open/floor/plating/indoor/woodc,
/area/halflife/indoors)
"C" = (
/obj/structure/chair/halflife/wood{
	dir = 4
	},
/turf/open/floor/plating/indoor/woodc,
/area/halflife/indoors)
"F" = (
/obj/structure/table/halflife/no_smooth/wood/square,
/obj/item/stack/spacecash/c1,
/turf/open/floor/plating/indoor/woodc,
/area/halflife/indoors)
"I" = (
/obj/structure/table/halflife/no_smooth/wood/square,
/obj/structure/halflife/trash/glass/cans,
/turf/open/floor/plating/indoor/woodc,
/area/halflife/indoors)
"M" = (
/obj/structure/table/halflife/no_smooth/wood/square,
/obj/structure/halflife/trash/papers/two{
	pixel_x = 1;
	pixel_y = 5
	},
/turf/open/floor/plating/indoor/woodc,
/area/halflife/indoors)
"N" = (
/obj/modular_map_connector,
/turf/template_noop,
/area/template_noop)
"O" = (
/obj/structure/table/halflife/no_smooth/wood/square,
/obj/machinery/light/small/directional/south,
/turf/open/floor/plating/indoor/woodc,
/area/halflife/indoors)
"P" = (
/obj/machinery/door/unpowered/halflife/wood,
/turf/open/floor/plating/indoor/woodc,
/area/halflife/indoors)
"Q" = (
/obj/machinery/light/small/directional/west,
/turf/open/floor/plating/indoor/woodc,
/area/halflife/indoors)
"T" = (
/obj/machinery/light/small/directional/east,
/turf/open/floor/plating/indoor/woodc,
/area/halflife/indoors)
"U" = (
/obj/structure/halflife/trash/papers/two{
	dir = 1
	},
/turf/open/floor/plating/indoor/woodc,
/area/halflife/indoors)
"X" = (
/obj/structure/closet/halflife,
/obj/effect/spawner/random/halflife/loot,
/turf/open/floor/plating/indoor/woodc,
/area/halflife/indoors)
"Y" = (
/obj/structure/dresser,
/obj/structure/halflife/rug/red,
/turf/open/floor/plating/indoor/woodc,
/area/halflife/indoors)
"Z" = (
/obj/structure/table/halflife/no_smooth/wood/square,
/obj/structure/halflife/trash/glass/basic,
/turf/open/floor/plating/indoor/woodc,
/area/halflife/indoors)

(1,1,1) = {"
s
s
s
s
s
s
s
s
s
s
s
s
s
s
s
s
N
"}
(2,1,1) = {"
s
a
a
a
a
a
a
a
a
a
a
a
a
a
a
a
s
"}
(3,1,1) = {"
s
a
F
F
Z
e
Q
m
m
a
m
m
Q
m
j
a
s
"}
(4,1,1) = {"
s
a
m
m
m
m
m
m
m
P
m
m
m
m
m
a
s
"}
(5,1,1) = {"
s
a
m
m
m
m
m
m
m
a
t
m
m
m
Y
a
s
"}
(6,1,1) = {"
s
a
X
m
l
l
m
m
M
a
y
m
m
m
o
a
s
"}
(7,1,1) = {"
s
a
a
a
a
a
r
m
a
a
a
a
a
a
a
a
s
"}
(8,1,1) = {"
s
a
m
m
m
m
m
m
m
m
m
m
m
m
F
a
s
"}
(9,1,1) = {"
s
h
m
m
m
m
m
m
m
m
m
m
m
m
O
a
s
"}
(10,1,1) = {"
s
a
m
m
T
m
m
m
m
m
m
m
m
m
I
a
s
"}
(11,1,1) = {"
s
a
a
a
a
a
r
m
a
a
a
a
a
a
a
a
s
"}
(12,1,1) = {"
s
a
X
m
C
C
m
m
m
a
y
m
m
m
Y
a
s
"}
(13,1,1) = {"
s
a
m
U
m
m
m
m
m
a
t
m
m
m
o
a
s
"}
(14,1,1) = {"
s
a
m
m
m
m
d
m
m
P
m
m
m
m
m
a
s
"}
(15,1,1) = {"
s
a
f
F
F
e
T
m
f
a
m
m
T
m
j
a
s
"}
(16,1,1) = {"
s
a
a
a
a
a
a
a
a
a
a
a
a
a
a
a
s
"}
(17,1,1) = {"
s
s
s
s
s
s
s
s
s
s
s
s
s
s
s
s
s
"}
