//MAP CONVERTED BY dmm2tgm.py THIS HEADER COMMENT PREVENTS RECONVERSION, DO NOT REMOVE
"a" = (
/turf/open/floor/plating/indoor/concrete/bricks,
/area/halflife/indoors)
"b" = (
/obj/structure/halflife/trash/cardboard{
	dir = 8
	},
/obj/effect/spawner/random/halflife/loot/trash,
/turf/open/floor/plating/indoor/concrete/bricks,
/area/halflife/indoors)
"c" = (
/obj/effect/turf_decal/box,
/turf/open/floor/plating/indoor/concrete/bricks,
/area/halflife/indoors)
"d" = (
/obj/structure/closet/halflife,
/obj/item/stack/spacecash/c10,
/turf/open/floor/plating/indoor/concrete/bricks,
/area/halflife/indoors)
"e" = (
/obj/item/stack/spacecash/c1,
/turf/open/floor/plating/indoor/concrete/bricks,
/area/halflife/indoors)
"f" = (
/obj/machinery/light,
/turf/open/floor/plating/indoor/metal/pipe/intersection{
	dir = 1
	},
/area/halflife/indoors)
"g" = (
/turf/closed/wall/halflife/concrete,
/area/halflife/indoors)
"h" = (
/turf/open/floor/plating/indoor/metal/pipe,
/area/halflife/indoors)
"i" = (
/turf/open/floor/plating/indoor/metal/pipe/corner{
	dir = 4
	},
/area/halflife/indoors)
"j" = (
/obj/effect/spawner/random/halflife/loot/ammo,
/turf/open/floor/plating/indoor/concrete/bricks,
/area/halflife/indoors)
"l" = (
/obj/machinery/door/unpowered/halflife/metal,
/turf/open/floor/plating/indoor/metal/pipe{
	dir = 1
	},
/area/halflife/indoors)
"m" = (
/turf/open/floor/plating/indoor/metal/pipe/intersection,
/area/halflife/indoors)
"o" = (
/turf/template_noop,
/area/template_noop)
"p" = (
/obj/effect/spawner/random/halflife/loot/heal,
/turf/open/floor/plating/indoor/concrete/bricks,
/area/halflife/indoors)
"q" = (
/turf/open/floor/plating/indoor/metal/pipe/corner{
	dir = 8
	},
/area/halflife/indoors)
"r" = (
/obj/structure/halflife/pallet/stack,
/turf/open/floor/plating/indoor/concrete/bricks,
/area/halflife/indoors)
"s" = (
/turf/open/floor/plating/indoor/metal/pipe/corner{
	dir = 1
	},
/area/halflife/indoors)
"t" = (
/obj/structure/halflife/barrel/double/yellow,
/turf/open/floor/plating/indoor/concrete/bricks,
/area/halflife/indoors)
"w" = (
/obj/machinery/door/unpowered/halflife/metal,
/turf/open/floor/plating/indoor/concrete/bricks,
/area/halflife/indoors)
"x" = (
/obj/structure/halflife/pipes/vent,
/turf/open/floor/plating/indoor/concrete/bricks,
/area/halflife/indoors)
"y" = (
/obj/effect/spawner/random/halflife/loot/consumables,
/turf/open/floor/plating/indoor/concrete/bricks,
/area/halflife/indoors)
"z" = (
/mob/living/basic/halflife/headcrab/poison,
/turf/open/floor/plating/indoor/concrete/bricks,
/area/halflife/indoors)
"A" = (
/mob/living/basic/halflife/zombie/poison,
/turf/open/floor/plating/indoor/concrete/bricks,
/area/halflife/indoors)
"B" = (
/obj/structure/halflife/pipes/vent,
/obj/structure/halflife/barrel/double/yellow,
/turf/open/floor/plating/indoor/concrete/bricks,
/area/halflife/indoors)
"C" = (
/obj/effect/turf_decal/box,
/obj/structure/halflife/trash/garbage/dumpster/crate,
/turf/open/floor/plating/indoor/concrete/bricks,
/area/halflife/indoors)
"D" = (
/obj/structure/halflife/tank/chemical/container,
/turf/open/floor/plating/indoor/concrete/bricks,
/area/halflife/indoors)
"E" = (
/turf/open/floor/plating/indoor/metal/pipe{
	dir = 1
	},
/area/halflife/indoors)
"F" = (
/obj/structure/halflife/tank/chemical/huge,
/turf/open/floor/plating/indoor/concrete/bricks,
/area/halflife/indoors)
"G" = (
/turf/open/floor/plating/indoor/metal/walkway{
	dir = 1
	},
/area/halflife/indoors)
"H" = (
/obj/effect/spawner/random/halflife/loot,
/turf/open/floor/plating/indoor/concrete/bricks,
/area/halflife/indoors)
"I" = (
/obj/structure/halflife/trash/garbage/dumpster/crate,
/turf/open/floor/plating/indoor/concrete/bricks,
/area/halflife/indoors)
"K" = (
/obj/effect/spawner/random/halflife/loot/crafting_bench,
/turf/open/floor/plating/indoor/concrete/bricks,
/area/halflife/indoors)
"L" = (
/turf/open/floor/plating/indoor/metal/plate,
/area/halflife/indoors)
"M" = (
/obj/machinery/light{
	dir = 1
	},
/turf/open/floor/plating/indoor/concrete/bricks,
/area/halflife/indoors)
"N" = (
/obj/structure/halflife/trash/wood{
	dir = 6
	},
/turf/open/floor/plating/indoor/concrete/bricks,
/area/halflife/indoors)
"P" = (
/obj/effect/turf_decal/box,
/obj/structure/reagent_dispensers/fueltank,
/turf/open/floor/plating/indoor/concrete/bricks,
/area/halflife/indoors)
"Q" = (
/obj/machinery/light/small/directional/north,
/turf/open/floor/plating/indoor/metal/pipe,
/area/halflife/indoors)
"S" = (
/obj/structure/halflife/pallet,
/obj/item/stack/spacecash/c1,
/turf/open/floor/plating/indoor/concrete/bricks,
/area/halflife/indoors)
"U" = (
/obj/structure/halflife/trash/bricks{
	dir = 4
	},
/obj/item/stack/spacecash/c1,
/turf/open/floor/plating/indoor/concrete/bricks,
/area/halflife/indoors)
"V" = (
/turf/open/floor/plating/indoor/metal/pipe/corner,
/area/halflife/indoors)
"W" = (
/obj/modular_map_connector,
/turf/template_noop,
/area/template_noop)
"X" = (
/obj/structure/halflife/trash/bricks,
/turf/open/floor/plating/indoor/concrete/bricks,
/area/halflife/indoors)
"Y" = (
/obj/structure/halflife/tank/chemical/container/broken,
/turf/open/floor/plating/indoor/concrete/bricks,
/area/halflife/indoors)

(1,1,1) = {"
o
o
o
o
o
o
o
o
o
o
o
o
o
o
o
o
W
"}
(2,1,1) = {"
o
g
g
g
g
g
g
g
g
g
g
g
g
g
g
g
o
"}
(3,1,1) = {"
o
g
V
H
a
a
g
M
L
L
L
L
E
E
V
g
o
"}
(4,1,1) = {"
o
g
Q
C
c
y
g
x
G
K
a
a
S
a
h
g
o
"}
(5,1,1) = {"
o
g
h
c
c
a
g
U
G
a
a
a
p
a
h
g
o
"}
(6,1,1) = {"
o
g
h
P
C
a
g
a
G
a
e
a
a
a
h
g
o
"}
(7,1,1) = {"
o
g
m
E
E
E
l
E
G
E
E
E
V
t
h
g
o
"}
(8,1,1) = {"
o
g
g
g
g
g
g
a
G
a
A
a
m
E
f
g
o
"}
(9,1,1) = {"
o
g
m
E
E
E
l
E
G
E
E
E
s
Y
h
g
o
"}
(10,1,1) = {"
o
g
h
F
a
a
g
a
G
a
a
a
a
a
h
g
o
"}
(11,1,1) = {"
o
g
Q
a
a
r
g
D
G
a
z
j
a
a
h
g
o
"}
(12,1,1) = {"
o
g
h
a
a
y
g
a
G
S
a
a
a
I
h
g
o
"}
(13,1,1) = {"
o
w
L
a
a
X
g
N
G
a
a
a
a
b
h
g
o
"}
(14,1,1) = {"
o
g
h
a
a
a
g
B
G
a
a
a
i
E
s
g
o
"}
(15,1,1) = {"
o
g
q
E
E
E
g
E
G
E
E
E
s
S
d
g
o
"}
(16,1,1) = {"
o
g
g
g
g
g
g
g
g
g
g
g
g
g
g
g
o
"}
(17,1,1) = {"
o
o
o
o
o
o
o
o
o
o
o
o
o
o
o
o
o
"}
