//MAP CONVERTED BY dmm2tgm.py THIS HEADER COMMENT PREVENTS RECONVERSION, DO NOT REMOVE
"a" = (
/turf/open/floor/plating/indoor/sterilesquares,
/area/halflife/indoors)
"b" = (
/turf/open/floor/plating/indoor/metal/plate,
/area/halflife/indoors)
"c" = (
/obj/structure/halflife/trash/papers/two{
	dir = 1
	},
/turf/open/floor/plating/indoor/tiled9,
/area/halflife/indoors)
"d" = (
/obj/item/stack/medical/suture,
/turf/open/floor/plating/indoor/metal/plate,
/area/halflife/indoors)
"e" = (
/obj/structure/closet/halflife/wall/firstaid,
/obj/item/reagent_containers/pill/patch/medkit,
/obj/item/reagent_containers/pill/patch/medkit,
/turf/open/floor/plating/indoor/metal/plate,
/area/halflife/indoors)
"f" = (
/obj/machinery/light/small/directional/west,
/turf/open/floor/plating/indoor/sterilesquares,
/area/halflife/indoors)
"g" = (
/obj/machinery/light/small/directional/west,
/turf/open/floor/plating/indoor/tiled9,
/area/halflife/indoors)
"h" = (
/obj/structure/halflife/storage/large/medical,
/turf/open/floor/plating/indoor/sterilesquares,
/area/halflife/indoors)
"i" = (
/turf/template_noop,
/area/template_noop)
"j" = (
/obj/machinery/door/unpowered/halflife/metal,
/turf/open/floor/plating/indoor/sterilesquares,
/area/halflife/indoors)
"l" = (
/obj/structure/bed/halflife/bedframe/wood,
/obj/structure/bed/halflife/mattress/stained,
/turf/open/floor/plating/indoor/sterilesquares,
/area/halflife/indoors)
"m" = (
/obj/item/stack/spacecash/c1,
/turf/open/floor/plating/indoor/sterilesquares,
/area/halflife/indoors)
"n" = (
/obj/structure/halflife/trash/papers/three{
	dir = 8;
	pixel_y = 8
	},
/turf/open/floor/plating/indoor/sterilesquares,
/area/halflife/indoors)
"o" = (
/obj/structure/chair/office/halflife/blue{
	dir = 8
	},
/turf/open/floor/plating/indoor/sterilesquares,
/area/halflife/indoors)
"p" = (
/obj/structure/table/halflife/no_smooth/large/metal,
/obj/item/reagent_containers/pill/antitox,
/turf/open/floor/plating/indoor/metal/plate,
/area/halflife/indoors)
"q" = (
/obj/structure/bed/halflife/bedframe/wood,
/turf/open/floor/plating/indoor/sterilesquares,
/area/halflife/indoors)
"r" = (
/obj/structure/table/halflife/no_smooth/metal,
/obj/item/stack/spacecash/c1,
/turf/open/floor/plating/indoor/sterilesquares,
/area/halflife/indoors)
"s" = (
/obj/machinery/door/unpowered/halflife/seethrough/metal,
/turf/open/floor/plating/indoor/tiled9,
/area/halflife/indoors)
"t" = (
/obj/effect/turf_decal/halflife/covering/tiles/white,
/turf/closed/wall/halflife/brick/grey,
/area/halflife/indoors)
"u" = (
/turf/open/floor/plating/indoor/tiled9,
/area/halflife/indoors)
"v" = (
/mob/living/basic/halflife/headcrab/poison,
/turf/open/floor/plating/indoor/sterilesquares,
/area/halflife/indoors)
"w" = (
/obj/structure/table/halflife/no_smooth/large/metal,
/turf/open/floor/plating/indoor/metal/plate,
/area/halflife/indoors)
"x" = (
/obj/machinery/light/small/directional/west,
/turf/open/floor/plating/indoor/metal/plate,
/area/halflife/indoors)
"y" = (
/obj/machinery/light/small/directional/east,
/turf/open/floor/plating/indoor/metal/plate,
/area/halflife/indoors)
"z" = (
/obj/structure/bed/halflife/bedframe/wood,
/obj/structure/bed/halflife/mattress/stained,
/obj/item/stack/spacecash/c1,
/turf/open/floor/plating/indoor/sterilesquares,
/area/halflife/indoors)
"A" = (
/mob/living/basic/halflife/headcrab,
/turf/open/floor/plating/indoor/sterilesquares,
/area/halflife/indoors)
"C" = (
/obj/machinery/light/small/broken/directional/east,
/turf/open/floor/plating/indoor/sterilesquares,
/area/halflife/indoors)
"D" = (
/obj/item/chair/halflife/metal/blue,
/turf/open/floor/plating/indoor/tiled9,
/area/halflife/indoors)
"E" = (
/obj/structure/bed/halflife/bedframe/wood,
/obj/machinery/light/small/directional/south,
/turf/open/floor/plating/indoor/sterilesquares,
/area/halflife/indoors)
"F" = (
/obj/machinery/light/small/directional/east,
/turf/open/floor/plating/indoor/sterilesquares,
/area/halflife/indoors)
"G" = (
/obj/structure/halflife/trash/papers/three,
/turf/open/floor/plating/indoor/sterilesquares,
/area/halflife/indoors)
"H" = (
/obj/structure/halflife/trash/papers/two{
	dir = 8
	},
/turf/open/floor/plating/indoor/sterilesquares,
/area/halflife/indoors)
"I" = (
/obj/structure/chair/halflife/metal/blue{
	dir = 4
	},
/turf/open/floor/plating/indoor/tiled9,
/area/halflife/indoors)
"J" = (
/obj/structure/bed/halflife/mattress/stained,
/turf/open/floor/plating/indoor/sterilesquares,
/area/halflife/indoors)
"K" = (
/obj/machinery/door/unpowered/halflife/metal,
/turf/open/floor/plating/indoor/metal/plate,
/area/halflife/indoors)
"N" = (
/obj/structure/table/halflife/no_smooth/large/metal,
/obj/item/reagent_containers/hypospray/medipen/healthpen,
/turf/open/floor/plating/indoor/metal/plate,
/area/halflife/indoors)
"O" = (
/obj/structure/table/halflife/no_smooth/metal,
/obj/item/storage/wallet,
/turf/open/floor/plating/indoor/sterilesquares,
/area/halflife/indoors)
"Q" = (
/obj/structure/table/optable,
/obj/effect/decal/cleanable/blood/old,
/obj/item/stack/spacecash/c10,
/turf/open/floor/plating/indoor/sterilesquares,
/area/halflife/indoors)
"S" = (
/mob/living/basic/halflife/zombie/fast,
/turf/open/floor/plating/indoor/sterilesquares,
/area/halflife/indoors)
"T" = (
/obj/structure/table/halflife/no_smooth/large/metal{
	dir = 8
	},
/turf/open/floor/plating/indoor/sterilesquares,
/area/halflife/indoors)
"U" = (
/obj/machinery/light/small/directional/north,
/turf/open/floor/plating/indoor/sterilesquares,
/area/halflife/indoors)
"V" = (
/obj/structure/halflife/trash/papers/three{
	dir = 8
	},
/turf/open/floor/plating/indoor/sterilesquares,
/area/halflife/indoors)
"W" = (
/obj/machinery/door/unpowered/halflife/seethrough/metal,
/turf/open/floor/plating/indoor/sterilesquares,
/area/halflife/indoors)
"X" = (
/obj/modular_map_connector,
/turf/template_noop,
/area/template_noop)
"Y" = (
/turf/closed/wall/halflife/brick/grey,
/area/halflife/indoors)
"Z" = (
/obj/effect/turf_decal/halflife/covering/tiles/white,
/obj/structure/halflife/sign/clinic{
	pixel_y = 0
	},
/turf/closed/wall/halflife/brick/grey,
/area/halflife/indoors)

(1,1,1) = {"
i
i
i
i
i
i
i
i
i
i
i
i
i
i
i
i
X
"}
(2,1,1) = {"
i
Y
Y
Y
Y
Y
Y
Y
Y
Y
Y
Y
Y
Y
Y
t
i
"}
(3,1,1) = {"
i
Z
I
g
I
D
t
a
a
a
a
q
a
f
l
t
i
"}
(4,1,1) = {"
i
s
c
u
u
u
W
a
a
J
A
a
a
a
h
t
i
"}
(5,1,1) = {"
i
t
u
u
u
u
t
U
a
n
a
a
a
a
a
t
i
"}
(6,1,1) = {"
i
t
u
u
u
u
t
h
a
a
a
z
a
V
E
t
i
"}
(7,1,1) = {"
i
t
a
T
Y
Y
t
a
a
a
a
a
a
a
h
t
i
"}
(8,1,1) = {"
i
t
a
o
a
a
t
a
a
a
a
a
A
a
a
t
i
"}
(9,1,1) = {"
i
t
a
a
H
a
W
a
v
a
a
l
a
F
z
t
i
"}
(10,1,1) = {"
i
t
r
F
a
r
t
a
a
a
Y
Y
Y
Y
Y
t
i
"}
(11,1,1) = {"
i
Y
Y
Y
Y
Y
t
h
a
a
t
p
x
N
b
t
i
"}
(12,1,1) = {"
i
t
O
a
m
a
t
a
a
a
t
e
b
b
b
t
i
"}
(13,1,1) = {"
i
t
Q
a
a
a
t
U
a
a
K
b
b
b
b
t
i
"}
(14,1,1) = {"
i
t
a
S
G
a
j
a
a
a
t
w
b
p
b
t
i
"}
(15,1,1) = {"
i
t
m
C
a
a
t
a
a
a
t
d
y
b
b
t
i
"}
(16,1,1) = {"
i
Y
Y
Y
Y
Y
Y
Y
Y
Y
Y
Y
Y
Y
Y
t
i
"}
(17,1,1) = {"
i
i
i
i
i
i
i
i
i
i
i
i
i
i
i
i
i
"}
