//MAP CONVERTED BY dmm2tgm.py THIS HEADER COMMENT PREVENTS RECONVERSION, DO NOT REMOVE
"a" = (
/turf/template_noop,
/area/template_noop)
"b" = (
/obj/structure/table/halflife/no_smooth/wood/square,
/obj/structure/halflife/trash/papers/two{
	pixel_x = 1;
	pixel_y = 5
	},
/turf/open/floor/plating/indoor/woodc,
/area/halflife/indoors)
"c" = (
/obj/structure/chair/comfy/halflife/armchair{
	dir = 1
	},
/turf/open/floor/plating/indoor/woodc,
/area/halflife/indoors)
"d" = (
/turf/open/floor/plating/indoor/woodc,
/area/halflife/indoors)
"e" = (
/obj/structure/halflife/storage/large/clothing,
/turf/open/floor/plating/indoor/woodc,
/area/halflife/indoors)
"f" = (
/obj/structure/table/halflife/no_smooth/wood/square,
/obj/structure/halflife/trash/glass/basic,
/turf/open/floor/plating/indoor/checkered,
/area/halflife/indoors)
"g" = (
/obj/structure/halflife/toilet{
	pixel_y = 8
	},
/turf/open/floor/plating/indoor/lino,
/area/halflife/indoors)
"h" = (
/obj/structure/table/halflife/no_smooth/wood/square,
/obj/machinery/light/small/directional/north,
/obj/item/stack/spacecash/c1,
/turf/open/floor/plating/indoor/woodc,
/area/halflife/indoors)
"i" = (
/turf/open/floor/plating/indoor/checkered,
/area/halflife/indoors)
"j" = (
/obj/structure/halflife/trash/papers/two{
	dir = 8
	},
/turf/open/floor/plating/indoor/woodc,
/area/halflife/indoors)
"k" = (
/obj/machinery/light/small/directional/north,
/obj/structure/table/halflife/no_smooth/large/wood/desk/alt,
/turf/open/floor/plating/indoor/woodc,
/area/halflife/indoors)
"m" = (
/obj/structure/chair/halflife/wood{
	dir = 4
	},
/turf/open/floor/plating/indoor/woodc,
/area/halflife/indoors)
"n" = (
/obj/machinery/light/small/directional/south,
/turf/open/floor/plating/indoor/lino,
/area/halflife/indoors)
"o" = (
/obj/structure/closet/cabinet,
/obj/effect/spawner/random/halflife/loot,
/obj/item/stack/spacecash/c1,
/obj/item/stack/spacecash/c1,
/turf/open/floor/plating/indoor/woodc,
/area/halflife/indoors)
"p" = (
/obj/structure/table/halflife/no_smooth/wood/square,
/obj/structure/halflife/trash/food/misc,
/turf/open/floor/plating/indoor/checkered,
/area/halflife/indoors)
"q" = (
/obj/machinery/door/unpowered/halflife/metal,
/turf/open/floor/plating/indoor/lino,
/area/halflife/indoors)
"t" = (
/obj/structure/bed/halflife/bedframe/cot,
/obj/structure/bed/halflife/mattress/yellowed,
/obj/machinery/light/small/directional/south,
/turf/open/floor/plating/indoor/woodc,
/area/halflife/indoors)
"v" = (
/obj/structure/table/halflife/no_smooth/wood/stand,
/turf/open/floor/plating/indoor/woodc,
/area/halflife/indoors)
"w" = (
/obj/structure/chair/halflife/wood{
	dir = 4
	},
/obj/machinery/light/small/directional/west,
/turf/open/floor/plating/indoor/woodc,
/area/halflife/indoors)
"x" = (
/obj/structure/window/fulltile/halflife/nosmooth/brick,
/turf/open/floor/plating/indoor/woodc,
/area/halflife/indoors)
"y" = (
/obj/modular_map_connector,
/turf/template_noop,
/area/template_noop)
"A" = (
/obj/structure/halflife/toilet{
	pixel_y = 8
	},
/obj/machinery/light/small/directional/east,
/turf/open/floor/plating/indoor/lino,
/area/halflife/indoors)
"B" = (
/obj/machinery/door/unpowered/halflife/metal,
/turf/open/floor/plating/indoor/woodc,
/area/halflife/indoors)
"C" = (
/obj/structure/halflife/rug/red,
/turf/open/floor/plating/indoor/woodc,
/area/halflife/indoors)
"D" = (
/turf/open/floor/plating/indoor/lino,
/area/halflife/indoors)
"E" = (
/turf/open/floor/plating/ground/grass,
/area/template_noop)
"F" = (
/obj/structure/chair/office/halflife/blue{
	dir = 1
	},
/turf/open/floor/plating/indoor/woodc,
/area/halflife/indoors)
"G" = (
/obj/machinery/door/unpowered/halflife/wood{
	dir = 8
	},
/turf/open/floor/plating/indoor/lino,
/area/halflife/indoors)
"H" = (
/obj/effect/turf_decal/halflife/covering/wallpaper/green,
/turf/closed/wall/halflife/brick,
/area/halflife/indoors)
"I" = (
/obj/structure/bed/halflife/bedframe/wood,
/obj/structure/bed/halflife/mattress/stale,
/obj/machinery/light/small/directional/south,
/turf/open/floor/plating/indoor/woodc,
/area/halflife/indoors)
"J" = (
/obj/structure/halflife/pot/plant,
/turf/open/floor/plating/indoor/woodc,
/area/halflife/indoors)
"K" = (
/obj/machinery/door/unpowered/halflife/wood,
/turf/open/floor/plating/indoor/woodc,
/area/halflife/indoors)
"L" = (
/obj/structure/closet/halflife,
/obj/effect/spawner/random/halflife/loot,
/obj/item/stack/spacecash/c1,
/turf/open/floor/plating/indoor/woodc,
/area/halflife/indoors)
"M" = (
/obj/machinery/shower/halflife{
	dir = 8
	},
/obj/structure/fluff/shower_drain,
/turf/open/floor/plating/indoor/lino,
/area/halflife/indoors)
"N" = (
/turf/closed/wall/halflife/brick,
/area/halflife/indoors)
"O" = (
/turf/open/floor/plating/ground/sidewalk,
/area/template_noop)
"Q" = (
/obj/structure/dresser,
/obj/structure/halflife/rug/red,
/obj/item/stack/spacecash/c1,
/turf/open/floor/plating/indoor/woodc,
/area/halflife/indoors)
"R" = (
/obj/machinery/door/unpowered/halflife/seethrough/metal,
/turf/open/floor/plating/indoor/woodc,
/area/halflife/indoors)
"T" = (
/obj/structure/halflife/trash/papers/three,
/turf/open/floor/plating/indoor/woodc,
/area/halflife/indoors)
"U" = (
/obj/machinery/shower/halflife{
	dir = 8
	},
/obj/item/stack/spacecash/c1,
/turf/open/floor/plating/indoor/lino,
/area/halflife/indoors)
"V" = (
/obj/structure/sink/halflife,
/obj/structure/mirror/halflife{
	pixel_y = 32
	},
/turf/open/floor/plating/indoor/lino,
/area/halflife/indoors)
"X" = (
/obj/machinery/light/small/directional/east,
/obj/structure/closet/secure_closet/freezer/halflife,
/obj/effect/spawner/random/halflife/loot/consumables,
/turf/open/floor/plating/indoor/checkered,
/area/halflife/indoors)
"Y" = (
/obj/machinery/light/small/directional/south,
/turf/open/floor/plating/indoor/woodc,
/area/halflife/indoors)

(1,1,1) = {"
a
a
a
a
a
a
a
a
a
a
a
a
a
a
a
a
y
"}
(2,1,1) = {"
a
N
N
N
N
N
N
N
N
N
N
N
N
N
N
N
a
"}
(3,1,1) = {"
a
N
J
d
m
w
d
K
d
Q
N
N
N
N
N
N
a
"}
(4,1,1) = {"
a
N
h
d
d
d
T
N
d
t
N
N
N
N
N
N
a
"}
(5,1,1) = {"
a
N
b
d
d
d
d
N
N
N
N
N
N
N
N
N
a
"}
(6,1,1) = {"
a
N
N
d
N
d
d
d
d
Y
N
N
N
N
N
N
a
"}
(7,1,1) = {"
a
N
e
d
N
L
d
d
d
d
N
N
N
N
N
N
a
"}
(8,1,1) = {"
a
N
d
d
N
N
G
N
f
i
N
N
N
N
N
N
a
"}
(9,1,1) = {"
a
R
d
Y
N
V
D
N
p
i
N
N
N
N
N
N
a
"}
(10,1,1) = {"
a
x
j
d
N
A
M
N
X
i
N
N
N
N
N
N
a
"}
(11,1,1) = {"
a
N
N
N
N
N
N
N
N
N
N
N
N
N
N
N
a
"}
(12,1,1) = {"
a
E
H
o
d
v
I
N
N
N
N
N
N
N
N
N
a
"}
(13,1,1) = {"
a
O
B
d
d
d
d
N
V
D
N
N
N
N
N
N
a
"}
(14,1,1) = {"
a
E
H
k
C
d
d
q
D
n
N
N
N
N
N
N
a
"}
(15,1,1) = {"
a
E
H
d
F
d
c
N
g
U
N
N
N
N
N
N
a
"}
(16,1,1) = {"
a
E
N
N
N
N
N
N
N
N
N
N
N
N
N
N
a
"}
(17,1,1) = {"
a
a
a
a
a
a
a
a
a
a
a
a
a
a
a
a
a
"}
