//MAP CONVERTED BY dmm2tgm.py THIS HEADER COMMENT PREVENTS RECONVERSION, DO NOT REMOVE
"a" = (
/turf/template_noop,
/area/template_noop)
"b" = (
/obj/structure/table/halflife/no_smooth/wood/square,
/obj/machinery/light/small/directional/north,
/turf/open/floor/plating/indoor/woodc,
/area/halflife/indoors)
"d" = (
/obj/structure/table/halflife/no_smooth/wood/square,
/obj/item/stack/spacecash/c1,
/turf/open/floor/plating/indoor/woodc,
/area/halflife/indoors)
"e" = (
/obj/structure/halflife/trash/papers/two{
	dir = 1
	},
/turf/open/floor/plating/indoor/woodc,
/area/halflife/indoors)
"h" = (
/obj/structure/halflife/pot/plant,
/turf/open/floor/plating/indoor/woodc,
/area/halflife/indoors)
"i" = (
/obj/structure/table/halflife/no_smooth/wood/square,
/turf/open/floor/plating/indoor/woodc,
/area/halflife/indoors)
"l" = (
/obj/modular_map_connector,
/turf/template_noop,
/area/template_noop)
"n" = (
/obj/machinery/light/small/directional/west,
/turf/open/floor/plating/indoor/woodc,
/area/halflife/indoors)
"o" = (
/obj/structure/dresser,
/obj/structure/halflife/rug/red,
/turf/open/floor/plating/indoor/woodc,
/area/halflife/indoors)
"r" = (
/turf/closed/wall/halflife/concrete/alt,
/area/halflife/indoors)
"w" = (
/obj/structure/table/halflife/no_smooth/wood/low,
/obj/item/stack/spacecash/c1,
/turf/open/floor/plating/indoor/woodc,
/area/halflife/indoors)
"y" = (
/obj/structure/table/halflife/no_smooth/wood/square,
/obj/structure/halflife/trash/glass/basic,
/turf/open/floor/plating/indoor/woodc,
/area/halflife/indoors)
"A" = (
/obj/structure/table/halflife/no_smooth/wood/square,
/obj/structure/halflife/trash/papers/two{
	pixel_x = 1;
	pixel_y = 5
	},
/turf/open/floor/plating/indoor/woodc,
/area/halflife/indoors)
"B" = (
/obj/structure/bed/halflife/bedframe/cot,
/obj/structure/bed/halflife/mattress/yellowed,
/obj/machinery/light/small/directional/south,
/turf/open/floor/plating/indoor/woodc,
/area/halflife/indoors)
"D" = (
/obj/structure/closet/halflife,
/obj/effect/spawner/random/halflife/loot,
/obj/item/stack/spacecash/c1,
/turf/open/floor/plating/indoor/woodc,
/area/halflife/indoors)
"E" = (
/obj/structure/chair/halflife/wood{
	dir = 4
	},
/turf/open/floor/plating/indoor/woodc,
/area/halflife/indoors)
"H" = (
/obj/structure/table/halflife/no_smooth/wood/square,
/obj/structure/halflife/trash/glass/cans,
/turf/open/floor/plating/indoor/woodc,
/area/halflife/indoors)
"I" = (
/turf/open/floor/plating/indoor/woodc,
/area/halflife/indoors)
"J" = (
/obj/structure/chair/halflife/wood{
	dir = 8
	},
/turf/open/floor/plating/indoor/woodc,
/area/halflife/indoors)
"K" = (
/obj/structure/closet/halflife,
/obj/effect/spawner/random/halflife/loot,
/turf/open/floor/plating/indoor/woodc,
/area/halflife/indoors)
"N" = (
/obj/structure/halflife/trash/papers/two{
	dir = 8
	},
/turf/open/floor/plating/indoor/woodc,
/area/halflife/indoors)
"O" = (
/obj/machinery/door/unpowered/halflife/seethrough/metal,
/turf/open/floor/plating/indoor/woodc,
/area/halflife/indoors)
"P" = (
/obj/structure/barricade/sandbags,
/turf/open/floor/plating/indoor/woodc,
/area/halflife/indoors)
"Q" = (
/obj/structure/table/halflife/no_smooth/wood/low,
/obj/effect/spawner/random/halflife/loot,
/turf/open/floor/plating/indoor/woodc,
/area/halflife/indoors)
"R" = (
/obj/machinery/door/unpowered/halflife/wood,
/turf/open/floor/plating/indoor/woodc,
/area/halflife/indoors)
"Z" = (
/obj/machinery/light/small/directional/east,
/turf/open/floor/plating/indoor/woodc,
/area/halflife/indoors)

(1,1,1) = {"
a
a
a
a
a
a
a
a
a
a
a
a
a
a
a
a
l
"}
(2,1,1) = {"
a
r
r
r
r
r
r
r
r
r
r
r
r
r
r
r
a
"}
(3,1,1) = {"
a
r
d
d
y
h
n
I
I
r
I
I
n
I
D
r
a
"}
(4,1,1) = {"
a
r
I
I
I
I
I
I
I
R
I
I
I
I
I
r
a
"}
(5,1,1) = {"
a
r
I
I
I
I
I
I
I
r
Q
I
I
I
o
r
a
"}
(6,1,1) = {"
a
r
K
I
J
J
I
I
A
r
w
I
I
I
B
r
a
"}
(7,1,1) = {"
a
r
r
r
r
r
P
I
r
r
r
r
r
r
r
r
a
"}
(8,1,1) = {"
a
r
d
I
I
I
I
I
I
r
I
I
I
I
I
r
a
"}
(9,1,1) = {"
a
r
b
I
I
I
I
I
I
O
I
I
I
I
I
O
a
"}
(10,1,1) = {"
a
r
H
I
I
I
I
I
I
r
I
I
Z
I
I
r
a
"}
(11,1,1) = {"
a
r
r
r
r
r
P
I
r
r
r
r
r
r
r
r
a
"}
(12,1,1) = {"
a
r
K
I
E
E
I
I
I
r
w
I
I
I
o
r
a
"}
(13,1,1) = {"
a
r
I
e
I
I
I
I
I
r
Q
I
I
I
B
r
a
"}
(14,1,1) = {"
a
r
I
I
I
I
N
I
I
R
I
I
I
I
I
r
a
"}
(15,1,1) = {"
a
r
i
d
d
h
Z
I
i
r
I
I
Z
I
D
r
a
"}
(16,1,1) = {"
a
r
r
r
r
r
r
r
r
r
r
r
r
r
r
r
a
"}
(17,1,1) = {"
a
a
a
a
a
a
a
a
a
a
a
a
a
a
a
a
a
"}
