//MAP CONVERTED BY dmm2tgm.py THIS HEADER COMMENT PREVENTS RECONVERSION, DO NOT REMOVE
"a" = (
/turf/template_noop,
/area/template_noop)
"c" = (
/turf/closed/wall/halflife/brick,
/area/halflife/indoors)
"e" = (
/obj/structure/sign/warning/biohazard/directional/north,
/turf/open/floor/plating/indoor/woodc,
/area/halflife/indoors)
"f" = (
/obj/structure/table/halflife/wood,
/obj/item/knife/kitchen,
/turf/open/floor/plating/indoor/woodc,
/area/halflife/indoors)
"h" = (
/obj/structure/halflife/storage/shelf/wood/alt,
/obj/item/stack/spacecash/c1,
/turf/open/floor/plating/indoor/woodc,
/area/halflife/indoors)
"i" = (
/obj/structure/flora/xen/tinyshrooms,
/turf/open/floor/plating/indoor/woodc,
/area/halflife/indoors)
"j" = (
/turf/open/floor/plating/indoor/woodc,
/area/halflife/indoors)
"m" = (
/obj/machinery/door/unpowered/halflife/metal,
/turf/open/floor/plating/indoor/woodc,
/area/halflife/indoors)
"q" = (
/obj/machinery/door/unpowered/halflife/seethrough/metal,
/turf/open/floor/plating/indoor/woodc,
/area/halflife/indoors)
"u" = (
/obj/structure/flora/xen/mound,
/turf/open/floor/plating/indoor/woodc,
/area/halflife/indoors)
"v" = (
/obj/structure/table/halflife/no_smooth/cable_reel,
/turf/open/floor/plating/indoor/woodc,
/area/halflife/indoors)
"w" = (
/obj/modular_map_connector,
/turf/template_noop,
/area/template_noop)
"z" = (
/obj/structure/halflife/trash/garbage/dumpster/crate,
/turf/open/floor/plating/indoor/woodc,
/area/halflife/indoors)
"C" = (
/obj/structure/halflife/storage/shelf/wood/alt,
/obj/effect/spawner/random/halflife/loot,
/turf/open/floor/plating/indoor/woodc,
/area/halflife/indoors)
"F" = (
/obj/structure/halflife/storage/shelf/wood/alt,
/turf/open/floor/plating/indoor/woodc,
/area/halflife/indoors)
"G" = (
/obj/structure/alien/weeds/node,
/turf/open/floor/plating/indoor/woodc,
/area/halflife/indoors)
"H" = (
/obj/structure/sign/warning/biohazard/directional/north,
/obj/structure/alien/weeds,
/turf/open/floor/plating/indoor/woodc,
/area/halflife/indoors)
"I" = (
/obj/structure/flora/xen/leafy,
/turf/open/floor/plating/indoor/woodc,
/area/halflife/indoors)
"J" = (
/obj/structure/table/halflife/no_smooth/cable_reel,
/obj/effect/spawner/random/halflife/loot,
/turf/open/floor/plating/indoor/woodc,
/area/halflife/indoors)
"L" = (
/obj/structure/halflife/trash/wood{
	dir = 1
	},
/turf/open/floor/plating/indoor/woodc,
/area/halflife/indoors)
"N" = (
/obj/structure/alien/weeds,
/turf/open/floor/plating/indoor/woodc,
/area/halflife/indoors)
"P" = (
/obj/structure/table/halflife/no_smooth/cable_reel,
/obj/item/stack/spacecash/c1,
/turf/open/floor/plating/indoor/woodc,
/area/halflife/indoors)
"R" = (
/obj/structure/table/halflife/wood,
/turf/open/floor/plating/indoor/woodc,
/area/halflife/indoors)
"V" = (
/mob/living/basic/halflife/zombie/gonome/complete/cash_gorged,
/turf/open/floor/plating/indoor/woodc,
/area/halflife/indoors)
"X" = (
/mob/living/basic/halflife/headcrab/armored,
/turf/open/floor/plating/indoor/woodc,
/area/halflife/indoors)
"Y" = (
/obj/item/stack/spacecash/c1,
/turf/open/floor/plating/indoor/woodc,
/area/halflife/indoors)

(1,1,1) = {"
a
a
a
a
a
a
a
a
a
a
a
a
a
a
a
a
w
"}
(2,1,1) = {"
a
c
c
c
c
c
c
c
c
c
c
c
c
c
c
c
a
"}
(3,1,1) = {"
a
c
C
j
j
j
j
G
j
j
j
c
v
j
z
c
a
"}
(4,1,1) = {"
a
c
F
j
Y
j
u
j
j
j
j
q
j
j
P
c
a
"}
(5,1,1) = {"
a
c
C
j
j
j
j
X
j
I
R
c
j
j
j
c
a
"}
(6,1,1) = {"
a
c
v
i
G
j
j
j
j
j
R
c
z
j
z
c
a
"}
(7,1,1) = {"
a
c
R
j
j
j
j
Y
G
j
R
c
c
c
c
c
a
"}
(8,1,1) = {"
a
c
f
j
j
Y
j
j
j
j
j
c
H
N
j
c
a
"}
(9,1,1) = {"
a
c
R
j
j
j
V
j
j
j
j
m
N
j
j
q
a
"}
(10,1,1) = {"
a
c
R
j
j
G
j
j
j
j
j
c
e
N
N
c
a
"}
(11,1,1) = {"
a
c
R
j
i
j
Y
j
j
G
R
c
c
c
c
c
a
"}
(12,1,1) = {"
a
c
v
j
G
j
j
j
j
Y
R
c
v
j
z
c
a
"}
(13,1,1) = {"
a
c
h
j
j
X
j
G
j
u
R
c
j
j
z
c
a
"}
(14,1,1) = {"
a
c
I
L
j
i
j
j
j
j
j
q
j
j
j
c
a
"}
(15,1,1) = {"
a
c
F
Y
j
j
j
j
j
j
j
c
j
J
z
c
a
"}
(16,1,1) = {"
a
c
c
c
c
c
c
c
c
c
c
c
c
c
c
c
a
"}
(17,1,1) = {"
a
a
a
a
a
a
a
a
a
a
a
a
a
a
a
a
a
"}
