//MAP CONVERTED BY dmm2tgm.py THIS HEADER COMMENT PREVENTS RECONVERSION, DO NOT REMOVE
"a" = (
/turf/closed/wall/halflife/concrete/alt,
/area/halflife/indoors)
"d" = (
/obj/structure/table/halflife/metal/grate,
/turf/open/floor/plating/indoor/concrete/bricks,
/area/halflife/indoors)
"e" = (
/obj/structure/halflife/pallet,
/obj/machinery/light/small/red/directional/east,
/turf/open/floor/plating/indoor/concrete/bricks,
/area/halflife/indoors)
"g" = (
/turf/open/floor/plating/indoor/concrete/bricks,
/area/halflife/indoors)
"h" = (
/obj/structure/window/fulltile/halflife/nosmooth/brick,
/obj/structure/barricade/wooden/crude,
/turf/open/floor/plating/indoor/woodc,
/area/halflife/indoors)
"i" = (
/obj/structure/halflife/storage/large/clothing,
/obj/item/stack/spacecash/c1,
/turf/open/floor/plating/indoor/carpet/green,
/area/halflife/indoors)
"j" = (
/obj/structure/halflife/storage/large/clothing,
/obj/effect/spawner/random/halflife/loot,
/turf/open/floor/plating/indoor/carpet/green,
/area/halflife/indoors)
"l" = (
/obj/structure/table/halflife/metal/grate,
/obj/structure/halflife/trash/cardboard{
	dir = 4
	},
/obj/effect/spawner/random/halflife/loot,
/turf/open/floor/plating/indoor/concrete/bricks,
/area/halflife/indoors)
"m" = (
/turf/open/floor/plating/indoor/carpet/green,
/area/halflife/indoors)
"n" = (
/obj/modular_map_connector,
/turf/template_noop,
/area/template_noop)
"q" = (
/turf/template_noop,
/area/template_noop)
"r" = (
/obj/structure/halflife/trash/books/pile,
/turf/open/floor/plating/indoor/woodc/fancy,
/area/halflife/indoors)
"s" = (
/obj/structure/table/halflife/metal/grate,
/obj/item/stack/spacecash/c1,
/turf/open/floor/plating/indoor/concrete/bricks,
/area/halflife/indoors)
"t" = (
/obj/item/stack/spacecash/c1,
/turf/open/floor/plating/indoor/carpet/green,
/area/halflife/indoors)
"u" = (
/obj/structure/halflife/trash/cardboard{
	dir = 8
	},
/turf/open/floor/plating/indoor/woodc,
/area/halflife/indoors)
"w" = (
/obj/structure/table/halflife/no_smooth/wood,
/obj/item/stack/spacecash/c1{
	amount = 5
	},
/turf/open/floor/plating/indoor/concrete/bricks,
/area/halflife/indoors)
"x" = (
/obj/structure/table/halflife/no_smooth/large/wood/desk{
	dir = 8
	},
/obj/structure/halflife/rug/yellow,
/turf/open/floor/plating/indoor/woodc/fancy,
/area/halflife/indoors)
"z" = (
/obj/machinery/light/small/red/directional/east,
/turf/open/floor/plating/indoor/woodc/fancy,
/area/halflife/indoors)
"B" = (
/obj/machinery/door/unpowered/halflife/metal{
	dir = 8
	},
/turf/open/floor/plating/indoor/woodc/fancy,
/area/halflife/indoors)
"C" = (
/obj/structure/chair/office/halflife/blue{
	dir = 8
	},
/turf/open/floor/plating/indoor/woodc/fancy,
/area/halflife/indoors)
"D" = (
/turf/open/floor/plating/indoor/woodc/fancy,
/area/halflife/indoors)
"F" = (
/obj/effect/spawner/random/halflife/loot,
/turf/open/floor/plating/indoor/carpet/green,
/area/halflife/indoors)
"G" = (
/obj/structure/halflife/trash/cardboard,
/turf/open/floor/plating/indoor/carpet/green,
/area/halflife/indoors)
"J" = (
/obj/structure/halflife/storage/large/clothing,
/turf/open/floor/plating/indoor/concrete/bricks,
/area/halflife/indoors)
"L" = (
/mob/living/basic/halflife/zombie,
/turf/open/floor/plating/indoor/concrete/bricks,
/area/halflife/indoors)
"N" = (
/obj/machinery/light/small/red/directional/west,
/turf/open/floor/plating/indoor/woodc,
/area/halflife/indoors)
"O" = (
/obj/machinery/door/unpowered/halflife/metal,
/turf/open/floor/plating/indoor/concrete/bricks,
/area/halflife/indoors)
"P" = (
/turf/open/floor/plating/indoor/woodc,
/area/halflife/indoors)
"Q" = (
/obj/structure/table/halflife/wood,
/obj/item/stack/spacecash/c1,
/turf/open/floor/plating/indoor/woodc/fancy,
/area/halflife/indoors)
"S" = (
/obj/structure/table/halflife/wood,
/turf/open/floor/plating/indoor/woodc/fancy,
/area/halflife/indoors)
"T" = (
/obj/structure/halflife/pallet/stack,
/turf/open/floor/plating/indoor/concrete/bricks,
/area/halflife/indoors)
"V" = (
/obj/structure/halflife/storage/large/clothing,
/turf/open/floor/plating/indoor/carpet/green,
/area/halflife/indoors)
"W" = (
/obj/structure/halflife/trash/cardboard{
	dir = 4
	},
/turf/open/floor/plating/indoor/carpet/green,
/area/halflife/indoors)
"X" = (
/obj/machinery/light/small/red/directional/east,
/turf/open/floor/plating/indoor/woodc,
/area/halflife/indoors)
"Y" = (
/obj/machinery/door/unpowered/halflife/metal,
/turf/open/floor/plating/indoor/woodc,
/area/halflife/indoors)

(1,1,1) = {"
q
q
q
q
q
q
q
q
q
q
q
q
q
q
q
q
n
"}
(2,1,1) = {"
q
a
a
a
a
a
a
a
a
a
a
a
a
a
a
a
q
"}
(3,1,1) = {"
q
a
a
a
P
P
N
P
P
P
P
P
N
P
P
a
q
"}
(4,1,1) = {"
q
a
a
a
P
j
m
i
m
V
m
i
m
m
P
Y
q
"}
(5,1,1) = {"
q
a
a
a
P
m
m
m
m
m
m
m
G
m
P
a
q
"}
(6,1,1) = {"
q
a
a
a
P
i
m
V
m
V
m
j
m
m
P
a
q
"}
(7,1,1) = {"
q
a
a
a
P
m
m
F
m
m
m
t
m
W
P
a
q
"}
(8,1,1) = {"
q
a
a
a
P
P
P
P
P
P
P
P
P
P
P
a
q
"}
(9,1,1) = {"
q
a
a
a
P
i
m
V
m
i
m
V
m
m
P
h
q
"}
(10,1,1) = {"
q
a
a
a
P
m
m
m
m
F
m
m
m
m
P
h
q
"}
(11,1,1) = {"
q
a
a
a
u
P
X
P
P
P
P
P
P
P
P
a
q
"}
(12,1,1) = {"
q
a
a
a
a
a
a
a
a
a
B
a
a
r
x
a
q
"}
(13,1,1) = {"
q
a
a
a
J
g
l
d
s
a
D
D
D
D
C
a
q
"}
(14,1,1) = {"
q
a
a
a
g
g
L
g
g
O
D
D
D
D
D
a
q
"}
(15,1,1) = {"
q
a
a
a
w
g
e
g
T
a
Q
S
z
Q
Q
a
q
"}
(16,1,1) = {"
q
a
a
a
a
a
a
a
a
a
a
a
a
a
a
a
q
"}
(17,1,1) = {"
q
q
q
q
q
q
q
q
q
q
q
q
q
q
q
q
q
"}
