//MAP CONVERTED BY dmm2tgm.py THIS HEADER COMMENT PREVENTS RECONVERSION, DO NOT REMOVE
"a" = (
/turf/closed/indestructible/rock,
/area/template_noop)
"d" = (
/turf/template_noop,
/area/template_noop)
"i" = (
/turf/closed/wall/halflife/concrete,
/area/template_noop)
"q" = (
/obj/modular_map_connector,
/turf/template_noop,
/area/template_noop)
"y" = (
/turf/closed/wall/halflife/concrete/alt,
/area/template_noop)
"N" = (
/turf/closed/mineral/random,
/area/template_noop)

(1,1,1) = {"
d
d
d
d
d
d
d
d
d
d
d
d
d
d
d
d
d
d
d
d
d
d
d
d
d
d
d
d
d
d
d
d
d
d
d
d
d
d
d
d
d
d
d
d
d
d
d
d
d
d
d
d
d
d
d
d
d
d
d
d
d
q
"}
(2,1,1) = {"
d
N
N
N
N
N
N
N
N
N
N
N
N
N
N
N
N
N
N
N
N
N
N
N
N
N
N
N
N
N
N
N
N
N
N
N
N
N
N
N
N
N
N
N
N
N
N
N
N
N
N
N
N
N
N
N
N
N
N
N
N
d
"}
(3,1,1) = {"
d
N
N
N
N
N
N
N
N
N
N
N
N
N
N
N
N
N
N
N
N
N
N
N
N
N
N
N
N
N
N
N
N
N
N
N
N
N
N
N
N
N
N
N
N
N
N
N
N
N
N
N
N
N
N
N
N
N
N
N
N
d
"}
(4,1,1) = {"
d
N
N
N
N
N
N
N
N
N
N
N
N
N
N
N
N
N
N
N
N
N
N
N
N
N
N
N
N
N
N
N
N
N
N
N
N
N
N
N
N
N
N
N
N
N
N
N
N
N
N
N
N
N
N
N
N
N
N
N
N
d
"}
(5,1,1) = {"
d
N
N
N
N
N
N
N
N
N
N
N
N
N
N
N
N
N
N
N
N
N
N
N
N
N
N
N
N
N
N
N
N
N
N
N
N
N
N
N
N
N
N
N
N
N
N
N
N
N
N
N
N
N
N
N
N
N
N
N
N
d
"}
(6,1,1) = {"
d
N
N
N
N
N
N
N
N
N
N
N
N
N
N
N
N
N
N
N
N
N
N
N
N
N
N
N
N
N
N
N
N
N
N
N
N
N
N
N
N
N
N
N
N
N
N
N
N
N
N
N
N
N
N
N
N
N
N
N
N
d
"}
(7,1,1) = {"
d
N
N
N
N
N
N
N
N
N
N
N
N
N
N
N
N
N
N
N
N
N
N
N
N
N
N
N
N
N
N
N
N
N
N
N
N
N
N
N
N
N
N
N
N
N
N
N
N
N
N
N
N
N
N
N
N
N
N
N
N
d
"}
(8,1,1) = {"
d
N
N
N
N
N
N
N
N
N
N
N
N
N
N
N
N
N
N
N
N
N
N
N
N
N
N
N
N
N
N
N
N
N
N
N
N
N
N
N
N
N
N
N
N
N
N
N
N
N
N
N
N
N
N
N
N
N
N
N
N
d
"}
(9,1,1) = {"
d
N
N
N
N
N
N
N
N
N
N
N
N
N
N
N
N
N
N
N
N
N
N
N
N
N
N
N
N
N
N
N
N
N
N
N
N
N
N
N
N
N
N
N
N
N
N
N
N
N
N
N
N
N
N
N
N
N
N
N
N
d
"}
(10,1,1) = {"
d
N
N
N
N
N
N
N
N
N
N
N
N
N
N
N
N
N
N
N
N
N
N
N
N
N
N
N
N
N
N
N
N
N
N
N
N
N
N
N
N
N
N
N
N
N
N
N
N
N
N
N
N
N
N
N
N
N
N
N
N
d
"}
(11,1,1) = {"
d
N
N
N
N
N
N
N
N
N
N
N
N
N
N
N
N
N
N
N
N
N
N
N
N
N
N
N
N
N
N
N
N
N
N
N
N
N
N
N
N
N
N
N
N
N
N
N
N
N
N
N
N
N
N
N
N
N
N
N
N
d
"}
(12,1,1) = {"
d
N
N
N
N
N
N
N
N
N
N
N
N
N
N
N
N
N
N
N
N
N
N
N
N
N
N
N
N
N
N
N
N
N
N
N
N
N
N
N
N
N
N
N
N
N
N
N
N
N
N
N
N
N
N
N
N
N
N
N
N
d
"}
(13,1,1) = {"
d
N
N
N
N
N
N
N
N
N
N
N
N
N
N
N
a
a
a
a
a
a
a
a
a
a
a
a
a
a
a
a
a
a
a
N
N
N
N
N
N
N
N
N
N
N
N
N
N
N
N
N
N
N
N
N
N
N
N
N
N
d
"}
(14,1,1) = {"
d
N
N
N
N
N
N
N
N
N
N
N
N
N
N
N
a
y
y
y
y
y
y
y
y
y
y
y
y
y
y
y
y
y
a
N
N
N
N
N
N
N
N
N
N
N
N
N
N
N
N
N
N
N
N
N
N
N
N
N
N
d
"}
(15,1,1) = {"
d
N
N
N
N
N
N
N
N
N
N
N
N
N
N
N
a
N
N
N
N
N
N
N
N
N
N
N
N
N
N
N
N
y
a
N
N
N
N
N
N
N
N
N
N
N
N
N
N
N
N
N
N
N
N
N
N
N
N
N
N
d
"}
(16,1,1) = {"
d
N
N
N
N
N
N
N
N
N
N
N
N
N
N
N
a
N
N
N
N
N
N
N
N
N
N
N
N
N
N
N
N
y
a
N
N
N
N
N
N
N
N
N
N
N
N
N
N
N
N
N
N
N
N
N
N
N
N
N
N
d
"}
(17,1,1) = {"
d
N
N
N
N
N
N
N
N
N
N
N
N
N
N
N
a
N
N
N
N
N
N
N
N
N
N
N
N
N
N
N
N
y
a
N
N
N
N
N
N
N
N
N
N
N
N
N
N
N
N
N
N
N
N
N
N
N
N
N
N
d
"}
(18,1,1) = {"
d
N
N
N
N
N
N
N
N
N
N
N
N
N
N
N
a
N
N
N
N
N
N
N
N
N
N
N
N
N
N
N
N
y
a
N
N
N
N
N
N
N
N
N
N
N
N
N
N
N
N
N
N
N
N
N
N
N
N
N
N
d
"}
(19,1,1) = {"
d
N
N
N
N
N
N
N
N
N
N
N
N
N
N
N
a
N
N
N
N
N
i
i
i
i
i
i
N
y
N
N
N
y
a
N
N
N
N
N
N
N
N
N
N
N
N
N
N
N
N
N
N
N
N
N
N
N
N
N
N
d
"}
(20,1,1) = {"
d
N
N
N
N
N
N
N
N
N
N
N
N
N
N
N
a
N
N
N
N
N
N
N
N
N
N
i
N
y
N
N
N
y
a
N
N
N
N
N
N
N
N
N
N
N
N
N
N
N
N
N
N
N
N
N
N
N
N
N
N
d
"}
(21,1,1) = {"
d
N
N
N
N
N
N
N
N
N
N
N
N
N
N
N
a
N
N
N
N
N
N
N
N
N
N
i
N
y
N
N
N
y
a
N
N
N
N
N
N
N
N
N
N
N
N
N
N
N
N
N
N
N
N
N
N
N
N
N
N
d
"}
(22,1,1) = {"
d
N
N
N
N
N
N
N
N
N
N
N
N
N
N
N
a
N
N
N
N
N
N
N
N
N
N
N
N
y
N
N
N
y
a
N
N
N
N
N
N
N
N
N
N
N
N
N
N
N
N
N
N
N
N
N
N
N
N
N
N
d
"}
(23,1,1) = {"
d
N
N
N
N
N
N
N
N
N
N
N
N
N
N
N
a
N
N
N
N
N
N
i
i
i
i
N
N
y
N
N
N
y
a
N
N
N
N
N
N
N
N
N
N
N
N
N
N
N
N
N
N
N
N
N
N
N
N
N
N
d
"}
(24,1,1) = {"
d
N
N
N
N
N
N
N
N
N
N
N
N
N
N
N
a
N
N
N
N
N
i
N
N
N
N
i
N
y
N
N
N
y
a
N
N
N
N
N
N
N
N
N
N
N
N
N
N
N
N
N
N
N
N
N
N
N
N
N
N
d
"}
(25,1,1) = {"
d
N
N
N
N
N
N
N
N
N
N
N
N
N
N
N
a
N
N
N
N
N
N
i
i
i
i
N
N
y
N
N
N
y
a
N
N
N
N
N
N
N
N
N
N
N
N
N
N
N
N
N
N
N
N
N
N
N
N
N
N
d
"}
(26,1,1) = {"
d
N
N
N
N
N
N
N
N
N
N
N
N
N
N
N
a
N
N
N
N
N
N
N
N
N
N
N
N
y
N
N
N
y
a
N
N
N
N
N
N
N
N
N
N
N
N
N
N
N
N
N
N
N
N
N
N
N
N
N
N
d
"}
(27,1,1) = {"
d
N
N
N
N
N
N
N
N
N
N
N
N
N
N
N
a
N
N
N
N
N
N
i
i
i
i
N
N
y
N
N
N
y
a
N
N
N
N
N
N
N
N
N
N
N
N
N
N
N
N
N
N
N
N
N
N
N
N
N
N
d
"}
(28,1,1) = {"
d
N
N
N
N
N
N
N
N
N
N
N
N
N
N
N
a
N
N
N
N
N
i
N
N
N
N
i
N
y
N
N
N
y
a
N
N
N
N
N
N
N
N
N
N
N
N
N
N
N
N
N
N
N
N
N
N
N
N
N
N
d
"}
(29,1,1) = {"
d
N
N
N
N
N
N
N
N
N
N
N
N
N
N
N
a
N
N
N
N
N
N
i
i
i
i
N
N
y
N
N
N
y
a
N
N
N
N
N
N
N
N
N
N
N
N
N
N
N
N
N
N
N
N
N
N
N
N
N
N
d
"}
(30,1,1) = {"
d
N
N
N
N
N
N
N
N
N
N
N
N
N
N
N
a
N
N
N
N
N
N
N
N
N
N
N
N
y
N
N
N
y
a
N
N
N
N
N
N
N
N
N
N
N
N
N
N
N
N
N
N
N
N
N
N
N
N
N
N
d
"}
(31,1,1) = {"
d
N
N
N
N
N
N
N
N
N
N
N
N
N
N
N
a
N
N
N
N
N
i
N
N
N
N
N
N
y
N
N
N
y
a
N
N
N
N
N
N
N
N
N
N
N
N
N
N
N
N
N
N
N
N
N
N
N
N
N
N
d
"}
(32,1,1) = {"
d
N
N
N
N
N
N
N
N
N
N
N
N
N
N
N
a
N
N
N
N
N
i
i
i
i
i
i
N
y
N
N
N
y
a
N
N
N
N
N
N
N
N
N
N
N
N
N
N
N
N
N
N
N
N
N
N
N
N
N
N
d
"}
(33,1,1) = {"
d
N
N
N
N
N
N
N
N
N
N
N
N
N
N
N
a
N
N
N
N
N
i
N
N
N
N
N
N
y
N
N
N
y
a
N
N
N
N
N
N
N
N
N
N
N
N
N
N
N
N
N
N
N
N
N
N
N
N
N
N
d
"}
(34,1,1) = {"
d
N
N
N
N
N
N
N
N
N
N
N
N
N
N
N
a
N
N
N
N
N
N
N
N
N
N
N
N
N
N
N
N
y
a
N
N
N
N
N
N
N
N
N
N
N
N
N
N
N
N
N
N
N
N
N
N
N
N
N
N
d
"}
(35,1,1) = {"
d
N
N
N
N
N
N
N
N
N
N
N
N
N
N
N
a
N
N
N
N
N
N
N
N
N
N
N
N
N
N
N
N
y
a
N
N
N
N
N
N
N
N
N
N
N
N
N
N
N
N
N
N
N
N
N
N
N
N
N
N
d
"}
(36,1,1) = {"
d
N
N
N
N
N
N
N
N
N
N
N
N
N
N
N
a
y
y
y
y
y
y
y
y
y
y
y
y
y
y
y
y
y
a
N
N
N
N
N
N
N
N
N
N
N
N
N
N
N
N
N
N
N
N
N
N
N
N
N
N
d
"}
(37,1,1) = {"
d
N
N
N
N
N
N
N
N
N
N
N
N
N
N
N
a
a
a
a
a
a
a
a
a
a
a
a
a
a
a
a
a
a
a
N
N
N
N
N
N
N
N
N
N
N
N
N
N
N
N
N
N
N
N
N
N
N
N
N
N
d
"}
(38,1,1) = {"
d
N
N
N
N
N
N
N
N
N
N
N
N
N
N
N
N
N
N
N
N
N
N
N
N
N
N
N
N
N
N
N
N
N
N
N
N
N
N
N
N
N
N
N
N
N
N
N
N
N
N
N
N
N
N
N
N
N
N
N
N
d
"}
(39,1,1) = {"
d
N
N
N
N
N
N
N
N
N
N
N
N
N
N
N
N
N
N
N
N
N
N
N
N
N
N
N
N
N
N
N
N
N
N
N
N
N
N
N
N
N
N
N
N
N
N
N
N
N
N
N
N
N
N
N
N
N
N
N
N
d
"}
(40,1,1) = {"
d
N
N
N
N
N
N
N
N
N
N
N
N
N
N
N
N
N
N
N
N
N
N
N
N
N
N
N
N
N
N
N
N
N
N
N
N
N
N
N
N
N
N
N
N
N
N
N
N
N
N
N
N
N
N
N
N
N
N
N
N
d
"}
(41,1,1) = {"
d
N
N
N
N
N
N
N
N
N
N
N
N
N
N
N
N
N
N
N
N
N
N
N
N
N
N
N
N
N
N
N
N
N
N
N
N
N
N
N
N
N
N
N
N
N
N
N
N
N
N
N
N
N
N
N
N
N
N
N
N
d
"}
(42,1,1) = {"
d
N
N
N
N
N
N
N
N
N
N
N
N
N
N
N
N
N
N
N
N
N
N
N
N
N
N
N
N
N
N
N
N
N
N
N
N
N
N
N
N
N
N
N
N
N
N
N
N
N
N
N
N
N
N
N
N
N
N
N
N
d
"}
(43,1,1) = {"
d
N
N
N
N
N
N
N
N
N
N
N
N
N
N
N
N
N
N
N
N
N
N
N
N
N
N
N
N
N
N
N
N
N
N
N
N
N
N
N
N
N
N
N
N
N
N
N
N
N
N
N
N
N
N
N
N
N
N
N
N
d
"}
(44,1,1) = {"
d
N
N
N
N
N
N
N
N
N
N
N
N
N
N
N
N
N
N
N
N
N
N
N
N
N
N
N
N
N
N
N
N
N
N
N
N
N
N
N
N
N
N
N
N
N
N
N
N
N
N
N
N
N
N
N
N
N
N
N
N
d
"}
(45,1,1) = {"
d
N
N
N
N
N
N
N
N
N
N
N
N
N
N
N
N
N
N
N
N
N
N
N
N
N
N
N
N
N
N
N
N
N
N
N
N
N
N
N
N
N
N
N
N
N
N
N
N
N
N
N
N
N
N
N
N
N
N
N
N
d
"}
(46,1,1) = {"
d
N
N
N
N
N
N
N
N
N
N
N
N
N
N
N
N
N
N
N
N
N
N
N
N
N
N
N
N
N
N
N
N
N
N
N
N
N
N
N
N
N
N
N
N
N
N
N
N
N
N
N
N
N
N
N
N
N
N
N
N
d
"}
(47,1,1) = {"
d
N
N
N
N
N
N
N
N
N
N
N
N
N
N
N
N
N
N
N
N
N
N
N
N
N
N
N
N
N
N
N
N
N
N
N
N
N
N
N
N
N
N
N
N
N
N
N
N
N
N
N
N
N
N
N
N
N
N
N
N
d
"}
(48,1,1) = {"
d
N
N
N
N
N
N
N
N
N
N
N
N
N
N
N
N
N
N
N
N
N
N
N
N
N
N
N
N
N
N
N
N
N
N
N
N
N
N
N
N
N
N
N
N
N
N
N
N
N
N
N
N
N
N
N
N
N
N
N
N
d
"}
(49,1,1) = {"
d
N
N
N
N
N
N
N
N
N
N
N
N
N
N
N
N
N
N
N
N
N
N
N
N
N
N
N
N
N
N
N
N
N
N
N
N
N
N
N
N
N
N
N
N
N
N
N
N
N
N
N
N
N
N
N
N
N
N
N
N
d
"}
(50,1,1) = {"
d
N
N
N
N
N
N
N
N
N
N
N
N
N
N
N
N
N
N
N
N
N
N
N
N
N
N
N
N
N
N
N
N
N
N
N
N
N
N
N
N
N
N
N
N
N
N
N
N
N
N
N
N
N
N
N
N
N
N
N
N
d
"}
(51,1,1) = {"
d
N
N
N
N
N
N
N
N
N
N
N
N
N
N
N
N
N
N
N
N
N
N
N
N
N
N
N
N
N
N
N
N
N
N
N
N
N
N
N
N
N
N
N
N
N
N
N
N
N
N
N
N
N
N
N
N
N
N
N
N
d
"}
(52,1,1) = {"
d
N
N
N
N
N
N
N
N
N
N
N
N
N
N
N
N
N
N
N
N
N
N
N
N
N
N
N
N
N
N
N
N
N
N
N
N
N
N
N
N
N
N
N
N
N
N
N
N
N
N
N
N
N
N
N
N
N
N
N
N
d
"}
(53,1,1) = {"
d
N
N
N
N
N
N
N
N
N
N
N
N
N
N
N
N
N
N
N
N
N
N
N
N
N
N
N
N
N
N
N
N
N
N
N
N
N
N
N
N
N
N
N
N
N
N
N
N
N
N
N
N
N
N
N
N
N
N
N
N
d
"}
(54,1,1) = {"
d
N
N
N
N
N
N
N
N
N
N
N
N
N
N
N
N
N
N
N
N
N
N
N
N
N
N
N
N
N
N
N
N
N
N
N
N
N
N
N
N
N
N
N
N
N
N
N
N
N
N
N
N
N
N
N
N
N
N
N
N
d
"}
(55,1,1) = {"
d
N
N
N
N
N
N
N
N
N
N
N
N
N
N
N
N
N
N
N
N
N
N
N
N
N
N
N
N
N
N
N
N
N
N
N
N
N
N
N
N
N
N
N
N
N
N
N
N
N
N
N
N
N
N
N
N
N
N
N
N
d
"}
(56,1,1) = {"
d
N
N
N
N
N
N
N
N
N
N
N
N
N
N
N
N
N
N
N
N
N
N
N
N
N
N
N
N
N
N
N
N
N
N
N
N
N
N
N
N
N
N
N
N
N
N
N
N
N
N
N
N
N
N
N
N
N
N
N
N
d
"}
(57,1,1) = {"
d
N
N
N
N
N
N
N
N
N
N
N
N
N
N
N
N
N
N
N
N
N
N
N
N
N
N
N
N
N
N
N
N
N
N
N
N
N
N
N
N
N
N
N
N
N
N
N
N
N
N
N
N
N
N
N
N
N
N
N
N
d
"}
(58,1,1) = {"
d
N
N
N
N
N
N
N
N
N
N
N
N
N
N
N
N
N
N
N
N
N
N
N
N
N
N
N
N
N
N
N
N
N
N
N
N
N
N
N
N
N
N
N
N
N
N
N
N
N
N
N
N
N
N
N
N
N
N
N
N
d
"}
(59,1,1) = {"
d
N
N
N
N
N
N
N
N
N
N
N
N
N
N
N
N
N
N
N
N
N
N
N
N
N
N
N
N
N
N
N
N
N
N
N
N
N
N
N
N
N
N
N
N
N
N
N
N
N
N
N
N
N
N
N
N
N
N
N
N
d
"}
(60,1,1) = {"
d
N
N
N
N
N
N
N
N
N
N
N
N
N
N
N
N
N
N
N
N
N
N
N
N
N
N
N
N
N
N
N
N
N
N
N
N
N
N
N
N
N
N
N
N
N
N
N
N
N
N
N
N
N
N
N
N
N
N
N
N
d
"}
(61,1,1) = {"
d
N
N
N
N
N
N
N
N
N
N
N
N
N
N
N
N
N
N
N
N
N
N
N
N
N
N
N
N
N
N
N
N
N
N
N
N
N
N
N
N
N
N
N
N
N
N
N
N
N
N
N
N
N
N
N
N
N
N
N
N
d
"}
(62,1,1) = {"
d
d
d
d
d
d
d
d
d
d
d
d
d
d
d
d
d
d
d
d
d
d
d
d
d
d
d
d
d
d
d
d
d
d
d
d
d
d
d
d
d
d
d
d
d
d
d
d
d
d
d
d
d
d
d
d
d
d
d
d
d
d
"}
