//MAP CONVERTED BY dmm2tgm.py THIS HEADER COMMENT PREVENTS RECONVERSION, DO NOT REMOVE
"aA" = (
/obj/structure/closet/crate/halflife,
/obj/item/stack/sheet/halflife/plastic,
/obj/item/stack/sheet/halflife/plastic,
/obj/item/stack/sheet/halflife/plastic,
/turf/open/floor/plating/indoor/concrete/small,
/area/template_noop)
"bl" = (
/obj/structure/halflife/storage/shelf,
/obj/item/gun/ballistic/shotgun/antixen/mining{
	pixel_y = 20;
	pixel_x = 0
	},
/obj/item/gun/ballistic/shotgun/antixen/mining,
/turf/open/floor/plating/indoor/concrete/small,
/area/template_noop)
"ce" = (
/obj/structure/cable,
/turf/open/floor/plating/indoor/metal/grate/border,
/area/template_noop)
"cx" = (
/obj/structure/table/halflife/metal/grate,
/obj/structure/rustic_extractor,
/turf/open/floor/plating/indoor/tile/green,
/area/template_noop)
"dj" = (
/obj/machinery/microwave{
	pixel_y = 4
	},
/turf/open/floor/plating/indoor/tile/kitchen,
/area/template_noop)
"dr" = (
/obj/machinery/hydroponics/constructable{
	dir = 4
	},
/turf/open/floor/plating/indoor/tile/navy,
/area/template_noop)
"eE" = (
/obj/structure/chair/halflife/metal/folding{
	dir = 1
	},
/turf/open/floor/plating/indoor/cafeteria,
/area/template_noop)
"eF" = (
/obj/structure/table/halflife/metal/grate,
/turf/open/floor/plating/indoor/concrete,
/area/template_noop)
"fj" = (
/obj/structure/closet/secure_closet/freezer/halflife,
/obj/item/food/grown/potato,
/obj/item/food/grown/potato,
/obj/item/food/grown/cabbage,
/obj/item/food/grown/carrot,
/obj/item/food/grown/carrot,
/obj/item/food/grown/tomato,
/obj/item/food/grown/onion,
/obj/item/food/grown/onion,
/turf/open/floor/plating/indoor/tile/kitchen,
/area/template_noop)
"fn" = (
/turf/open/floor/plating/indoor/concrete/bricks,
/area/template_noop)
"fD" = (
/obj/structure/table/halflife/metal,
/turf/open/floor/plating/indoor/cafeteria,
/area/template_noop)
"fH" = (
/obj/structure/table/halflife/metal,
/obj/structure/halflife/rug/rubber,
/turf/open/floor/plating/indoor/tile/kitchen,
/area/template_noop)
"fM" = (
/obj/structure/chair/halflife/metal/folding,
/turf/open/floor/plating/indoor/cafeteria,
/area/template_noop)
"gz" = (
/turf/open/floor/plating/indoor/tile/black,
/area/template_noop)
"gG" = (
/obj/structure/window/fulltile/halflife/nosmooth/reinforced,
/turf/open/floor/plating/indoor/concrete/bricks,
/area/template_noop)
"gY" = (
/obj/structure/railing/halflife/sewer{
	dir = 8
	},
/obj/structure/cable,
/turf/open/floor/plating/indoor/metal/grate/border/warning,
/area/template_noop)
"hb" = (
/obj/machinery/griddle,
/turf/open/floor/plating/indoor/tile/kitchen,
/area/template_noop)
"hn" = (
/obj/structure/reagent_dispensers/watertank,
/turf/open/floor/plating/indoor/tile/green,
/area/template_noop)
"hp" = (
/obj/structure/halflife/tank/chemical/container/fuel,
/turf/open/floor/plating/indoor/concrete/small,
/area/template_noop)
"hw" = (
/obj/machinery/door/unpowered/halflife/metal/red{
	keylock = 1;
	locked = 1;
	lockid = "rebel"
	},
/turf/open/floor/plating/indoor/concrete/bricks,
/area/template_noop)
"hB" = (
/obj/machinery/atm,
/turf/open/floor/plating/indoor/concrete,
/area/template_noop)
"hV" = (
/obj/structure/halflife/rug/rubber,
/turf/open/floor/plating/indoor/tile/kitchen,
/area/template_noop)
"hW" = (
/turf/open/floor/plating/indoor/woodc/fancy,
/area/template_noop)
"ip" = (
/obj/structure/closet/crate/halflife,
/obj/item/reagent_containers/cup/bucket,
/obj/item/reagent_containers/cup/bucket,
/obj/item/cultivator,
/obj/item/cultivator,
/obj/item/shovel/spade,
/obj/item/shovel/spade,
/obj/item/hatchet/wooden,
/obj/item/hatchet/wooden,
/obj/item/reagent_containers/cup/bottle/nutrient/ez,
/obj/item/reagent_containers/cup/bottle/nutrient/ez,
/turf/open/floor/plating/indoor/tile/green,
/area/template_noop)
"iS" = (
/obj/structure/closet/halflife,
/turf/open/floor/plating/indoor/metal/grate,
/area/template_noop)
"jg" = (
/obj/structure/halflife/storage/large/shelf,
/obj/effect/spawner/random/halflife/loot,
/turf/open/floor/plating/indoor/concrete/small,
/area/template_noop)
"jK" = (
/obj/structure/table/halflife/no_smooth/large/crafting/ammobench,
/turf/open/floor/plating/indoor/concrete/small,
/area/template_noop)
"kw" = (
/obj/structure/chair/halflife/metal/folding{
	dir = 4
	},
/turf/open/floor/plating/indoor/concrete/bricks,
/area/template_noop)
"kI" = (
/obj/structure/closet/crate/halflife,
/obj/item/reagent_containers/cup/glass/waterbottle/large,
/obj/item/reagent_containers/cup/glass/waterbottle/large,
/obj/item/reagent_containers/cup/glass/waterbottle/large,
/turf/open/floor/plating/indoor/tile/kitchen,
/area/template_noop)
"le" = (
/obj/structure/window/fulltile/halflife/nosmooth/brick,
/turf/open/floor/plating/indoor/tile/green,
/area/template_noop)
"lM" = (
/obj/structure/table/halflife/metal,
/turf/open/floor/plating/indoor/tile/kitchen,
/area/template_noop)
"mp" = (
/obj/machinery/door/unpowered/halflife/seethrough/grate,
/turf/open/floor/plating/indoor/concrete/bricks,
/area/template_noop)
"my" = (
/obj/machinery/button/door{
	id = "rebel_bunker_entrance_west";
	pixel_y = 9;
	name = "west shutters"
	},
/obj/machinery/button/door{
	id = "rebel_bunker_entrance_east";
	pixel_y = 0;
	pixel_x = 0;
	name = "east shutters"
	},
/turf/open/floor/plating/indoor/tile/black,
/area/template_noop)
"om" = (
/obj/machinery/vending/hydroseeds,
/turf/open/floor/plating/indoor/tile/green,
/area/template_noop)
"oY" = (
/obj/machinery/biogenerator,
/turf/open/floor/plating/indoor/tile/green,
/area/template_noop)
"pb" = (
/obj/structure/cable,
/turf/open/floor/plating/indoor/tile/black,
/area/template_noop)
"pR" = (
/obj/machinery/door/unpowered/halflife/seethrough/grate,
/turf/open/floor/plating/indoor/tile/black,
/area/template_noop)
"qf" = (
/turf/open/floor/plating/indoor/cafeteria,
/area/template_noop)
"qp" = (
/obj/modular_map_connector,
/turf/template_noop,
/area/template_noop)
"qA" = (
/obj/machinery/door/unpowered/halflife/seethrough/metal,
/turf/open/floor/plating/indoor/tile/green,
/area/template_noop)
"rj" = (
/turf/open/floor/plating/indoor/concrete/small,
/area/template_noop)
"rv" = (
/obj/machinery/door/unpowered/halflife/metal/red{
	keylock = 1;
	lockid = "rebel"
	},
/turf/open/floor/plating/indoor/tile/black,
/area/template_noop)
"ry" = (
/obj/structure/table/halflife/no_smooth/large/crafting/weaponbench,
/turf/open/floor/plating/indoor/concrete/small,
/area/template_noop)
"rD" = (
/obj/machinery/atm,
/turf/open/floor/plating/indoor/cafeteria,
/area/template_noop)
"rI" = (
/obj/structure/table/halflife/no_smooth/large/metal,
/turf/open/floor/plating/indoor/cafeteria,
/area/template_noop)
"sw" = (
/turf/open/floor/plating/ground/rockunder,
/area/template_noop)
"tg" = (
/obj/structure/chair/halflife/metal/folding{
	dir = 1
	},
/turf/open/floor/plating/indoor/concrete/bricks,
/area/template_noop)
"tC" = (
/obj/structure/table/halflife/no_smooth/large/metal/desk{
	dir = 1
	},
/turf/open/floor/plating/indoor/concrete/bricks,
/area/template_noop)
"um" = (
/obj/structure/halflife/storage/large/shelf,
/obj/item/pickaxe,
/obj/item/pickaxe,
/obj/item/pickaxe,
/turf/open/floor/plating/indoor/concrete/small,
/area/template_noop)
"uB" = (
/turf/open/floor/plating/indoor/woodc,
/area/template_noop)
"va" = (
/turf/open/floor/plating/indoor/tile/kitchen,
/area/template_noop)
"vY" = (
/turf/open/floor/plating/indoor/concrete,
/area/template_noop)
"wh" = (
/obj/structure/chair/halflife/metal/blue{
	dir = 4
	},
/obj/machinery/light/small/directional/west,
/turf/open/floor/plating/indoor/tile/green,
/area/template_noop)
"wR" = (
/turf/open/floor/plating/indoor/metal/grate/border,
/area/template_noop)
"xk" = (
/obj/machinery/vending/hydronutrients,
/turf/open/floor/plating/indoor/tile/green,
/area/template_noop)
"xw" = (
/turf/open/floor/plating/indoor/lino,
/area/template_noop)
"xJ" = (
/obj/structure/closet/crate/halflife,
/obj/item/stack/sheet/scrap_copper,
/obj/item/stack/sheet/scrap_copper,
/turf/open/floor/plating/indoor/concrete/small,
/area/template_noop)
"yh" = (
/obj/structure/closet/crate/halflife,
/obj/item/stack/sheet/iron/ten,
/turf/open/floor/plating/indoor/concrete/small,
/area/template_noop)
"zc" = (
/obj/structure/railing/halflife/sewer{
	dir = 4
	},
/turf/open/floor/plating/indoor/metal/grate/border/warning,
/area/template_noop)
"zp" = (
/obj/structure/table/halflife/metal/alt,
/turf/open/floor/plating/indoor/concrete/bricks,
/area/template_noop)
"zs" = (
/obj/effect/spawner/random/halflife/loot,
/turf/open/floor/plating/indoor/concrete/small,
/area/template_noop)
"zC" = (
/obj/structure/table/halflife/metal/grate,
/turf/open/floor/plating/indoor/concrete/bricks,
/area/template_noop)
"Ah" = (
/obj/machinery/door/poddoor{
	id = "bunker_engineer_exit"
	},
/turf/open/floor/plating/indoor/tile/black,
/area/template_noop)
"Ai" = (
/obj/structure/sink/halflife/clean,
/turf/open/floor/plating/indoor/tile/green,
/area/template_noop)
"Bd" = (
/obj/machinery/deepfryer,
/turf/open/floor/plating/indoor/tile/kitchen,
/area/template_noop)
"Bf" = (
/turf/open/floor/plating/indoor/tile/green,
/area/template_noop)
"Bg" = (
/obj/structure/cable,
/turf/open/floor/plating/indoor/metal/grate/border/warning{
	dir = 1
	},
/area/template_noop)
"Bu" = (
/obj/structure/weightmachine/weightlifter,
/turf/open/floor/plating/indoor/concrete/bricks,
/area/template_noop)
"Bv" = (
/obj/structure/cable,
/turf/open/floor/plating/indoor/metal/grate,
/area/template_noop)
"By" = (
/turf/open/floor/plating/indoor/woodc/mosaic,
/area/template_noop)
"Ch" = (
/obj/structure/chair/office/halflife/blue,
/turf/open/floor/plating/indoor/concrete/bricks,
/area/template_noop)
"CF" = (
/obj/structure/weightmachine,
/turf/open/floor/plating/indoor/concrete/bricks,
/area/template_noop)
"Eh" = (
/obj/structure/table/halflife/metal/grate,
/turf/open/floor/plating/indoor/cafeteria,
/area/template_noop)
"Es" = (
/obj/structure/closet/crate/halflife,
/turf/open/floor/plating/indoor/tile/kitchen,
/area/template_noop)
"Fp" = (
/turf/closed/indestructible/rock,
/area/template_noop)
"FQ" = (
/obj/machinery/door/unpowered/halflife/metal/red{
	keylock = 1;
	lockid = "rebel"
	},
/turf/open/floor/plating/indoor/lino,
/area/template_noop)
"FY" = (
/obj/structure/closet/crate/halflife/wooden,
/turf/open/floor/plating/indoor/concrete/small,
/area/template_noop)
"Gl" = (
/obj/machinery/door/unpowered/halflife/seethrough/metal{
	keylock = 1;
	lockid = "kitchen";
	dir = 8
	},
/turf/open/floor/plating/indoor/cafeteria,
/area/template_noop)
"GD" = (
/obj/machinery/light/small/directional/north,
/turf/open/floor/plating/indoor/lino,
/area/template_noop)
"Hd" = (
/obj/structure/table/halflife/no_smooth/large/crafting/workbench,
/turf/open/floor/plating/indoor/concrete/small,
/area/template_noop)
"HM" = (
/obj/machinery/door/poddoor/shutters{
	id = "rebel_bunker_entrance_west";
	dir = 8
	},
/turf/open/floor/plating/indoor/concrete/bricks,
/area/template_noop)
"Ih" = (
/obj/structure/closet/crate/halflife,
/turf/open/floor/plating/indoor/concrete/small,
/area/template_noop)
"Ir" = (
/turf/open/floor/plating/indoor/metal/grate/border/warning,
/area/template_noop)
"It" = (
/obj/structure/closet/crate/halflife,
/obj/item/fuel_cell/full,
/obj/item/fuel_cell/full,
/obj/item/fuel_cell/high,
/obj/item/fuel_cell/high,
/obj/item/fuel_cell/random,
/obj/item/fuel_cell/random,
/obj/item/fuel_cell/random,
/obj/item/crowbar,
/turf/open/floor/plating/indoor/metal/grate,
/area/template_noop)
"IT" = (
/obj/structure/sink/halflife{
	pixel_y = 8
	},
/obj/structure/mirror/halflife{
	pixel_y = 32
	},
/turf/open/floor/plating/indoor/lino,
/area/template_noop)
"IX" = (
/obj/structure/table/halflife/metal/alt,
/obj/item/dice{
	pixel_x = -6;
	pixel_y = 3
	},
/obj/item/dice{
	pixel_x = 5;
	pixel_y = 1
	},
/obj/item/dice{
	pixel_x = -3;
	pixel_y = 4
	},
/obj/item/dice{
	pixel_x = 5;
	pixel_y = 10
	},
/obj/item/dice{
	pixel_x = -8;
	pixel_y = 10
	},
/turf/open/floor/plating/indoor/concrete/bricks,
/area/template_noop)
"Jn" = (
/obj/item/clothing/mask/gas/hl2/military,
/obj/item/clothing/mask/gas/hl2/military,
/turf/open/floor/plating/indoor/concrete/small,
/area/template_noop)
"Kp" = (
/obj/structure/chair/halflife/metal/folding{
	dir = 8
	},
/turf/open/floor/plating/indoor/concrete/bricks,
/area/template_noop)
"La" = (
/obj/structure/table/halflife/no_smooth/large/crafting/armorbench,
/turf/open/floor/plating/indoor/concrete/small,
/area/template_noop)
"LK" = (
/obj/structure/table/halflife/no_smooth/cable_reel,
/turf/open/floor/plating/indoor/concrete/small,
/area/template_noop)
"MP" = (
/obj/structure/halflife/storage/shelf,
/obj/item/ammo_casing/shotgun/mining{
	pixel_x = 10;
	pixel_y = 20
	},
/obj/item/ammo_casing/shotgun/mining{
	pixel_x = 4;
	pixel_y = 20
	},
/obj/item/ammo_casing/shotgun/mining{
	pixel_x = -2;
	pixel_y = 20
	},
/obj/item/ammo_casing/shotgun/mining{
	pixel_x = -8;
	pixel_y = 20
	},
/obj/item/ammo_casing/shotgun/mining{
	pixel_x = 9;
	pixel_y = 0
	},
/obj/item/ammo_casing/shotgun/mining{
	pixel_x = 3;
	pixel_y = 0
	},
/obj/item/ammo_casing/shotgun/mining{
	pixel_x = -4;
	pixel_y = 0
	},
/obj/item/ammo_casing/shotgun/mining{
	pixel_x = -9;
	pixel_y = 0
	},
/turf/open/floor/plating/indoor/concrete,
/area/template_noop)
"Nj" = (
/obj/machinery/porta_turret/combine/rebel{
	anchored = 1;
	dir = 1
	},
/turf/open/floor/plating/indoor/concrete/bricks,
/area/template_noop)
"Nt" = (
/obj/machinery/door/poddoor/shutters{
	id = "rebel_bunker_entrance_east";
	dir = 4
	},
/turf/open/floor/plating/indoor/concrete/bricks,
/area/template_noop)
"Nz" = (
/obj/structure/halflife/storage/large/shelf,
/turf/open/floor/plating/indoor/concrete/small,
/area/template_noop)
"NY" = (
/obj/structure/halflife/toilet{
	pixel_y = 8
	},
/turf/open/floor/plating/indoor/lino,
/area/template_noop)
"Oe" = (
/obj/structure/table/halflife/no_smooth/large/crafting/tinkerbench,
/turf/open/floor/plating/indoor/concrete/small,
/area/template_noop)
"Ot" = (
/obj/structure/table/halflife/metal/heavy,
/obj/machinery/mill,
/turf/open/floor/plating/indoor/concrete/bricks,
/area/template_noop)
"Pa" = (
/obj/machinery/door/unpowered/halflife/metal/red{
	keylock = 1;
	lockid = "rebel"
	},
/turf/open/floor/plating/indoor/woodc/mosaic,
/area/template_noop)
"Ph" = (
/obj/structure/kitchenspike,
/turf/open/floor/plating/indoor/tile/kitchen,
/area/template_noop)
"Pi" = (
/turf/open/floor/plating/indoor/metal/grate,
/area/template_noop)
"PE" = (
/obj/structure/closet/crate/halflife,
/obj/item/food/canned/halflife/beans,
/obj/item/food/canned/halflife/seafood,
/turf/open/floor/plating/indoor/tile/kitchen,
/area/template_noop)
"Qx" = (
/obj/structure/closet/secure_closet/freezer/halflife,
/obj/item/food/meat/slab,
/obj/item/food/meat/slab,
/obj/item/food/meat/slab/chicken,
/obj/item/food/meat/slab/chicken,
/obj/item/food/meat/slab/xen,
/obj/item/food/meat/slab/xen,
/turf/open/floor/plating/indoor/tile/kitchen,
/area/template_noop)
"QQ" = (
/obj/machinery/power/fusion_engine,
/obj/structure/cable,
/turf/open/floor/plating/indoor/metal/grate/border,
/area/template_noop)
"QV" = (
/turf/open/floor/plating/indoor/sterilesquares,
/area/template_noop)
"Rq" = (
/obj/structure/barricade/sandbags,
/turf/open/floor/plating/indoor/concrete/bricks,
/area/template_noop)
"Sm" = (
/obj/structure/table/halflife/no_smooth/large/metal,
/obj/machinery/reagentgrinder{
	pixel_x = 4;
	pixel_y = 14
	},
/turf/open/floor/plating/indoor/tile/kitchen,
/area/template_noop)
"So" = (
/turf/template_noop,
/area/template_noop)
"Sw" = (
/obj/structure/bed/halflife/bedframe/cot,
/turf/open/floor/plating/indoor/tile/black,
/area/template_noop)
"SI" = (
/obj/machinery/button/door{
	id = "bunker_engineer_exit";
	pixel_y = 28;
	name = "engineering emergency exit blastdoor"
	},
/turf/open/floor/plating/indoor/woodc/fancy,
/area/template_noop)
"SN" = (
/obj/structure/table/halflife/metal/grate,
/turf/open/floor/plating/indoor/concrete/small,
/area/template_noop)
"SR" = (
/turf/closed/wall/halflife/concrete/bunker,
/area/template_noop)
"TQ" = (
/obj/machinery/washing_machine,
/turf/open/floor/plating/indoor/concrete/bricks,
/area/template_noop)
"Ua" = (
/obj/structure/table/halflife/metal/alt,
/obj/item/toy/cards/deck{
	pixel_x = 5;
	pixel_y = 3
	},
/obj/item/toy/cards/deck{
	pixel_x = -3;
	pixel_y = 11
	},
/turf/open/floor/plating/indoor/concrete/bricks,
/area/template_noop)
"Up" = (
/obj/structure/chair/halflife/metal/folding,
/turf/open/floor/plating/indoor/concrete/bricks,
/area/template_noop)
"UH" = (
/obj/machinery/press,
/obj/structure/table/halflife/metal/heavy,
/turf/open/floor/plating/indoor/concrete/bricks,
/area/template_noop)
"Vv" = (
/obj/structure/railing/halflife/sewer,
/obj/structure/railing/halflife/sewer{
	dir = 1
	},
/turf/open/floor/plating/indoor/metal/pipe,
/area/template_noop)
"Xc" = (
/obj/machinery/door/unpowered/halflife/metal{
	keylock = 1;
	locked = 1;
	lockid = "kitchen"
	},
/turf/open/floor/plating/indoor/tile/kitchen,
/area/template_noop)
"Xq" = (
/obj/structure/halflife/storage/large/shelf,
/obj/effect/spawner/random/halflife/loot,
/obj/effect/spawner/random/halflife/loot,
/turf/open/floor/plating/indoor/concrete/small,
/area/template_noop)
"Yy" = (
/obj/machinery/oven/range,
/turf/open/floor/plating/indoor/tile/kitchen,
/area/template_noop)

(1,1,1) = {"
So
So
So
So
So
So
So
So
So
So
So
So
So
So
So
So
So
So
So
So
So
So
So
So
So
So
So
So
So
So
So
So
So
So
So
So
So
So
So
So
So
So
So
So
So
So
So
So
So
So
So
So
So
So
So
So
So
So
So
So
So
qp
"}
(2,1,1) = {"
So
Fp
Fp
Fp
Fp
Fp
Fp
Fp
Fp
Fp
Fp
Fp
Fp
Fp
Fp
Fp
Fp
Fp
Fp
Fp
Fp
Fp
Fp
Fp
Fp
Fp
Fp
Fp
Fp
Fp
Fp
Fp
Fp
Fp
Fp
Fp
Fp
Fp
Fp
Fp
Fp
Fp
Fp
Fp
Fp
Fp
Fp
Fp
Fp
Fp
Fp
Fp
Fp
Fp
Fp
Fp
Fp
Fp
Fp
Fp
Fp
So
"}
(3,1,1) = {"
So
Fp
Fp
Fp
Fp
Fp
Fp
Fp
Fp
Fp
Fp
Fp
Fp
Fp
Fp
Fp
Fp
Fp
Fp
Fp
Fp
Fp
Fp
Fp
Fp
Fp
Fp
Fp
Fp
Fp
Fp
Fp
Fp
Fp
Fp
Fp
Fp
Fp
Fp
Fp
Fp
Fp
Fp
Fp
Fp
Fp
Fp
Fp
Fp
Fp
Fp
Fp
Fp
Fp
Fp
Fp
Fp
Fp
Fp
Fp
Fp
So
"}
(4,1,1) = {"
So
Fp
Fp
Fp
Fp
Fp
Fp
Fp
Fp
Fp
Fp
Fp
Fp
Fp
Fp
Fp
Fp
Fp
Fp
Fp
Fp
Fp
Fp
Fp
Fp
Fp
Fp
Fp
Fp
Fp
Fp
Fp
sw
sw
Fp
Fp
Fp
Fp
Fp
Fp
Fp
Fp
Fp
Fp
Fp
Fp
Fp
Fp
Fp
Fp
Fp
Fp
Fp
Fp
Fp
Fp
Fp
Fp
Fp
Fp
Fp
So
"}
(5,1,1) = {"
So
Fp
Fp
Fp
Fp
Fp
Fp
Fp
Fp
Fp
Fp
Fp
Fp
Fp
Fp
Fp
Fp
Fp
Fp
Fp
Fp
Fp
Fp
Fp
Fp
Fp
Fp
Fp
Fp
Fp
Fp
Fp
Fp
sw
sw
Fp
Fp
Fp
Fp
Fp
Fp
Fp
Fp
Fp
Fp
Fp
Fp
Fp
Fp
Fp
Fp
Fp
Fp
Fp
Fp
Fp
Fp
Fp
Fp
Fp
Fp
So
"}
(6,1,1) = {"
So
Fp
Fp
Fp
Fp
Fp
Fp
Fp
Fp
Fp
Fp
Fp
Fp
Fp
Fp
Fp
Fp
Fp
Fp
Fp
Fp
Fp
Fp
Fp
Fp
Fp
Fp
Fp
Fp
Fp
Fp
Fp
Fp
sw
Fp
Fp
Fp
Fp
Fp
Fp
Fp
Fp
Fp
Fp
Fp
Fp
Fp
Fp
Fp
Fp
Fp
Fp
Fp
Fp
Fp
Fp
Fp
Fp
Fp
Fp
Fp
So
"}
(7,1,1) = {"
So
Fp
Fp
Fp
Fp
Fp
Fp
Fp
Fp
Fp
Fp
Fp
Fp
Fp
Fp
Fp
Fp
Fp
Fp
Fp
Fp
Fp
Fp
Fp
Fp
Fp
Fp
Fp
Fp
Fp
Fp
Fp
sw
sw
Fp
Fp
Fp
Fp
Fp
Fp
Fp
Fp
Fp
Fp
Fp
Fp
Fp
Fp
Fp
Fp
Fp
Fp
Fp
Fp
Fp
Fp
Fp
Fp
Fp
Fp
Fp
So
"}
(8,1,1) = {"
So
Fp
Fp
Fp
Fp
Fp
Fp
Fp
Fp
Fp
Fp
Fp
Fp
Fp
Fp
Fp
Fp
Fp
SR
SR
SR
SR
SR
Fp
Fp
Fp
Fp
Fp
Fp
Fp
Fp
Fp
sw
sw
sw
Fp
Fp
Fp
Fp
Fp
Fp
Fp
Fp
Fp
Fp
Fp
Fp
Fp
Fp
Fp
Fp
Fp
Fp
Fp
Fp
Fp
Fp
Fp
Fp
Fp
Fp
So
"}
(9,1,1) = {"
So
Fp
Fp
Fp
Fp
Fp
Fp
Fp
Fp
Fp
Fp
Fp
Fp
Fp
Fp
SR
SR
SR
SR
TQ
zC
TQ
SR
SR
SR
SR
Fp
Fp
Fp
Fp
Fp
Fp
Fp
sw
sw
Fp
Fp
Fp
Fp
Fp
Fp
Fp
Fp
Fp
Fp
Fp
Fp
Fp
Fp
Fp
Fp
Fp
Fp
Fp
Fp
Fp
Fp
Fp
Fp
Fp
Fp
So
"}
(10,1,1) = {"
So
Fp
Fp
Fp
Fp
Fp
Fp
Fp
Fp
Fp
Fp
Fp
Fp
Fp
Fp
SR
NY
xw
SR
fn
fn
fn
SR
xw
xw
SR
Fp
Fp
Fp
Fp
Fp
Fp
Fp
Fp
sw
sw
Fp
Fp
Fp
Fp
Fp
Fp
Fp
Fp
Fp
Fp
Fp
Fp
Fp
Fp
Fp
Fp
Fp
Fp
SR
SR
SR
SR
SR
Fp
Fp
So
"}
(11,1,1) = {"
So
Fp
Fp
Fp
Fp
Fp
Fp
Fp
Fp
Fp
Fp
Fp
Fp
Fp
Fp
SR
GD
xw
FQ
fn
fn
fn
FQ
xw
xw
SR
Fp
Fp
Fp
Fp
Fp
sw
sw
sw
sw
sw
Fp
Fp
Fp
Fp
Fp
Fp
Fp
Fp
Fp
Fp
Fp
Fp
Fp
Fp
Fp
Fp
Fp
Fp
SR
Pi
Pi
Pi
SR
Fp
Fp
So
"}
(12,1,1) = {"
So
Fp
Fp
Fp
Fp
Fp
Fp
Fp
Fp
Fp
Fp
Fp
Fp
Fp
Fp
SR
IT
xw
SR
fn
fn
fn
SR
xw
xw
SR
Fp
Fp
Fp
Fp
Fp
Fp
sw
sw
sw
sw
sw
Fp
Fp
Fp
Fp
Fp
Fp
Fp
Fp
Fp
Fp
Fp
Fp
Fp
Fp
Fp
Fp
Fp
SR
Pi
Pi
Pi
SR
Fp
Fp
So
"}
(13,1,1) = {"
So
Fp
Fp
Fp
Fp
Fp
Fp
Fp
Fp
Fp
SR
SR
SR
SR
SR
SR
SR
SR
SR
SR
fn
SR
SR
SR
SR
SR
SR
SR
SR
SR
SR
SR
SR
HM
HM
HM
SR
SR
SR
SR
SR
SR
SR
SR
SR
SR
SR
SR
SR
SR
SR
SR
SR
SR
SR
SR
SR
Pi
SR
Fp
Fp
So
"}
(14,1,1) = {"
So
Fp
Fp
Fp
Fp
Fp
Fp
Fp
Fp
Fp
SR
Pi
SR
Sw
gz
gz
SR
vY
vY
vY
fn
vY
vY
SR
gz
gz
Sw
SR
fn
fn
tC
SR
fn
fn
fn
fn
Rq
Nj
SR
Bv
Bv
Bv
Bv
Bv
Bv
Bv
Bv
Bv
Bv
Bv
Bv
Bv
Bv
Bv
Bv
Bv
Bv
Bv
SR
Fp
Fp
So
"}
(15,1,1) = {"
So
Fp
Fp
Fp
Fp
Fp
Fp
Fp
Fp
Fp
SR
Pi
SR
gz
gz
gz
rv
vY
fn
fn
fn
fn
vY
rv
gz
gz
gz
SR
fn
Ch
my
gG
fn
fn
fn
fn
Rq
fn
SR
Bv
SR
SR
SR
SR
SR
SR
SR
SR
SR
SR
SR
SR
SR
SR
SR
SR
SR
Bv
SR
Fp
Fp
So
"}
(16,1,1) = {"
So
Fp
Fp
Fp
Fp
Fp
Fp
SR
SR
SR
SR
Pi
SR
Sw
gz
gz
SR
vY
CF
fn
fn
Bu
vY
SR
gz
gz
Sw
SR
fn
fn
fn
SR
fn
fn
fn
fn
Rq
Nj
SR
Bv
SR
QV
QV
QV
QV
QV
QV
QV
QV
QV
QV
QV
QV
QV
QV
QV
SR
Bv
SR
Fp
Fp
So
"}
(17,1,1) = {"
So
Fp
Fp
Fp
Fp
Fp
Fp
SR
Pi
Pi
SR
Pi
SR
SR
SR
SR
SR
vY
Bu
fn
fn
CF
vY
SR
SR
SR
SR
SR
SR
fn
fn
SR
SR
Nt
Nt
Nt
SR
SR
SR
Bv
SR
QV
QV
QV
QV
QV
QV
QV
QV
QV
QV
QV
QV
QV
QV
QV
SR
Bv
SR
Fp
Fp
So
"}
(18,1,1) = {"
So
Fp
Fp
Fp
Fp
Fp
Fp
SR
Pi
Pi
Pi
Pi
SR
Sw
gz
gz
SR
vY
fn
fn
fn
fn
vY
vY
SR
gz
gz
Sw
SR
fn
fn
hw
vY
fn
fn
fn
vY
SR
Bv
Bv
SR
QV
QV
QV
QV
QV
QV
QV
QV
QV
QV
QV
QV
QV
QV
QV
SR
Bv
SR
Fp
Fp
So
"}
(19,1,1) = {"
So
Fp
Fp
Fp
Fp
Fp
Fp
SR
Pi
Pi
SR
Bv
SR
gz
gz
gz
rv
vY
fn
fn
kw
fn
fn
vY
rv
gz
gz
gz
SR
fn
fn
SR
vY
fn
fn
fn
vY
SR
Pi
Pi
SR
QV
QV
QV
QV
QV
QV
QV
QV
QV
QV
QV
QV
QV
QV
QV
SR
Bv
SR
Fp
Fp
So
"}
(20,1,1) = {"
So
Fp
Fp
SR
SR
SR
SR
SR
SR
SR
SR
Bv
SR
Sw
gz
gz
SR
vY
fn
Up
Ua
tg
fn
vY
SR
gz
gz
Sw
SR
SR
SR
SR
vY
fn
fn
fn
vY
SR
Pi
Pi
SR
QV
QV
QV
QV
QV
QV
QV
QV
QV
QV
QV
QV
QV
QV
QV
SR
Bv
SR
Fp
Fp
So
"}
(21,1,1) = {"
So
Fp
Fp
SR
Bv
Bv
Bv
Bv
Bv
Bv
Bv
Bv
SR
SR
SR
SR
SR
hB
fn
Up
zp
tg
fn
vY
SR
SR
SR
SR
SR
Pi
Pi
SR
vY
fn
fn
fn
vY
SR
Pi
Pi
SR
QV
QV
QV
QV
QV
QV
QV
QV
QV
QV
QV
QV
QV
QV
QV
SR
Bv
SR
Fp
Fp
So
"}
(22,1,1) = {"
So
Fp
Fp
SR
Bv
SR
SR
SR
SR
SR
SR
SR
SR
Sw
gz
gz
SR
vY
fn
Up
IX
tg
fn
vY
SR
gz
gz
Sw
SR
Pi
Pi
SR
vY
fn
fn
fn
vY
SR
Pi
Pi
SR
QV
QV
QV
QV
QV
QV
QV
QV
QV
QV
QV
QV
QV
QV
QV
SR
Bv
SR
Fp
Fp
So
"}
(23,1,1) = {"
So
Fp
Fp
SR
Bv
SR
hW
hW
hW
hW
uB
uB
SR
gz
gz
gz
rv
vY
fn
fn
Kp
fn
fn
vY
rv
gz
gz
gz
SR
Pi
Pi
SR
vY
fn
fn
fn
vY
SR
Pi
Pi
SR
QV
QV
QV
QV
QV
QV
QV
QV
QV
QV
QV
QV
QV
QV
QV
SR
Bv
SR
Fp
Fp
So
"}
(24,1,1) = {"
So
Fp
Fp
SR
Bv
SR
hW
hW
hW
hW
uB
uB
SR
Sw
gz
gz
SR
vY
vY
vY
fn
vY
vY
vY
SR
gz
gz
Sw
SR
Pi
Pi
SR
vY
fn
fn
fn
vY
SR
Pi
Pi
SR
QV
QV
QV
QV
QV
QV
QV
QV
QV
QV
QV
QV
QV
QV
QV
SR
Bv
SR
Fp
Fp
So
"}
(25,1,1) = {"
So
Fp
Fp
SR
Bv
SR
hW
hW
hW
hW
uB
uB
SR
SR
SR
SR
SR
SR
SR
vY
fn
vY
SR
SR
SR
SR
SR
SR
SR
Pi
Pi
SR
vY
fn
fn
fn
vY
SR
Pi
Pi
SR
SR
SR
SR
SR
SR
SR
SR
QV
SR
SR
SR
SR
SR
SR
SR
SR
Bv
SR
SR
Fp
So
"}
(26,1,1) = {"
So
Fp
Fp
SR
Bv
SR
hW
hW
hW
hW
uB
uB
uB
SR
By
By
By
By
SR
vY
fn
vY
SR
Pi
Pi
Pi
Pi
Pi
Pi
Pi
Pi
SR
vY
fn
fn
fn
vY
SR
Pi
Pi
Pi
Pi
Pi
Pi
Pi
Pi
SR
fn
fn
fn
SR
Pi
Pi
Pi
Pi
Pi
Pi
Bv
Bv
SR
Fp
So
"}
(27,1,1) = {"
So
Fp
Fp
SR
Bv
SR
hW
hW
hW
hW
uB
uB
uB
Pa
By
By
By
By
SR
vY
fn
vY
SR
Pi
Pi
Pi
Pi
Pi
Pi
Pi
Pi
SR
vY
fn
fn
fn
vY
SR
Pi
Pi
Pi
Pi
Pi
Pi
Pi
Pi
SR
fn
fn
fn
SR
Pi
SR
SR
SR
SR
SR
SR
Bv
SR
Fp
So
"}
(28,1,1) = {"
So
Fp
Fp
SR
Bv
SR
hW
hW
hW
hW
uB
uB
uB
SR
By
By
By
By
SR
vY
fn
vY
SR
Pi
Pi
Pi
Pi
Pi
Pi
Pi
Pi
SR
vY
fn
fn
fn
vY
SR
Pi
Pi
Pi
Pi
Pi
Pi
Pi
Pi
SR
fn
fn
fn
SR
Pi
SR
iS
iS
iS
iS
SR
Bv
SR
Fp
So
"}
(29,1,1) = {"
So
Fp
Fp
SR
Bv
SR
SR
SR
SR
SR
uB
SR
SR
SR
SR
SR
SR
SR
SR
vY
fn
vY
SR
SR
SR
SR
SR
SR
SR
SR
SR
SR
vY
fn
fn
fn
vY
SR
SR
SR
SR
SR
SR
SR
SR
SR
SR
fn
fn
fn
SR
SR
SR
gz
gz
gz
gz
SR
Bv
SR
Fp
So
"}
(30,1,1) = {"
So
Fp
Fp
SR
Bv
SR
vY
vY
vY
vY
fn
vY
vY
vY
vY
vY
vY
vY
vY
vY
fn
vY
vY
vY
vY
vY
vY
vY
vY
vY
vY
vY
vY
fn
fn
fn
vY
vY
vY
vY
vY
vY
vY
vY
vY
vY
vY
fn
fn
fn
fn
SR
gz
gz
gz
gz
gz
SR
Bv
SR
Fp
So
"}
(31,1,1) = {"
So
Fp
Fp
SR
Bv
SR
vY
fn
fn
fn
fn
fn
fn
fn
fn
fn
fn
fn
fn
fn
fn
fn
fn
fn
fn
fn
fn
fn
fn
fn
fn
fn
fn
fn
fn
fn
fn
fn
fn
fn
fn
fn
fn
fn
fn
fn
fn
fn
fn
fn
fn
gz
gz
gz
iS
iS
iS
SR
Bv
SR
Fp
So
"}
(32,1,1) = {"
So
Fp
Fp
SR
Bv
SR
vY
vY
vY
vY
fn
vY
vY
vY
vY
vY
vY
vY
vY
vY
fn
vY
vY
vY
vY
vY
vY
vY
vY
vY
vY
vY
vY
fn
fn
fn
vY
vY
vY
vY
vY
vY
vY
vY
vY
vY
vY
fn
fn
fn
fn
SR
gz
gz
gz
gz
gz
SR
Bv
SR
Fp
So
"}
(33,1,1) = {"
So
Fp
Fp
SR
Bv
SR
SR
SR
SR
SR
uB
SR
SR
SR
SR
SR
SR
SR
SR
vY
fn
vY
SR
SR
SR
SR
SR
SR
SR
SR
SR
SR
vY
fn
fn
fn
vY
SR
SR
SR
SR
SR
SR
SR
SR
SR
SR
fn
fn
fn
SR
SR
SR
gz
gz
gz
gz
SR
Bv
SR
Fp
So
"}
(34,1,1) = {"
So
Fp
Fp
SR
Bv
SR
hW
hW
hW
hW
uB
uB
uB
SR
By
By
By
By
SR
vY
fn
vY
SR
Pi
Pi
Pi
Pi
Pi
Pi
Pi
Pi
SR
vY
fn
fn
fn
vY
SR
Pi
Pi
Pi
Pi
Pi
Pi
Pi
Pi
SR
fn
fn
fn
SR
Pi
SR
iS
iS
iS
iS
SR
Bv
SR
Fp
So
"}
(35,1,1) = {"
So
Fp
Fp
SR
Bv
SR
hW
hW
hW
hW
uB
uB
uB
Pa
By
By
By
By
SR
vY
fn
vY
SR
Pi
Pi
Pi
Pi
Pi
Pi
Pi
Pi
SR
vY
fn
fn
fn
vY
SR
Pi
Pi
Pi
Pi
Pi
Pi
Pi
Pi
SR
fn
fn
fn
SR
Pi
SR
SR
SR
SR
SR
SR
Bv
SR
Fp
So
"}
(36,1,1) = {"
So
Fp
Fp
SR
Bv
SR
hW
hW
hW
hW
uB
uB
uB
SR
By
By
By
By
SR
vY
fn
vY
SR
Pi
Pi
Pi
Pi
Pi
Pi
Pi
Pi
SR
vY
fn
fn
fn
vY
SR
Bv
Bv
Bv
Bv
Bv
Bv
Bv
Bv
Bg
Bg
Bg
Bg
Bg
Bv
Bv
Bv
Bv
Bv
Bv
Bv
Bv
SR
Fp
So
"}
(37,1,1) = {"
So
Fp
Fp
SR
Bv
SR
hW
hW
hW
hW
uB
uB
SR
SR
SR
SR
SR
SR
SR
SR
Gl
SR
SR
SR
SR
SR
SR
SR
SR
Pi
Pi
SR
vY
fn
fn
fn
vY
SR
Pi
Pi
SR
SR
SR
SR
SR
SR
SR
fn
fn
fn
SR
SR
SR
SR
SR
SR
SR
Bv
SR
SR
Fp
So
"}
(38,1,1) = {"
So
Fp
Fp
SR
Bv
SR
hW
hW
hW
hW
uB
uB
SR
Qx
va
va
PE
SR
qf
qf
qf
qf
qf
qf
qf
qf
qf
qf
SR
Pi
Pi
SR
vY
fn
fn
fn
vY
SR
Pi
Pi
SR
dr
Bf
dr
Bf
Bf
SR
fn
fn
fn
SR
fn
fn
fn
fn
fn
SR
Bv
SR
Fp
Fp
So
"}
(39,1,1) = {"
So
Fp
Fp
SR
Bv
SR
SI
hW
hW
hW
uB
uB
SR
Ph
va
va
Es
SR
qf
qf
qf
qf
fM
rI
eE
fM
rI
eE
SR
Pi
Pi
SR
vY
fn
fn
fn
vY
SR
Pi
Pi
SR
dr
Bf
dr
Bf
Bf
qA
fn
fn
fn
fn
fn
fn
fn
fn
fn
SR
Bv
SR
Fp
Fp
So
"}
(40,1,1) = {"
So
Fp
Fp
SR
Bv
SR
SR
SR
SR
SR
SR
SR
SR
fj
va
va
kI
SR
rD
qf
qf
qf
fM
qf
eE
fM
qf
eE
SR
Pi
Pi
SR
vY
fn
fn
fn
vY
SR
Pi
Pi
SR
dr
Bf
dr
Bf
Bf
SR
fn
fn
fn
SR
fn
fn
fn
fn
fn
SR
Bv
SR
Fp
Fp
So
"}
(41,1,1) = {"
So
Fp
Fp
SR
Bv
Bv
Bv
Bv
Bv
Bv
Bv
Bv
SR
SR
va
va
SR
SR
qf
qf
qf
qf
qf
qf
qf
qf
qf
qf
SR
Pi
Pi
SR
vY
fn
fn
fn
vY
SR
Pi
Pi
SR
Bf
Bf
Bf
Bf
Bf
le
fn
fn
fn
SR
fn
fn
fn
fn
fn
SR
Bv
SR
Fp
Fp
So
"}
(42,1,1) = {"
So
Fp
Fp
SR
SR
SR
SR
SR
SR
SR
SR
Bv
SR
hb
hV
va
fH
SR
qf
qf
qf
qf
qf
qf
qf
qf
qf
qf
SR
Pi
Pi
SR
vY
fn
fn
fn
vY
SR
Pi
Pi
SR
oY
Bf
Bf
Bf
Bf
SR
fn
fn
fn
SR
fn
fn
fn
fn
fn
SR
Bv
SR
Fp
Fp
So
"}
(43,1,1) = {"
So
Fp
Fp
Fp
Fp
Fp
Fp
Fp
Fp
Fp
SR
Bv
SR
Yy
va
va
lM
SR
fD
fD
fD
fD
fD
qf
qf
qf
qf
qf
SR
Pi
Pi
SR
vY
fn
fn
fn
vY
SR
Pi
Pi
SR
SR
SR
SR
Bf
SR
SR
fn
fn
fn
SR
fn
fn
fn
fn
fn
SR
Bv
SR
Fp
Fp
So
"}
(44,1,1) = {"
So
Fp
Fp
Fp
Fp
Fp
Fp
Fp
Fp
Fp
SR
Bv
SR
Sm
va
va
va
SR
qf
qf
qf
qf
fD
qf
qf
fM
rI
eE
SR
Pi
Pi
SR
vY
fn
fn
fn
vY
SR
Pi
Pi
SR
om
wh
xk
Bf
hn
SR
fn
fn
fn
SR
fn
fn
fn
fn
fn
SR
Bv
SR
Fp
Fp
So
"}
(45,1,1) = {"
So
Fp
Fp
Fp
Fp
Fp
Fp
Fp
Fp
Fp
SR
Bv
SR
dj
hV
va
hV
Xc
qf
qf
qf
qf
qf
qf
qf
fM
qf
eE
SR
Pi
Pi
SR
vY
fn
fn
fn
vY
SR
Pi
Pi
SR
Ai
Bf
Bf
Bf
cx
SR
fn
fn
fn
SR
fn
fn
fn
fn
fn
SR
Bv
SR
Fp
Fp
So
"}
(46,1,1) = {"
So
Fp
Fp
Fp
Fp
Fp
Fp
Fp
Fp
Fp
SR
Bv
SR
Bd
va
va
lM
SR
Eh
Eh
qf
qf
qf
qf
qf
qf
qf
qf
SR
Pi
Pi
SR
vY
fn
fn
fn
vY
SR
Pi
Pi
SR
ip
Bf
Bf
Bf
hn
SR
fn
fn
fn
SR
fn
fn
fn
fn
fn
SR
Bv
SR
Fp
Fp
So
"}
(47,1,1) = {"
So
Fp
Fp
Fp
Fp
Fp
Fp
Fp
Fp
Fp
SR
Bv
SR
SR
SR
SR
SR
SR
SR
SR
SR
SR
SR
SR
SR
SR
SR
SR
SR
SR
SR
SR
SR
fn
fn
fn
SR
SR
SR
SR
SR
SR
SR
SR
SR
SR
SR
SR
fn
SR
SR
SR
SR
SR
SR
SR
SR
Bv
SR
Fp
Fp
So
"}
(48,1,1) = {"
So
Fp
Fp
Fp
Fp
Fp
Fp
Fp
Fp
Fp
SR
Bv
Bv
Bv
Bv
Bv
Bv
Bv
Bv
Bv
Bv
Bv
Bv
Bv
Bv
Bv
SR
LK
rj
rj
rj
rj
rj
fn
fn
fn
rj
rj
rj
rj
rj
SN
SR
jK
rj
Oe
rj
rj
fn
rj
SR
Bv
Bv
Bv
Bv
Bv
Bv
Bv
SR
Fp
Fp
So
"}
(49,1,1) = {"
So
Fp
Fp
Fp
Fp
Fp
Fp
Fp
Fp
Fp
SR
SR
SR
SR
SR
SR
SR
SR
SR
SR
SR
SR
SR
SR
SR
Bv
SR
LK
fn
fn
fn
fn
fn
fn
fn
fn
fn
fn
fn
fn
fn
SN
SR
rj
fn
rj
fn
fn
fn
rj
SR
Bv
SR
SR
SR
SR
SR
SR
SR
Fp
Fp
So
"}
(50,1,1) = {"
So
Fp
Fp
Fp
Fp
Fp
Fp
Fp
Fp
Fp
Fp
Fp
Fp
Fp
Fp
Fp
Fp
Fp
Fp
Fp
SR
QQ
gz
gz
Vv
pb
SR
FY
fn
Xq
fn
jg
fn
hp
fn
hp
fn
Nz
fn
Nz
fn
SN
SR
rj
fn
fn
fn
fn
fn
rj
SR
Bv
SR
Pi
Pi
SR
Fp
Fp
Fp
Fp
Fp
So
"}
(51,1,1) = {"
So
Fp
Fp
Fp
Fp
Fp
Fp
Fp
Fp
Fp
Fp
Fp
Fp
Fp
Fp
Fp
Fp
Fp
Fp
Fp
SR
ce
pb
pb
gY
pb
SR
rj
fn
zs
fn
rj
fn
rj
fn
rj
fn
rj
fn
rj
fn
Ih
SR
rj
fn
Hd
fn
UH
fn
rj
SR
Bv
Pi
Pi
Pi
SR
Fp
Fp
Fp
Fp
Fp
So
"}
(52,1,1) = {"
So
Fp
Fp
Fp
Fp
Fp
Fp
Fp
Fp
Fp
Fp
Fp
Fp
Fp
Fp
Fp
Fp
Fp
Fp
Fp
SR
QQ
gz
gz
Ir
pb
gz
fn
fn
rj
fn
rj
fn
rj
fn
rj
fn
rj
fn
rj
fn
fn
mp
fn
fn
rj
fn
Ot
fn
fn
SR
Bv
SR
Pi
Pi
SR
Fp
Fp
Fp
Fp
Fp
So
"}
(53,1,1) = {"
So
Fp
Fp
Fp
Fp
Fp
Fp
Fp
Fp
Fp
Fp
Fp
Fp
Fp
Fp
Fp
SR
SR
SR
SR
SR
ce
gz
gz
zc
pb
SR
rj
fn
bl
fn
um
fn
hp
fn
hp
fn
Nz
fn
jg
fn
rj
SR
rj
fn
fn
fn
SR
SR
vY
SR
Bv
SR
Pi
Pi
SR
Fp
Fp
Fp
Fp
Fp
So
"}
(54,1,1) = {"
So
Fp
Fp
Fp
Fp
Fp
Fp
Fp
Fp
Fp
Fp
Fp
Fp
sw
sw
Fp
SR
gz
gz
gz
SR
QQ
gz
gz
Vv
pb
SR
FY
fn
MP
fn
Jn
fn
rj
fn
rj
fn
zs
fn
rj
fn
yh
SR
rj
fn
fn
fn
SR
eF
vY
SR
Bv
SR
Pi
Pi
SR
Fp
Fp
Fp
Fp
Fp
So
"}
(55,1,1) = {"
So
Fp
Fp
Fp
Fp
Fp
Fp
Fp
Fp
Fp
Fp
Fp
Fp
sw
sw
sw
Ah
gz
gz
gz
pR
wR
gz
Pi
SR
Bv
SR
FY
fn
fn
fn
fn
fn
fn
fn
fn
fn
fn
fn
fn
fn
xJ
SR
La
fn
ry
fn
SR
vY
vY
SR
Bv
SR
SR
SR
SR
Fp
Fp
Fp
Fp
Fp
So
"}
(56,1,1) = {"
So
Fp
Fp
Fp
Fp
Fp
Fp
Fp
Fp
Fp
Fp
Fp
sw
Fp
Fp
sw
SR
gz
gz
gz
SR
wR
gz
It
SR
Bv
SR
LK
rj
rj
rj
rj
rj
rj
rj
rj
rj
rj
rj
rj
rj
aA
SR
rj
rj
rj
rj
SR
eF
vY
SR
Bv
SR
Fp
Fp
Fp
Fp
Fp
Fp
Fp
Fp
So
"}
(57,1,1) = {"
So
Fp
Fp
Fp
Fp
Fp
Fp
Fp
Fp
Fp
Fp
Fp
Fp
Fp
Fp
Fp
SR
SR
SR
SR
SR
SR
SR
SR
SR
Bv
SR
SR
SR
SR
SR
SR
SR
SR
SR
SR
SR
SR
SR
SR
SR
SR
SR
SR
SR
SR
SR
SR
SR
SR
SR
Bv
SR
Fp
Fp
Fp
Fp
Fp
Fp
Fp
Fp
So
"}
(58,1,1) = {"
So
Fp
Fp
Fp
Fp
Fp
Fp
Fp
Fp
Fp
Fp
Fp
Fp
Fp
Fp
Fp
Fp
Fp
Fp
Fp
Fp
Fp
Fp
Fp
SR
Bv
Bv
Bv
Bv
Bv
Bv
Bv
Bv
Bv
Bv
Bv
Bv
Bv
Bv
Bv
Bv
Bv
Bv
Bv
Bv
Bv
Bv
Bv
Bv
Bv
Bv
Bv
SR
Fp
Fp
Fp
Fp
Fp
Fp
Fp
Fp
So
"}
(59,1,1) = {"
So
Fp
Fp
Fp
Fp
Fp
Fp
Fp
Fp
Fp
Fp
Fp
Fp
Fp
Fp
Fp
Fp
Fp
Fp
Fp
Fp
Fp
Fp
Fp
SR
SR
SR
SR
SR
SR
SR
SR
SR
SR
SR
SR
SR
SR
SR
SR
SR
SR
SR
SR
SR
SR
SR
SR
SR
SR
SR
SR
SR
Fp
Fp
Fp
Fp
Fp
Fp
Fp
Fp
So
"}
(60,1,1) = {"
So
Fp
Fp
Fp
Fp
Fp
Fp
Fp
Fp
Fp
Fp
Fp
Fp
Fp
Fp
Fp
Fp
Fp
Fp
Fp
Fp
Fp
Fp
Fp
Fp
Fp
Fp
Fp
Fp
Fp
Fp
Fp
Fp
Fp
Fp
Fp
Fp
Fp
Fp
Fp
Fp
Fp
Fp
Fp
Fp
Fp
Fp
Fp
Fp
Fp
Fp
Fp
Fp
Fp
Fp
Fp
Fp
Fp
Fp
Fp
Fp
So
"}
(61,1,1) = {"
So
Fp
Fp
Fp
Fp
Fp
Fp
Fp
Fp
Fp
Fp
Fp
Fp
Fp
Fp
Fp
Fp
Fp
Fp
Fp
Fp
Fp
Fp
Fp
Fp
Fp
Fp
Fp
Fp
Fp
Fp
Fp
Fp
Fp
Fp
Fp
Fp
Fp
Fp
Fp
Fp
Fp
Fp
Fp
Fp
Fp
Fp
Fp
Fp
Fp
Fp
Fp
Fp
Fp
Fp
Fp
Fp
Fp
Fp
Fp
Fp
So
"}
(62,1,1) = {"
So
So
So
So
So
So
So
So
So
So
So
So
So
So
So
So
So
So
So
So
So
So
So
So
So
So
So
So
So
So
So
So
So
So
So
So
So
So
So
So
So
So
So
So
So
So
So
So
So
So
So
So
So
So
So
So
So
So
So
So
So
So
"}
