//MAP CONVERTED BY dmm2tgm.py THIS HEADER COMMENT PREVENTS RECONVERSION, DO NOT REMOVE
"b" = (
/obj/structure/halflife/pallet,
/turf/open/floor/plating/indoor/concrete/bricks,
/area/halflife/indoors/sewer)
"d" = (
/obj/modular_map_connector,
/turf/template_noop,
/area/template_noop)
"n" = (
/obj/structure/halflife/pallet/stack,
/turf/open/floor/plating/indoor/concrete/bricks,
/area/halflife/indoors/sewer)
"o" = (
/mob/living/simple_animal/hostile/halflife/headcrab,
/turf/open/floor/plating/indoor/concrete/bricks,
/area/halflife/indoors/sewer)
"p" = (
/obj/machinery/door/unpowered/halflife/metal{
	dir = 4
	},
/turf/open/floor/plating/indoor/concrete/bricks,
/area/halflife/indoors/sewer)
"w" = (
/obj/structure/table/halflife/metal/grate,
/turf/open/floor/plating/indoor/concrete/bricks,
/area/halflife/indoors/sewer)
"B" = (
/obj/effect/spawner/random/halflife/loot/consumables,
/obj/effect/decal/cleanable/blood/old,
/turf/open/floor/plating/indoor/concrete/bricks,
/area/halflife/indoors/sewer)
"J" = (
/obj/effect/decal/cleanable/blood/old,
/turf/open/floor/plating/indoor/concrete/bricks,
/area/halflife/indoors/sewer)
"N" = (
/turf/closed/wall/halflife/sewer,
/area/halflife/indoors/sewer)
"P" = (
/obj/effect/spawner/random/halflife/loot/consumables,
/turf/open/floor/plating/indoor/concrete/bricks,
/area/halflife/indoors/sewer)
"U" = (
/turf/open/floor/plating/indoor/concrete/bricks,
/area/halflife/indoors/sewer)
"X" = (
/turf/open/floor/plating/indoor/metal/walkway{
	dir = 1
	},
/area/halflife/indoors/sewer)
"Y" = (
/turf/template_noop,
/area/template_noop)

(1,1,1) = {"
Y
Y
Y
Y
Y
Y
Y
Y
Y
Y
Y
d
"}
(2,1,1) = {"
Y
N
N
N
N
N
N
N
N
N
N
Y
"}
(3,1,1) = {"
Y
N
B
U
U
N
U
U
U
b
N
Y
"}
(4,1,1) = {"
Y
N
U
U
U
X
o
U
U
o
N
Y
"}
(5,1,1) = {"
Y
N
w
U
U
X
U
U
U
U
N
Y
"}
(6,1,1) = {"
Y
N
w
U
U
X
U
U
U
J
N
Y
"}
(7,1,1) = {"
Y
N
w
o
U
X
U
U
U
U
N
Y
"}
(8,1,1) = {"
Y
N
w
U
U
X
U
U
U
U
N
Y
"}
(9,1,1) = {"
Y
N
U
U
o
X
U
U
U
U
N
Y
"}
(10,1,1) = {"
Y
N
U
U
P
N
n
U
U
U
N
Y
"}
(11,1,1) = {"
Y
N
N
N
N
N
N
N
N
p
N
Y
"}
(12,1,1) = {"
Y
Y
Y
Y
Y
Y
Y
Y
Y
Y
Y
Y
"}
