//MAP CONVERTED BY dmm2tgm.py THIS HEADER COMMENT PREVENTS RECONVERSION, DO NOT REMOVE
"e" = (
/obj/machinery/light/small{
	dir = 4
	},
/turf/open/floor/plating/indoor/metal,
/area/halflife/indoors/sewer)
"j" = (
/mob/living/simple_animal/hostile/halflife/headcrab/poison,
/turf/open/floor/plating/indoor/metal,
/area/halflife/indoors/sewer)
"l" = (
/turf/open/floor/plating/indoor/metal,
/area/halflife/indoors/sewer)
"m" = (
/turf/open/floor/plating/indoor/concrete/small,
/area/halflife/indoors/sewer)
"p" = (
/obj/machinery/door/unpowered/halflife/metal{
	dir = 4
	},
/turf/open/floor/plating/indoor/concrete/small,
/area/halflife/indoors/sewer)
"r" = (
/obj/machinery/turnstile/brig/halflife/forcefield/civilprotection/nodirectional,
/turf/open/floor/plating/indoor/concrete/small,
/area/halflife/indoors/sewer)
"z" = (
/turf/template_noop,
/area/template_noop)
"A" = (
/obj/structure/halflife/tank,
/turf/open/floor/plating/indoor/concrete/small,
/area/halflife/indoors/sewer)
"B" = (
/obj/structure/table/halflife/no_smooth/large/crafting/armorbench,
/turf/open/floor/plating/indoor/metal,
/area/halflife/indoors/sewer)
"D" = (
/obj/structure/table/halflife/no_smooth/large/crafting/weaponbench,
/turf/open/floor/plating/indoor/metal,
/area/halflife/indoors/sewer)
"F" = (
/obj/machinery/door/unpowered/halflife/metal,
/turf/open/floor/plating/indoor/metal,
/area/halflife/indoors/sewer)
"J" = (
/obj/structure/sign/poster/halflife/combine/two{
	pixel_y = 32
	},
/turf/open/floor/plating/indoor/concrete/small,
/area/halflife/indoors/sewer)
"K" = (
/obj/modular_map_connector,
/turf/template_noop,
/area/template_noop)
"P" = (
/mob/living/simple_animal/hostile/halflife/zombie/zombine,
/turf/open/floor/plating/indoor/concrete/small,
/area/halflife/indoors/sewer)
"R" = (
/obj/structure/table/halflife/metal/alt,
/obj/effect/spawner/random/halflife/loot/rare,
/turf/open/floor/plating/indoor/metal,
/area/halflife/indoors/sewer)
"S" = (
/obj/structure/table/halflife/metal/alt,
/obj/effect/spawner/random/halflife/loot,
/turf/open/floor/plating/indoor/metal,
/area/halflife/indoors/sewer)
"T" = (
/obj/structure/table/halflife/metal/alt,
/obj/effect/spawner/random/halflife/loot/ammo,
/turf/open/floor/plating/indoor/metal,
/area/halflife/indoors/sewer)
"V" = (
/obj/structure/table/halflife/no_smooth/large/crafting/ammobench,
/turf/open/floor/plating/indoor/metal,
/area/halflife/indoors/sewer)
"X" = (
/turf/closed/wall/halflife/sewer,
/area/halflife/indoors/sewer)
"Y" = (
/obj/machinery/turnstile/brig/halflife/forcefield/civilprotection/nodirectional,
/turf/open/floor/plating/indoor/metal,
/area/halflife/indoors/sewer)

(1,1,1) = {"
z
z
z
z
z
z
z
z
z
z
z
K
"}
(2,1,1) = {"
z
X
X
X
X
X
X
X
X
X
X
z
"}
(3,1,1) = {"
z
X
T
l
Y
m
F
l
l
B
X
z
"}
(4,1,1) = {"
z
X
D
j
X
m
X
S
e
l
X
z
"}
(5,1,1) = {"
z
X
l
l
X
J
X
X
X
X
X
z
"}
(6,1,1) = {"
z
X
T
R
X
m
F
l
l
V
X
z
"}
(7,1,1) = {"
z
X
X
X
X
m
X
S
e
l
X
z
"}
(8,1,1) = {"
z
X
A
m
m
m
X
X
X
X
X
z
"}
(9,1,1) = {"
z
X
A
P
m
m
r
m
m
m
X
z
"}
(10,1,1) = {"
z
X
A
m
m
m
X
m
m
m
X
z
"}
(11,1,1) = {"
z
X
X
X
X
X
X
p
X
X
X
z
"}
(12,1,1) = {"
z
z
z
z
z
z
z
z
z
z
z
z
"}
