//MAP CONVERTED BY dmm2tgm.py THIS HEADER COMMENT PREVENTS RECONVERSION, DO NOT REMOVE
"a" = (
/turf/open/floor/plating/indoor/concrete/bricks,
/area/halflife/indoors/sewer)
"j" = (
/obj/structure/closet/crate,
/obj/effect/spawner/random/halflife/loot,
/obj/effect/spawner/random/halflife/loot/clothing,
/obj/effect/spawner/random/halflife/loot/ammo,
/turf/open/floor/plating/indoor/concrete/bricks,
/area/halflife/indoors/sewer)
"k" = (
/obj/modular_map_connector,
/turf/template_noop,
/area/template_noop)
"m" = (
/mob/living/simple_animal/hostile/halflife/headcrab/poison,
/turf/open/floor/plating/indoor/concrete/bricks,
/area/halflife/indoors/sewer)
"y" = (
/obj/machinery/door/unpowered/halflife/metal,
/turf/open/floor/plating/indoor/concrete/bricks,
/area/halflife/indoors/sewer)
"H" = (
/obj/effect/spawner/random/halflife/loot,
/turf/open/floor/plating/indoor/concrete/bricks,
/area/halflife/indoors/sewer)
"J" = (
/turf/template_noop,
/area/template_noop)
"M" = (
/obj/machinery/door/unpowered/halflife/metal{
	dir = 4
	},
/turf/open/floor/plating/indoor/concrete/bricks,
/area/halflife/indoors/sewer)
"Q" = (
/obj/machinery/door/unpowered/halflife/metal{
	dir = 8
	},
/turf/open/floor/plating/indoor/concrete/bricks,
/area/halflife/indoors/sewer)
"T" = (
/mob/living/simple_animal/hostile/halflife/headcrab,
/turf/open/floor/plating/indoor/concrete/bricks,
/area/halflife/indoors/sewer)
"W" = (
/turf/closed/wall/halflife/sewer,
/area/halflife/indoors/sewer)
"Y" = (
/turf/open/floor/plating/indoor/metal/walkway{
	dir = 1
	},
/area/halflife/indoors/sewer)

(1,1,1) = {"
J
J
J
J
J
J
J
J
J
J
J
k
"}
(2,1,1) = {"
J
W
W
W
W
W
W
W
W
W
W
J
"}
(3,1,1) = {"
J
W
a
Y
a
W
a
Y
a
a
W
J
"}
(4,1,1) = {"
J
W
a
Y
a
Y
a
W
W
a
W
J
"}
(5,1,1) = {"
J
W
H
W
T
W
a
Y
W
a
W
J
"}
(6,1,1) = {"
J
W
a
W
a
W
a
W
W
a
W
J
"}
(7,1,1) = {"
J
W
a
Y
a
W
a
Y
a
m
W
J
"}
(8,1,1) = {"
J
W
a
Y
a
W
a
W
a
a
W
J
"}
(9,1,1) = {"
J
W
W
W
a
W
a
W
Q
W
W
J
"}
(10,1,1) = {"
J
W
a
y
a
y
a
W
a
j
W
J
"}
(11,1,1) = {"
J
W
W
W
M
W
W
W
W
W
W
J
"}
(12,1,1) = {"
J
J
J
J
J
J
J
J
J
J
J
J
"}
