//MAP CONVERTED BY dmm2tgm.py THIS HEADER COMMENT PREVENTS RECONVERSION, DO NOT REMOVE
"k" = (
/obj/machinery/door/unpowered/halflife/metal{
	dir = 8
	},
/turf/open/floor/plating/indoor/concrete/small,
/area/halflife/indoors/sewer)
"n" = (
/obj/modular_map_connector,
/turf/template_noop,
/area/template_noop)
"p" = (
/obj/machinery/light/small{
	dir = 4
	},
/turf/open/floor/plating/indoor/concrete/small,
/area/halflife/indoors/sewer)
"q" = (
/obj/structure/table/halflife/no_smooth/large/crafting/workbench,
/turf/open/floor/plating/indoor/concrete/small,
/area/halflife/indoors/sewer)
"t" = (
/obj/structure/ore_box,
/turf/open/floor/plating/indoor/concrete/small,
/area/halflife/indoors/sewer)
"w" = (
/obj/structure/closet/crate,
/obj/effect/spawner/random/halflife/loot,
/turf/open/floor/plating/indoor/concrete/small,
/area/halflife/indoors/sewer)
"y" = (
/turf/open/floor/plating/indoor/concrete/small,
/area/halflife/indoors/sewer)
"A" = (
/turf/closed/wall/halflife/sewer,
/area/halflife/indoors/sewer)
"B" = (
/obj/machinery/light/small{
	dir = 1
	},
/turf/open/floor/plating/indoor/concrete/small,
/area/halflife/indoors/sewer)
"J" = (
/obj/machinery/door/unpowered/halflife/metal,
/turf/open/floor/plating/indoor/concrete/small,
/area/halflife/indoors/sewer)
"Q" = (
/obj/structure/halflife/road_barrier,
/turf/open/floor/plating/indoor/concrete/small,
/area/halflife/indoors/sewer)
"U" = (
/turf/template_noop,
/area/template_noop)
"X" = (
/obj/structure/closet/crate,
/obj/item/pickaxe,
/turf/open/floor/plating/indoor/concrete/small,
/area/halflife/indoors/sewer)
"Y" = (
/obj/structure/closet/crate,
/obj/item/t_scanner/adv_mining_scanner/lesser,
/turf/open/floor/plating/indoor/concrete/small,
/area/halflife/indoors/sewer)
"Z" = (
/obj/structure/closet/crate,
/turf/open/floor/plating/indoor/concrete/small,
/area/halflife/indoors/sewer)

(1,1,1) = {"
U
U
U
U
U
U
U
U
U
U
U
n
"}
(2,1,1) = {"
U
A
A
k
A
A
A
A
A
A
A
U
"}
(3,1,1) = {"
U
A
y
y
Q
y
y
J
y
Y
A
U
"}
(4,1,1) = {"
U
A
y
y
y
y
y
A
y
w
A
U
"}
(5,1,1) = {"
U
A
y
p
Q
y
y
A
y
Z
A
U
"}
(6,1,1) = {"
U
A
A
A
A
q
y
A
y
Z
A
U
"}
(7,1,1) = {"
U
A
t
y
A
y
y
A
A
A
A
U
"}
(8,1,1) = {"
U
A
t
y
A
y
y
A
y
X
A
U
"}
(9,1,1) = {"
U
A
t
y
J
y
y
A
B
Z
A
U
"}
(10,1,1) = {"
U
A
t
y
A
y
y
J
y
w
A
U
"}
(11,1,1) = {"
U
A
A
A
A
A
A
A
A
A
A
U
"}
(12,1,1) = {"
U
U
U
U
U
U
U
U
U
U
U
U
"}
