//MAP CONVERTED BY dmm2tgm.py THIS HEADER COMMENT PREVENTS RECONVERSION, DO NOT REMOVE
"a" = (
/obj/machinery/recycler,
/turf/open/floor/plating/indoor/concrete/small,
/area/halflife/indoors/sewer)
"c" = (
/turf/open/floor/plating/indoor/concrete/small,
/area/halflife/indoors/sewer)
"d" = (
/obj/item/radio/intercom{
	pixel_y = -30
	},
/turf/open/floor/plating/indoor/metal/grate/border/warning,
/area/halflife/indoors/sewer)
"e" = (
/obj/structure/reagent_dispensers/fueltank,
/turf/open/floor/plating/indoor/metal/plate,
/area/halflife/indoors/sewer)
"f" = (
/obj/structure/frame/machine,
/obj/item/wrench,
/turf/open/floor/plating/indoor/metal/plate,
/area/halflife/indoors/sewer)
"i" = (
/obj/structure/halflife/trash/wood,
/turf/open/floor/plating/indoor/concrete/small,
/area/halflife/indoors/sewer)
"j" = (
/obj/machinery/light/small{
	dir = 8
	},
/turf/open/floor/plating/indoor/metal/plate,
/area/halflife/indoors/sewer)
"q" = (
/obj/structure/halflife/trash/papers,
/turf/open/floor/plating/indoor/metal/plate,
/area/halflife/indoors/sewer)
"s" = (
/obj/effect/spawner/random/halflife/loot,
/turf/open/floor/plating/indoor/concrete/small,
/area/halflife/indoors/sewer)
"u" = (
/obj/structure/table/halflife/metal/heavy,
/turf/open/floor/plating/indoor/metal/plate,
/area/halflife/indoors/sewer)
"y" = (
/obj/machinery/light/small{
	dir = 4
	},
/turf/open/floor/plating/indoor/concrete/small,
/area/halflife/indoors/sewer)
"C" = (
/obj/machinery/door/unpowered/halflife/metal{
	dir = 4
	},
/turf/open/floor/plating/indoor/concrete/bricks,
/area/halflife/indoors/sewer)
"D" = (
/obj/structure/frame/machine,
/turf/open/floor/plating/indoor/metal/plate,
/area/halflife/indoors/sewer)
"F" = (
/obj/modular_map_connector,
/turf/template_noop,
/area/template_noop)
"G" = (
/turf/open/floor/plating/indoor/metal/plate,
/area/halflife/indoors/sewer)
"H" = (
/turf/open/floor/plating/indoor/metal/grate/border/warning,
/area/halflife/indoors/sewer)
"K" = (
/obj/structure/table/halflife/no_smooth/large/crafting/workbench,
/turf/open/floor/plating/indoor/concrete/small,
/area/halflife/indoors/sewer)
"L" = (
/turf/template_noop,
/area/template_noop)
"O" = (
/obj/structure/table/halflife/metal/heavy,
/obj/structure/halflife/trash/glass/basic,
/turf/open/floor/plating/indoor/concrete/small,
/area/halflife/indoors/sewer)
"Q" = (
/obj/structure/table/halflife/metal/heavy,
/obj/item/circuitboard/machine/autolathe,
/turf/open/floor/plating/indoor/metal/plate,
/area/halflife/indoors/sewer)
"R" = (
/obj/structure/frame/machine,
/turf/open/floor/plating/indoor/concrete/small,
/area/halflife/indoors/sewer)
"S" = (
/turf/closed/wall/halflife/sewer,
/area/halflife/indoors/sewer)
"T" = (
/obj/structure/table/halflife/no_smooth/large/crafting/weaponbench,
/turf/open/floor/plating/indoor/metal/plate,
/area/halflife/indoors/sewer)
"U" = (
/obj/structure/table/halflife/no_smooth/large/crafting/ammobench,
/turf/open/floor/plating/indoor/concrete/small,
/area/halflife/indoors/sewer)
"W" = (
/obj/structure/table/halflife/no_smooth/large/crafting/armorbench,
/turf/open/floor/plating/indoor/metal/plate,
/area/halflife/indoors/sewer)
"Z" = (
/obj/structure/halflife/trash/papers/three,
/turf/open/floor/plating/indoor/concrete/small,
/area/halflife/indoors/sewer)

(1,1,1) = {"
L
L
L
L
L
L
L
L
L
L
L
F
"}
(2,1,1) = {"
L
S
S
S
S
S
S
S
S
S
S
L
"}
(3,1,1) = {"
L
S
c
c
c
H
G
G
G
u
S
L
"}
(4,1,1) = {"
L
S
s
c
c
H
q
G
G
Q
S
L
"}
(5,1,1) = {"
L
S
a
Z
U
H
W
G
G
D
S
L
"}
(6,1,1) = {"
L
S
c
c
y
H
G
G
G
e
S
L
"}
(7,1,1) = {"
L
S
S
S
S
d
S
S
S
S
S
L
"}
(8,1,1) = {"
L
S
R
c
K
H
T
G
j
G
S
L
"}
(9,1,1) = {"
L
S
O
c
c
H
G
G
G
f
S
L
"}
(10,1,1) = {"
L
S
c
i
c
H
G
G
G
D
S
L
"}
(11,1,1) = {"
L
S
S
S
S
C
S
S
S
S
S
L
"}
(12,1,1) = {"
L
L
L
L
L
L
L
L
L
L
L
L
"}
