//MAP CONVERTED BY dmm2tgm.py THIS HEADER COMMENT PREVENTS RECONVERSION, DO NOT REMOVE
"a" = (
/obj/structure/flora/ash/stem_shroom,
/turf/open/floor/plating/indoor/concrete/bricks,
/area/halflife/indoors/sewer)
"d" = (
/obj/structure/halflife/trash/wood,
/turf/open/floor/plating/indoor/concrete/bricks,
/area/halflife/indoors/sewer)
"j" = (
/obj/effect/spawner/random/halflife/loot,
/turf/open/floor/plating/indoor/concrete/bricks,
/area/halflife/indoors/sewer)
"l" = (
/obj/structure/halflife/trash/papers/two,
/turf/open/floor/plating/indoor/concrete/bricks,
/area/halflife/indoors/sewer)
"n" = (
/turf/template_noop,
/area/template_noop)
"s" = (
/obj/structure/halflife/trash/papers/three,
/turf/open/floor/plating/indoor/concrete/bricks,
/area/halflife/indoors/sewer)
"t" = (
/turf/open/floor/plating/indoor/concrete/bricks,
/area/halflife/indoors/sewer)
"u" = (
/obj/structure/flora/xen/leafy,
/turf/open/floor/plating/indoor/concrete/bricks,
/area/halflife/indoors/sewer)
"x" = (
/turf/closed/wall/halflife/sewer,
/area/halflife/indoors/sewer)
"z" = (
/mob/living/basic/halflife/headcrab/armored,
/turf/open/floor/plating/indoor/concrete/bricks,
/area/halflife/indoors/sewer)
"B" = (
/obj/effect/spawner/random/halflife/loot/ammo,
/turf/open/floor/plating/indoor/concrete/bricks,
/area/halflife/indoors/sewer)
"D" = (
/obj/structure/halflife/trash/cardboard,
/turf/open/floor/plating/indoor/concrete/bricks,
/area/halflife/indoors/sewer)
"E" = (
/obj/structure/alien/weeds/node,
/turf/open/floor/plating/indoor/concrete/bricks,
/area/halflife/indoors/sewer)
"I" = (
/obj/effect/spawner/random/halflife/loot/consumables,
/turf/open/floor/plating/indoor/concrete/bricks,
/area/halflife/indoors/sewer)
"J" = (
/obj/machinery/door/unpowered/halflife/metal{
	dir = 4
	},
/turf/open/floor/plating/indoor/concrete/bricks,
/area/halflife/indoors/sewer)
"M" = (
/obj/structure/flora/xen/tinyshrooms,
/turf/open/floor/plating/indoor/concrete/bricks,
/area/halflife/indoors/sewer)
"W" = (
/obj/structure/halflife/trash/papers/one,
/turf/open/floor/plating/indoor/concrete/bricks,
/area/halflife/indoors/sewer)
"Y" = (
/obj/modular_map_connector,
/turf/template_noop,
/area/template_noop)

(1,1,1) = {"
n
n
n
n
n
n
n
n
n
n
n
Y
"}
(2,1,1) = {"
n
x
x
x
x
x
x
x
x
x
x
n
"}
(3,1,1) = {"
n
x
a
t
u
t
z
t
t
j
x
n
"}
(4,1,1) = {"
n
x
t
t
E
W
t
E
u
t
x
n
"}
(5,1,1) = {"
n
x
E
t
t
t
t
t
t
l
x
n
"}
(6,1,1) = {"
n
x
M
t
x
t
M
t
a
t
x
n
"}
(7,1,1) = {"
n
x
t
t
x
E
t
z
B
t
x
n
"}
(8,1,1) = {"
n
x
t
t
x
t
t
t
E
t
x
n
"}
(9,1,1) = {"
n
x
d
t
x
t
s
M
t
I
x
n
"}
(10,1,1) = {"
n
x
t
t
x
j
a
t
t
D
x
n
"}
(11,1,1) = {"
n
x
x
J
x
x
x
x
x
x
x
n
"}
(12,1,1) = {"
n
n
n
n
n
n
n
n
n
n
n
n
"}
