//MAP CONVERTED BY dmm2tgm.py THIS HEADER COMMENT PREVENTS RECONVERSION, DO NOT REMOVE
"a" = (
/obj/structure/table/halflife/metal/alt,
/turf/open/floor/plating/indoor/concrete/small,
/area/halflife/indoors/sewer)
"b" = (
/obj/structure/table/halflife/metal/alt,
/obj/structure/halflife/trash/papers/three,
/turf/open/floor/plating/indoor/concrete/small,
/area/halflife/indoors/sewer)
"f" = (
/obj/machinery/door/unpowered/halflife/metal{
	dir = 8
	},
/turf/open/floor/plating/indoor/concrete/small,
/area/halflife/indoors/sewer)
"h" = (
/obj/structure/chair/office/halflife/blue{
	dir = 8
	},
/turf/open/floor/plating/indoor/concrete/small,
/area/halflife/indoors/sewer)
"j" = (
/obj/structure/table/halflife/metal/alt,
/obj/structure/halflife/trash/books,
/turf/open/floor/plating/indoor/concrete/small,
/area/halflife/indoors/sewer)
"s" = (
/obj/machinery/light/small{
	dir = 8
	},
/turf/open/floor/plating/indoor/concrete/small,
/area/halflife/indoors/sewer)
"t" = (
/obj/structure/window/fulltile,
/turf/open/floor/plating/indoor/concrete/small,
/area/halflife/indoors/sewer)
"w" = (
/obj/structure/closet/crate/critter,
/turf/open/floor/plating/indoor/concrete/small,
/area/halflife/indoors/sewer)
"y" = (
/obj/machinery/door/unpowered/halflife/metal,
/turf/open/floor/plating/indoor/concrete/small,
/area/halflife/indoors/sewer)
"A" = (
/obj/structure/table/halflife/metal/alt,
/obj/structure/halflife/trash/papers/two,
/turf/open/floor/plating/indoor/concrete/small,
/area/halflife/indoors/sewer)
"B" = (
/obj/structure/table/halflife/metal/alt,
/obj/effect/spawner/random/halflife/loot,
/turf/open/floor/plating/indoor/concrete/small,
/area/halflife/indoors/sewer)
"D" = (
/obj/structure/closet/crate/wooden,
/obj/effect/spawner/random/halflife/loot/rare,
/turf/open/floor/plating/indoor/concrete/small,
/area/halflife/indoors/sewer)
"I" = (
/obj/structure/halflife/trash/cardboard,
/turf/open/floor/plating/indoor/concrete/small,
/area/halflife/indoors/sewer)
"O" = (
/turf/open/floor/plating/indoor/concrete/small,
/area/halflife/indoors/sewer)
"R" = (
/turf/template_noop,
/area/template_noop)
"W" = (
/turf/closed/wall/halflife/sewer,
/area/halflife/indoors/sewer)
"X" = (
/obj/structure/table/halflife/metal/alt,
/obj/machinery/light/small{
	dir = 1
	},
/turf/open/floor/plating/indoor/concrete/small,
/area/halflife/indoors/sewer)
"Y" = (
/obj/modular_map_connector,
/turf/template_noop,
/area/template_noop)
"Z" = (
/mob/living/basic/halflife/headcrab/poison,
/obj/effect/decal/cleanable/blood/splatter,
/turf/open/floor/plating/indoor/concrete/small,
/area/halflife/indoors/sewer)

(1,1,1) = {"
R
R
R
R
R
R
R
R
R
R
R
Y
"}
(2,1,1) = {"
R
W
f
W
W
W
W
W
W
W
W
R
"}
(3,1,1) = {"
R
W
O
O
W
O
s
O
b
a
W
R
"}
(4,1,1) = {"
R
W
O
O
y
O
O
O
h
a
W
R
"}
(5,1,1) = {"
R
W
I
O
W
O
O
O
O
j
W
R
"}
(6,1,1) = {"
R
W
W
f
W
W
W
W
f
W
W
R
"}
(7,1,1) = {"
R
W
a
O
O
O
W
w
O
O
W
R
"}
(8,1,1) = {"
R
W
X
O
O
O
t
O
O
O
W
R
"}
(9,1,1) = {"
R
W
O
O
O
O
t
O
O
Z
W
R
"}
(10,1,1) = {"
R
W
O
B
A
a
W
O
O
D
W
R
"}
(11,1,1) = {"
R
W
W
W
W
W
W
W
W
W
W
R
"}
(12,1,1) = {"
R
R
R
R
R
R
R
R
R
R
R
R
"}
