//MAP CONVERTED BY dmm2tgm.py THIS HEADER COMMENT PREVENTS RECONVERSION, DO NOT REMOVE
"b" = (
/obj/item/fishing_lure,
/turf/open/floor/plating/indoor/concrete/small,
/area/halflife/indoors/sewer)
"h" = (
/obj/modular_map_connector,
/turf/template_noop,
/area/template_noop)
"i" = (
/turf/closed/wall/halflife/metal,
/area/halflife/indoors/sewer)
"k" = (
/obj/structure/halflife/storage/store/metal,
/turf/open/floor/plating/indoor/concrete/small,
/area/halflife/indoors/sewer)
"m" = (
/obj/machinery/light/small{
	dir = 1
	},
/turf/open/floor/plating/indoor/concrete/small,
/area/halflife/indoors/sewer)
"r" = (
/obj/machinery/door/unpowered/halflife/metal{
	dir = 4
	},
/turf/open/floor/plating/indoor/concrete/small,
/area/halflife/indoors/sewer)
"w" = (
/turf/open/halflife/water/sewer/deep,
/area/halflife/indoors/sewer)
"H" = (
/obj/structure/railing/halflife/sewer,
/turf/open/floor/plating/indoor/concrete/small,
/area/halflife/indoors/sewer)
"I" = (
/obj/structure/halflife/storage/store/metal,
/obj/effect/spawner/random/halflife/loot,
/turf/open/floor/plating/indoor/concrete/small,
/area/halflife/indoors/sewer)
"K" = (
/turf/open/floor/plating/indoor/concrete/small,
/area/halflife/indoors/sewer)
"M" = (
/obj/structure/halflife/storage/large/shelf,
/obj/item/fishing_hook,
/turf/open/floor/plating/indoor/concrete/small,
/area/halflife/indoors/sewer)
"U" = (
/obj/structure/halflife/storage/large/shelf,
/obj/item/fishing_rod,
/turf/open/floor/plating/indoor/concrete/small,
/area/halflife/indoors/sewer)
"V" = (
/turf/template_noop,
/area/template_noop)
"Z" = (
/obj/machinery/door/unpowered/halflife/metal,
/turf/open/floor/plating/indoor/concrete/small,
/area/halflife/indoors/sewer)

(1,1,1) = {"
V
V
V
V
V
V
V
V
V
V
V
h
"}
(2,1,1) = {"
V
i
i
i
i
i
i
i
i
i
i
V
"}
(3,1,1) = {"
V
i
k
K
K
i
U
K
H
w
i
V
"}
(4,1,1) = {"
V
i
I
K
K
i
K
K
H
w
i
V
"}
(5,1,1) = {"
V
i
k
K
K
i
K
K
H
w
i
V
"}
(6,1,1) = {"
V
i
k
K
K
Z
K
K
K
w
i
V
"}
(7,1,1) = {"
V
i
k
K
K
i
m
K
H
w
i
V
"}
(8,1,1) = {"
V
i
k
K
K
i
K
K
H
w
i
V
"}
(9,1,1) = {"
V
i
k
K
K
i
M
K
H
w
i
V
"}
(10,1,1) = {"
V
i
k
K
K
i
b
K
H
w
i
V
"}
(11,1,1) = {"
V
i
i
r
i
i
i
i
i
i
i
V
"}
(12,1,1) = {"
V
V
V
V
V
V
V
V
V
V
V
V
"}
