//MAP CONVERTED BY dmm2tgm.py THIS HEADER COMMENT PREVENTS RECONVERSION, DO NOT REMOVE
"c" = (
/obj/structure/closet/crate/radiation,
/obj/effect/spawner/random/halflife/loot/ammo,
/obj/effect/spawner/random/halflife/loot/ammo,
/turf/open/floor/plating/indoor/concrete/small,
/area/halflife/indoors/sewer)
"d" = (
/obj/effect/decal/cleanable/greenglow/filled,
/turf/open/floor/plating/indoor/concrete/bricks,
/area/halflife/indoors/sewer)
"f" = (
/obj/effect/decal/cleanable/greenglow/filled,
/turf/open/floor/plating/indoor/concrete/small,
/area/halflife/indoors/sewer)
"h" = (
/obj/effect/spawner/random/halflife/loot,
/turf/open/floor/plating/indoor/concrete/small,
/area/halflife/indoors/sewer)
"i" = (
/obj/structure/barricade/wooden,
/turf/open/floor/plating/indoor/concrete/small,
/area/halflife/indoors/sewer)
"k" = (
/obj/effect/spawner/random/halflife/loot,
/turf/open/floor/plating/indoor/concrete/bricks,
/area/halflife/indoors/sewer)
"q" = (
/obj/structure/halflife/barrel/triple/waste/two,
/turf/open/floor/plating/indoor/concrete/small,
/area/halflife/indoors/sewer)
"t" = (
/obj/structure/halflife/barrel/single/toxic/four,
/obj/effect/decal/cleanable/greenglow/filled,
/turf/open/floor/plating/indoor/concrete/bricks,
/area/halflife/indoors/sewer)
"u" = (
/obj/structure/halflife/barrel/single/toxic/one,
/turf/open/floor/plating/indoor/concrete/bricks,
/area/halflife/indoors/sewer)
"w" = (
/obj/structure/halflife/barrel/single/toxic/two,
/turf/open/floor/plating/indoor/concrete/bricks,
/area/halflife/indoors/sewer)
"z" = (
/turf/open/floor/plating/indoor/concrete/small,
/area/halflife/indoors/sewer)
"E" = (
/turf/closed/wall/halflife/metal,
/area/halflife/indoors/sewer)
"F" = (
/obj/structure/halflife/barrel/single/toxic/two,
/turf/open/floor/plating/indoor/concrete/small,
/area/halflife/indoors/sewer)
"I" = (
/turf/template_noop,
/area/template_noop)
"J" = (
/obj/machinery/door/unpowered/halflife/metal{
	dir = 8
	},
/turf/open/floor/plating/indoor/concrete/small,
/area/halflife/indoors/sewer)
"L" = (
/turf/open/floor/plating/indoor/concrete/bricks,
/area/halflife/indoors/sewer)
"N" = (
/obj/structure/halflife/barrel/single/toxic/one,
/turf/open/floor/plating/indoor/concrete/small,
/area/halflife/indoors/sewer)
"O" = (
/obj/modular_map_connector,
/turf/template_noop,
/area/template_noop)
"U" = (
/obj/structure/halflife/barrel/single/toxic/three,
/turf/open/floor/plating/indoor/concrete/bricks,
/area/halflife/indoors/sewer)

(1,1,1) = {"
I
I
I
I
I
I
I
I
I
I
I
O
"}
(2,1,1) = {"
I
E
E
E
E
E
E
E
J
E
E
I
"}
(3,1,1) = {"
I
E
f
z
z
F
E
L
z
L
E
I
"}
(4,1,1) = {"
I
E
c
z
N
z
E
L
z
L
E
I
"}
(5,1,1) = {"
I
E
z
z
f
h
E
t
z
L
E
I
"}
(6,1,1) = {"
I
E
N
z
z
N
E
E
f
L
E
I
"}
(7,1,1) = {"
I
E
f
z
i
z
q
E
z
w
E
I
"}
(8,1,1) = {"
I
E
E
E
E
i
E
E
i
L
E
I
"}
(9,1,1) = {"
I
E
L
L
k
z
f
i
z
d
E
I
"}
(10,1,1) = {"
I
E
d
u
L
L
u
E
L
U
E
I
"}
(11,1,1) = {"
I
E
E
E
E
E
E
E
E
E
E
I
"}
(12,1,1) = {"
I
I
I
I
I
I
I
I
I
I
I
I
"}
