//MAP CONVERTED BY dmm2tgm.py THIS HEADER COMMENT PREVENTS RECONVERSION, DO NOT REMOVE
"b" = (
/turf/open/floor/plating/indoor/metal/grate,
/area/halflife/indoors/sewer)
"e" = (
/obj/structure/halflife/barrel/double/grey/two,
/turf/open/floor/plating/indoor/metal/plate,
/area/halflife/indoors/sewer)
"f" = (
/obj/structure/halflife/barrel/triple/grey/two,
/turf/open/floor/plating/indoor/metal/plate,
/area/halflife/indoors/sewer)
"h" = (
/obj/modular_map_connector,
/turf/template_noop,
/area/template_noop)
"j" = (
/mob/living/simple_animal/hostile/halflife/zombie,
/turf/open/floor/plating/indoor/concrete/bricks,
/area/halflife/indoors/sewer)
"l" = (
/obj/structure/chair/halflife/metal/blue{
	dir = 4
	},
/turf/open/floor/plating/indoor/concrete/bricks,
/area/halflife/indoors/sewer)
"t" = (
/turf/open/floor/plating/indoor/metal/plate,
/area/halflife/indoors/sewer)
"u" = (
/obj/structure/table/halflife/metal/heavy,
/turf/open/floor/plating/indoor/metal/plate,
/area/halflife/indoors/sewer)
"y" = (
/obj/machinery/light/small{
	dir = 1
	},
/turf/open/floor/plating/indoor/concrete/bricks,
/area/halflife/indoors/sewer)
"z" = (
/obj/effect/spawner/random/halflife/loot,
/obj/structure/table/halflife/metal/heavy,
/turf/open/floor/plating/indoor/metal/plate,
/area/halflife/indoors/sewer)
"A" = (
/turf/open/floor/plating/indoor/concrete/bricks,
/area/halflife/indoors/sewer)
"E" = (
/obj/machinery/door/unpowered/halflife/metal{
	dir = 8
	},
/turf/open/floor/plating/indoor/metal/grate,
/area/halflife/indoors/sewer)
"F" = (
/obj/structure/table/halflife/metal/heavy,
/obj/effect/spawner/random/halflife/loot,
/turf/open/floor/plating/indoor/metal/plate,
/area/halflife/indoors/sewer)
"G" = (
/obj/structure/halflife/barrel/triple/grey/three,
/turf/open/floor/plating/indoor/metal/plate,
/area/halflife/indoors/sewer)
"I" = (
/obj/machinery/door/unpowered/halflife/metal,
/turf/open/floor/plating/indoor/metal/grate,
/area/halflife/indoors/sewer)
"J" = (
/obj/effect/spawner/random/halflife/loot/rare,
/obj/structure/table/halflife/metal/heavy,
/turf/open/floor/plating/indoor/metal/plate,
/area/halflife/indoors/sewer)
"M" = (
/obj/effect/decal/cleanable/blood/old,
/turf/open/floor/plating/indoor/concrete/bricks,
/area/halflife/indoors/sewer)
"N" = (
/turf/template_noop,
/area/template_noop)
"S" = (
/turf/closed/wall/halflife/sewer,
/area/halflife/indoors/sewer)
"Y" = (
/obj/structure/table/halflife/metal/grate,
/turf/open/floor/plating/indoor/concrete/bricks,
/area/halflife/indoors/sewer)

(1,1,1) = {"
N
N
N
N
N
N
N
N
N
N
N
h
"}
(2,1,1) = {"
N
S
S
S
S
S
S
S
E
S
S
N
"}
(3,1,1) = {"
N
S
f
t
e
S
A
A
b
A
S
N
"}
(4,1,1) = {"
N
S
t
t
t
I
b
b
b
A
S
N
"}
(5,1,1) = {"
N
S
t
t
t
S
A
A
A
j
S
N
"}
(6,1,1) = {"
N
S
t
t
t
S
S
y
M
A
S
N
"}
(7,1,1) = {"
N
S
t
t
t
z
S
A
A
A
S
N
"}
(8,1,1) = {"
N
S
t
t
t
F
S
A
A
l
S
N
"}
(9,1,1) = {"
N
S
t
t
t
u
S
j
A
Y
S
N
"}
(10,1,1) = {"
N
S
G
t
t
J
S
Y
Y
Y
S
N
"}
(11,1,1) = {"
N
S
S
S
S
S
S
S
S
S
S
N
"}
(12,1,1) = {"
N
N
N
N
N
N
N
N
N
N
N
N
"}
