//MAP CONVERTED BY dmm2tgm.py THIS HEADER COMMENT PREVENTS RECONVERSION, DO NOT REMOVE
"a" = (
/turf/template_noop,
/area/template_noop)
"e" = (
/obj/structure/table/halflife/metal/grate,
/obj/effect/spawner/random/halflife/loot/scrap,
/turf/open/floor/plating/indoor/concrete/bricks,
/area/halflife/indoors/sewer)
"f" = (
/obj/structure/alien/weeds/node,
/turf/open/floor/plating/indoor/concrete/bricks,
/area/halflife/indoors/sewer)
"g" = (
/obj/structure/flora/ash/stem_shroom,
/turf/open/floor/plating/indoor/concrete/bricks,
/area/halflife/indoors/sewer)
"j" = (
/obj/structure/halflife/trash/garbage,
/turf/open/floor/plating/indoor/metal/grate,
/area/halflife/indoors/sewer)
"l" = (
/obj/structure/halflife/trash/papers/two{
	dir = 1
	},
/turf/open/floor/plating/indoor/metal/grate,
/area/halflife/indoors/sewer)
"m" = (
/obj/structure/table/halflife/metal/grate,
/obj/effect/spawner/random/halflife/loot/heal,
/turf/open/floor/plating/indoor/metal/grate,
/area/halflife/indoors/sewer)
"n" = (
/obj/structure/table/halflife/metal/grate,
/obj/effect/spawner/random/halflife/loot/clothing,
/turf/open/floor/plating/indoor/metal/grate,
/area/halflife/indoors/sewer)
"s" = (
/obj/structure/flora/xen/tinyshrooms,
/turf/open/floor/plating/indoor/concrete/bricks,
/area/halflife/indoors/sewer)
"v" = (
/turf/open/floor/plating/indoor/metal/grate,
/area/halflife/indoors/sewer)
"w" = (
/obj/structure/flora/xen/mound,
/turf/open/floor/plating/indoor/concrete/bricks,
/area/halflife/indoors/sewer)
"A" = (
/turf/closed/wall/halflife/sewer,
/area/halflife/indoors/sewer)
"B" = (
/obj/structure/halflife/trash/papers/two{
	dir = 8
	},
/turf/open/floor/plating/indoor/concrete/bricks,
/area/halflife/indoors/sewer)
"C" = (
/obj/machinery/door/unpowered/halflife/metal,
/turf/open/floor/plating/indoor/metal/grate,
/area/halflife/indoors/sewer)
"G" = (
/obj/structure/table/halflife/metal/grate,
/obj/effect/spawner/random/halflife/loot/consumables,
/turf/open/floor/plating/indoor/concrete/bricks,
/area/halflife/indoors/sewer)
"J" = (
/obj/structure/flora/xen/cougher,
/turf/open/floor/plating/indoor/concrete/bricks,
/area/halflife/indoors/sewer)
"O" = (
/turf/open/floor/plating/indoor/concrete/bricks,
/area/halflife/indoors/sewer)
"Q" = (
/obj/structure/halflife/trash/garbage,
/turf/open/floor/plating/indoor/concrete/bricks,
/area/halflife/indoors/sewer)
"R" = (
/obj/machinery/door/unpowered/halflife/metal{
	dir = 8
	},
/turf/open/floor/plating/indoor/concrete/bricks,
/area/halflife/indoors/sewer)
"X" = (
/obj/modular_map_connector,
/turf/template_noop,
/area/template_noop)

(1,1,1) = {"
a
a
a
a
a
a
a
a
a
a
a
X
"}
(2,1,1) = {"
a
A
A
A
A
A
A
A
R
A
A
a
"}
(3,1,1) = {"
a
A
m
n
A
J
O
O
O
Q
A
a
"}
(4,1,1) = {"
a
A
O
g
A
O
O
O
O
J
A
a
"}
(5,1,1) = {"
a
A
B
O
A
O
f
J
O
O
A
a
"}
(6,1,1) = {"
a
A
f
O
A
A
w
A
A
A
A
a
"}
(7,1,1) = {"
a
A
J
O
A
v
O
O
O
s
A
a
"}
(8,1,1) = {"
a
A
O
O
A
l
O
f
O
O
A
a
"}
(9,1,1) = {"
a
A
O
O
C
v
J
O
O
G
A
a
"}
(10,1,1) = {"
a
A
s
Q
A
j
O
O
O
e
A
a
"}
(11,1,1) = {"
a
A
A
A
A
A
A
A
A
A
A
a
"}
(12,1,1) = {"
a
a
a
a
a
a
a
a
a
a
a
a
"}
