//MAP CONVERTED BY dmm2tgm.py THIS HEADER COMMENT PREVENTS RECONVERSION, DO NOT REMOVE
"d" = (
/obj/machinery/door/unpowered/halflife/metal{
	dir = 8
	},
/turf/open/floor/plating/indoor/concrete/bricks,
/area/halflife/indoors/sewer)
"g" = (
/obj/effect/decal/cleanable/blood/tracks{
	dir = 4
	},
/turf/open/floor/plating/indoor/concrete/bricks,
/area/halflife/indoors/sewer)
"j" = (
/mob/living/simple_animal/hostile/halflife/zombie/zombine,
/turf/open/floor/plating/indoor/concrete/bricks,
/area/halflife/indoors/sewer)
"l" = (
/turf/open/floor/plating/indoor/metal/pipe,
/area/halflife/indoors/sewer)
"m" = (
/obj/effect/decal/cleanable/blood/tracks{
	dir = 4
	},
/obj/effect/decal/cleanable/blood/tracks,
/turf/open/floor/plating/indoor/concrete/bricks,
/area/halflife/indoors/sewer)
"s" = (
/turf/open/floor/plating/indoor/concrete/bricks,
/area/halflife/indoors/sewer)
"t" = (
/obj/effect/spawner/random/halflife/loot/ammo,
/turf/open/floor/plating/indoor/concrete/bricks,
/area/halflife/indoors/sewer)
"w" = (
/obj/effect/decal/cleanable/blood/tracks,
/obj/machinery/door/unpowered/halflife/metal,
/turf/open/floor/plating/indoor/concrete/bricks,
/area/halflife/indoors/sewer)
"y" = (
/turf/closed/wall/halflife/metal,
/area/halflife/indoors/sewer)
"A" = (
/obj/machinery/light/small{
	dir = 8
	},
/turf/open/floor/plating/indoor/concrete/bricks,
/area/halflife/indoors/sewer)
"B" = (
/obj/machinery/door/unpowered/halflife/metal{
	dir = 8
	},
/turf/open/floor/plating/indoor/metal/grate,
/area/halflife/indoors/sewer)
"H" = (
/turf/open/floor/plating/indoor/metal/grate,
/area/halflife/indoors/sewer)
"O" = (
/obj/structure/table/halflife/no_smooth/cable_reel,
/obj/effect/spawner/random/halflife/loot/rare,
/turf/open/floor/plating/indoor/concrete/bricks,
/area/halflife/indoors/sewer)
"P" = (
/obj/modular_map_connector,
/turf/template_noop,
/area/template_noop)
"R" = (
/obj/machinery/light/small{
	dir = 1
	},
/turf/open/floor/plating/indoor/metal/pipe,
/area/halflife/indoors/sewer)
"U" = (
/obj/structure/halflife/trash/glass/basic,
/turf/open/floor/plating/indoor/concrete/bricks,
/area/halflife/indoors/sewer)
"W" = (
/obj/effect/decal/cleanable/blood/tracks,
/turf/open/floor/plating/indoor/concrete/bricks,
/area/halflife/indoors/sewer)
"Y" = (
/turf/template_noop,
/area/template_noop)
"Z" = (
/obj/effect/decal/cleanable/blood/tracks,
/turf/open/floor/plating/indoor/metal/grate,
/area/halflife/indoors/sewer)

(1,1,1) = {"
Y
Y
Y
Y
Y
Y
Y
Y
Y
Y
Y
P
"}
(2,1,1) = {"
Y
y
y
B
y
y
y
y
y
y
y
Y
"}
(3,1,1) = {"
Y
y
l
Z
Z
w
W
W
W
m
y
Y
"}
(4,1,1) = {"
Y
y
l
H
H
y
s
s
s
g
y
Y
"}
(5,1,1) = {"
Y
y
l
H
H
y
s
s
j
g
y
Y
"}
(6,1,1) = {"
Y
y
l
H
H
y
s
s
s
g
y
Y
"}
(7,1,1) = {"
Y
y
l
H
H
y
U
s
s
s
y
Y
"}
(8,1,1) = {"
Y
y
l
H
H
y
y
y
y
d
y
Y
"}
(9,1,1) = {"
Y
y
R
H
H
y
O
A
s
s
y
Y
"}
(10,1,1) = {"
Y
y
l
H
H
y
s
s
t
s
y
Y
"}
(11,1,1) = {"
Y
y
y
y
y
y
y
y
y
y
y
Y
"}
(12,1,1) = {"
Y
Y
Y
Y
Y
Y
Y
Y
Y
Y
Y
Y
"}
