//MAP CONVERTED BY dmm2tgm.py THIS HEADER COMMENT PREVENTS RECONVERSION, DO NOT REMOVE
"c" = (
/obj/structure/table/halflife/metal/heavy,
/turf/open/floor/plating/indoor/metal/industrial,
/area/halflife/indoors/sewer)
"m" = (
/obj/structure/halflife/trash/garbage,
/turf/open/floor/plating/indoor/concrete/small,
/area/halflife/indoors/sewer)
"o" = (
/turf/closed/wall/halflife/sewer,
/area/halflife/indoors/sewer)
"q" = (
/obj/structure/table/halflife/no_smooth/large/crafting/weaponbench,
/turf/open/floor/plating/indoor/metal/industrial,
/area/halflife/indoors/sewer)
"r" = (
/obj/structure/table/halflife/metal/heavy,
/obj/effect/spawner/random/halflife/loot,
/turf/open/floor/plating/indoor/metal/industrial,
/area/halflife/indoors/sewer)
"s" = (
/obj/structure/table/halflife/no_smooth/large/crafting/ammobench,
/turf/open/floor/plating/indoor/metal/industrial,
/area/halflife/indoors/sewer)
"t" = (
/obj/machinery/door/unpowered/halflife/metal{
	dir = 8
	},
/turf/open/floor/plating/indoor/concrete/small,
/area/halflife/indoors/sewer)
"D" = (
/obj/structure/table/halflife/metal/heavy,
/obj/structure/halflife/trash/papers/three,
/turf/open/floor/plating/indoor/metal/industrial,
/area/halflife/indoors/sewer)
"E" = (
/obj/structure/table/halflife/metal/alt,
/obj/effect/spawner/random/halflife/loot/heal,
/turf/open/floor/plating/indoor/concrete/small,
/area/halflife/indoors/sewer)
"F" = (
/obj/structure/halflife/barrel/double/grey/two,
/turf/open/floor/plating/indoor/concrete/small,
/area/halflife/indoors/sewer)
"G" = (
/obj/machinery/light/small{
	dir = 4
	},
/turf/open/floor/plating/indoor/metal/industrial,
/area/halflife/indoors/sewer)
"K" = (
/obj/structure/halflife/barrel/double/grey/one,
/turf/open/floor/plating/indoor/concrete/small,
/area/halflife/indoors/sewer)
"L" = (
/turf/open/floor/plating/indoor/concrete/bricks,
/area/halflife/indoors/sewer)
"M" = (
/obj/structure/halflife/barrel/triple/grey,
/turf/open/floor/plating/indoor/concrete/small,
/area/halflife/indoors/sewer)
"O" = (
/turf/template_noop,
/area/template_noop)
"P" = (
/obj/structure/table/halflife/metal/alt,
/turf/open/floor/plating/indoor/concrete/small,
/area/halflife/indoors/sewer)
"S" = (
/mob/living/basic/halflife/zombie/poison,
/turf/open/floor/plating/indoor/concrete/small,
/area/halflife/indoors/sewer)
"V" = (
/obj/machinery/door/unpowered/halflife/metal,
/turf/open/floor/plating/indoor/concrete/small,
/area/halflife/indoors/sewer)
"W" = (
/obj/modular_map_connector,
/turf/template_noop,
/area/template_noop)
"X" = (
/turf/open/floor/plating/indoor/concrete/small,
/area/halflife/indoors/sewer)
"Y" = (
/turf/open/floor/plating/indoor/metal/industrial,
/area/halflife/indoors/sewer)

(1,1,1) = {"
O
O
O
O
O
O
O
O
O
O
O
W
"}
(2,1,1) = {"
O
o
o
o
o
o
o
o
o
t
o
O
"}
(3,1,1) = {"
O
o
E
X
X
o
m
X
X
X
o
O
"}
(4,1,1) = {"
O
o
P
X
X
V
X
L
L
X
o
O
"}
(5,1,1) = {"
O
o
P
X
X
o
X
X
X
m
o
O
"}
(6,1,1) = {"
O
o
K
S
X
o
o
o
o
o
o
O
"}
(7,1,1) = {"
O
o
F
X
X
V
Y
D
c
r
o
O
"}
(8,1,1) = {"
O
o
M
X
X
o
Y
Y
Y
Y
o
O
"}
(9,1,1) = {"
O
o
X
X
X
o
q
Y
s
Y
o
O
"}
(10,1,1) = {"
O
o
P
P
P
o
Y
G
Y
Y
o
O
"}
(11,1,1) = {"
O
o
o
o
o
o
o
o
o
o
o
O
"}
(12,1,1) = {"
O
O
O
O
O
O
O
O
O
O
O
O
"}
