//MAP CONVERTED BY dmm2tgm.py THIS HEADER COMMENT PREVENTS RECONVERSION, DO NOT REMOVE
"a" = (
/obj/structure/halflife/trash/papers,
/turf/open/floor/plating/indoor/concrete/small,
/area/halflife/indoors/sewer)
"i" = (
/obj/structure/table/halflife/no_smooth/large/crafting/weaponbench,
/turf/open/floor/plating/indoor/concrete/small,
/area/halflife/indoors/sewer)
"l" = (
/obj/structure/table/halflife/metal/heavy,
/obj/effect/spawner/random/halflife/loot/ammo,
/turf/open/floor/plating/indoor/concrete/small,
/area/halflife/indoors/sewer)
"o" = (
/obj/modular_map_connector,
/turf/template_noop,
/area/template_noop)
"p" = (
/obj/structure/table/halflife/metal/heavy,
/turf/open/floor/plating/indoor/concrete/small,
/area/halflife/indoors/sewer)
"t" = (
/obj/structure/halflife/trash/cardboard,
/turf/open/floor/plating/indoor/concrete/bricks,
/area/halflife/indoors/sewer)
"v" = (
/obj/structure/table/halflife/metal/heavy,
/obj/structure/halflife/trash/food/dinner,
/turf/open/floor/plating/indoor/concrete/small,
/area/halflife/indoors/sewer)
"x" = (
/obj/machinery/light/small{
	dir = 1
	},
/turf/open/floor/plating/indoor/concrete/bricks,
/area/halflife/indoors/sewer)
"A" = (
/turf/closed/wall/halflife/metal,
/area/halflife/indoors/sewer)
"E" = (
/turf/template_noop,
/area/template_noop)
"F" = (
/obj/machinery/door/unpowered/halflife/metal{
	dir = 8
	},
/turf/open/floor/plating/indoor/concrete/bricks,
/area/halflife/indoors/sewer)
"L" = (
/turf/open/floor/plating/indoor/concrete/bricks,
/area/halflife/indoors/sewer)
"M" = (
/obj/structure/halflife/trash/papers/three,
/turf/open/floor/plating/indoor/concrete/small,
/area/halflife/indoors/sewer)
"Q" = (
/turf/open/floor/plating/indoor/concrete/small,
/area/halflife/indoors/sewer)
"W" = (
/obj/machinery/door/unpowered/halflife/metal{
	keylock = 1;
	locked = 1
	},
/turf/open/floor/plating/indoor/concrete/small,
/area/halflife/indoors/sewer)
"Y" = (
/obj/structure/table/halflife/metal/heavy,
/obj/effect/spawner/random/halflife/loot,
/turf/open/floor/plating/indoor/concrete/small,
/area/halflife/indoors/sewer)
"Z" = (
/obj/structure/halflife/trash/bricks,
/turf/open/floor/plating/indoor/concrete/small,
/area/halflife/indoors/sewer)

(1,1,1) = {"
E
E
E
E
E
E
E
E
E
E
E
o
"}
(2,1,1) = {"
E
A
A
A
A
A
A
F
A
A
A
E
"}
(3,1,1) = {"
E
A
p
p
Y
Q
A
L
L
L
A
E
"}
(4,1,1) = {"
E
A
v
Q
Q
Q
A
L
Q
L
A
E
"}
(5,1,1) = {"
E
A
Y
Q
Q
Q
W
L
Q
L
A
E
"}
(6,1,1) = {"
E
A
p
Q
Q
Q
A
L
Q
L
A
E
"}
(7,1,1) = {"
E
A
Q
Q
Q
Q
A
x
Q
L
A
E
"}
(8,1,1) = {"
E
A
Q
Z
Q
Y
A
L
Q
L
A
E
"}
(9,1,1) = {"
E
A
i
a
Q
l
A
L
Q
L
A
E
"}
(10,1,1) = {"
E
A
Q
Q
M
p
A
L
L
t
A
E
"}
(11,1,1) = {"
E
A
A
A
A
A
A
A
A
A
A
E
"}
(12,1,1) = {"
E
E
E
E
E
E
E
E
E
E
E
E
"}
