//MAP CONVERTED BY dmm2tgm.py THIS HEADER COMMENT PREVENTS RECONVERSION, DO NOT REMOVE
"a" = (
/turf/open/floor/plating/ground/sidewalk,
/area/space)
"b" = (
/obj/structure/railing/halflife/wood{
	dir = 8
	},
/turf/open/floor/plating/indoor/woodc/wide,
/area/space)
"d" = (
/turf/open/floor/plating/indoor/concrete/sewer,
/area/space)
"e" = (
/turf/open/floor/plating/ground/dirt,
/area/space)
"f" = (
/obj/structure/railing/halflife/solo{
	dir = 1
	},
/turf/open/floor/plating/indoor/metal/smooth,
/area/space)
"i" = (
/obj/effect/landmark/deployments_refugee,
/turf/open/floor/plating/indoor/woodc/wide,
/area/space)
"j" = (
/obj/structure/stairs/halflife/wood,
/turf/open/floor/plating/indoor/woodc/wide,
/area/space)
"k" = (
/turf/closed/wall/halflife/metal,
/area/space)
"l" = (
/obj/structure/stairs/halflife/concrete{
	dir = 8
	},
/turf/open/floor/plating/indoor/concrete/sewer,
/area/space)
"m" = (
/obj/structure/railing/halflife/wood,
/turf/open/floor/plating/indoor/woodc/wide,
/area/space)
"n" = (
/obj/machinery/turnstile/brig/halflife/forcefield/armory{
	dir = 1
	},
/turf/open/floor/plating/indoor/woodc/wide,
/area/space)
"o" = (
/obj/structure/stairs/halflife/combine{
	dir = 1
	},
/turf/open/floor/plating/indoor/metal/smooth,
/area/space)
"q" = (
/obj/structure/stairs/halflife/concrete,
/turf/open/floor/plating/indoor/concrete,
/area/space)
"r" = (
/obj/structure/stairs/halflife/concrete{
	dir = 4
	},
/turf/open/floor/plating/indoor/concrete/sewer,
/area/space)
"s" = (
/obj/structure/halflife/barrel/triple/grey,
/turf/open/floor/plating/indoor/woodc/wide,
/area/space)
"w" = (
/turf/open/floor/plating/indoor/woodc/stairs{
	dir = 1
	},
/area/space)
"x" = (
/turf/open/openspace,
/area/space)
"A" = (
/turf/cordon,
/area/space)
"B" = (
/turf/closed/wall/halflife/wood,
/area/space)
"C" = (
/obj/structure/stairs/halflife/combine{
	dir = 4
	},
/turf/open/floor/plating/indoor/metal/smooth,
/area/space)
"D" = (
/turf/open/floor/plating/indoor/metal/smooth,
/area/space)
"E" = (
/turf/open/floor/plating/indoor/concrete,
/area/space)
"G" = (
/turf/open/floor/plating/indoor/woodc/wide,
/area/space)
"I" = (
/turf/open/floor/plating/indoor/woodc/stairs{
	dir = 8
	},
/area/space)
"J" = (
/obj/structure/railing/halflife/wood{
	dir = 4
	},
/turf/open/floor/plating/indoor/woodc/wide,
/area/space)
"K" = (
/turf/closed/wall/halflife/sewer,
/area/space)
"M" = (
/obj/structure/stairs/halflife/wood{
	dir = 8
	},
/turf/open/floor/plating/indoor/woodc/wide,
/area/space)
"N" = (
/obj/machinery/turnstile/brig/halflife/forcefield/armory,
/turf/open/floor/plating/indoor/metal/smooth,
/area/space)
"O" = (
/obj/machinery/turnstile/brig/halflife/forcefield/armory{
	dir = 8
	},
/turf/open/floor/plating/indoor/metal/smooth,
/area/space)
"P" = (
/turf/closed/indestructible/rock,
/area/space)
"Q" = (
/obj/structure/stairs/halflife/wood{
	dir = 4
	},
/turf/open/floor/plating/indoor/woodc/wide,
/area/space)
"S" = (
/turf/open/halflife/water/shallow,
/area/space)
"U" = (
/obj/structure/halflife/barrel/triple/grey,
/turf/open/floor/plating/indoor/metal/smooth,
/area/space)
"V" = (
/obj/machinery/turnstile/brig/halflife/forcefield/armory{
	dir = 4
	},
/turf/open/floor/plating/indoor/woodc/wide,
/area/space)
"W" = (
/obj/effect/landmark/deployments_metrocop,
/turf/open/floor/plating/indoor/metal/smooth,
/area/space)
"X" = (
/turf/open/floor/plating/indoor/woodc/stairs{
	dir = 4
	},
/area/space)
"Y" = (
/turf/open/floor/plating/indoor/concrete/stairs,
/area/space)

(1,1,1) = {"
P
P
P
P
P
P
P
P
P
P
P
P
P
P
P
P
P
P
P
P
P
P
P
P
P
P
P
P
P
P
P
P
P
P
P
P
P
P
P
P
P
P
P
P
P
P
P
P
P
P
P
P
P
P
P
P
P
P
P
P
P
P
P
P
P
P
P
P
P
P
P
P
P
P
P
P
P
P
P
P
P
P
P
P
P
P
P
P
P
P
P
P
P
P
P
P
"}
(2,1,1) = {"
P
P
P
P
P
P
P
K
K
K
K
K
K
K
K
K
K
K
K
K
P
P
K
K
K
K
K
K
K
K
K
P
P
P
P
P
P
P
P
P
P
P
P
K
K
K
K
K
K
K
K
K
K
K
P
P
P
P
P
P
P
P
P
P
P
P
P
P
P
P
P
P
P
P
P
P
P
P
P
P
P
P
P
P
P
P
P
P
P
P
P
P
P
P
P
P
"}
(3,1,1) = {"
P
P
P
P
P
P
P
K
E
E
E
E
E
E
E
E
E
E
E
K
P
P
K
d
d
d
d
d
d
d
K
P
P
P
P
P
P
P
P
P
P
P
P
K
S
S
S
S
S
S
S
S
S
K
P
P
P
P
P
P
P
P
P
P
P
P
P
P
P
P
P
P
P
P
P
P
P
P
P
P
P
P
P
P
P
P
P
P
P
P
P
P
P
P
P
P
"}
(4,1,1) = {"
P
P
P
P
P
P
P
K
E
E
E
E
E
E
E
E
E
E
E
K
P
P
K
d
d
d
S
S
S
d
K
P
P
P
P
P
P
P
P
P
P
P
P
K
S
S
S
S
S
S
S
S
S
K
P
P
P
P
P
P
P
P
P
P
P
P
P
P
P
P
P
P
P
P
P
P
P
P
P
P
P
P
P
P
P
P
P
P
P
P
P
P
P
P
P
P
"}
(5,1,1) = {"
P
P
P
P
P
P
P
K
E
E
K
E
E
E
E
E
E
E
E
K
P
P
K
r
r
d
S
S
S
d
K
P
P
P
P
P
P
P
P
P
P
P
P
K
S
S
S
S
S
S
S
S
S
K
P
P
P
P
P
P
P
P
P
P
P
P
P
P
P
P
P
P
P
P
P
P
P
P
P
P
P
P
P
P
P
P
P
P
P
P
P
P
P
P
P
P
"}
(6,1,1) = {"
P
P
P
P
P
P
P
K
E
E
K
E
E
E
E
E
E
E
E
K
P
P
K
K
K
d
S
S
S
d
K
P
P
P
P
P
P
P
P
P
P
P
P
K
S
S
S
S
S
S
S
S
S
K
P
P
P
P
P
P
P
P
P
P
P
P
P
P
P
P
P
P
P
P
P
P
P
P
P
P
P
P
P
P
P
P
P
P
P
P
P
P
P
P
P
P
"}
(7,1,1) = {"
P
K
K
K
K
K
K
K
E
E
K
E
E
E
E
E
E
E
E
K
P
P
P
P
K
d
S
S
S
d
K
P
P
P
P
P
P
P
P
P
P
P
P
K
S
S
S
S
S
S
S
S
S
K
P
P
P
P
P
P
P
P
P
P
P
P
P
P
P
P
P
P
P
P
P
P
P
P
P
P
P
P
P
P
P
P
P
P
P
P
P
P
P
P
P
P
"}
(8,1,1) = {"
P
K
E
E
E
q
K
K
E
E
K
E
E
E
E
E
E
E
E
K
P
P
P
P
K
d
S
S
S
d
K
P
P
P
P
P
P
P
P
P
P
P
P
K
S
S
S
S
S
S
S
S
S
K
P
P
P
P
P
P
P
P
P
P
P
P
P
P
P
P
P
P
P
P
P
P
P
P
P
P
P
P
P
P
P
P
P
P
P
P
P
P
P
P
P
P
"}
(9,1,1) = {"
P
K
E
E
E
q
K
K
E
E
K
E
E
E
E
E
E
E
E
K
P
P
P
P
K
d
S
S
S
d
K
P
P
P
P
P
P
P
P
P
P
P
P
K
S
S
S
S
S
S
S
S
S
K
P
P
P
P
P
P
P
P
P
P
P
P
P
P
P
K
K
K
K
K
K
K
K
K
K
K
K
K
K
P
P
P
P
P
P
P
P
P
P
P
P
P
"}
(10,1,1) = {"
P
K
E
E
E
q
K
K
E
E
K
K
K
K
K
K
K
E
E
K
P
P
P
P
K
d
S
S
S
d
K
P
P
P
P
P
P
P
P
P
P
P
P
K
S
S
S
S
S
S
S
S
S
K
P
P
P
P
P
P
P
P
P
P
P
P
P
P
P
K
d
d
d
d
d
d
d
d
d
d
d
d
K
P
P
P
P
P
P
P
P
P
P
P
P
P
"}
(11,1,1) = {"
P
K
E
E
K
K
K
K
E
E
E
E
E
E
E
E
E
E
E
K
P
P
P
P
K
d
S
S
S
d
K
P
P
P
P
P
P
P
P
P
P
P
P
K
S
S
S
S
S
S
S
S
S
K
P
P
P
P
P
P
P
P
P
P
P
P
P
P
P
K
d
d
d
d
d
d
d
d
d
d
d
d
K
P
P
P
P
P
P
P
P
P
P
P
P
P
"}
(12,1,1) = {"
P
K
E
E
E
E
E
E
E
E
E
E
E
E
E
E
E
E
E
K
P
P
P
P
K
d
S
S
S
d
K
P
P
P
P
P
P
P
P
P
P
P
P
K
S
S
S
S
S
S
S
S
S
K
P
P
P
P
P
P
P
P
P
P
P
P
P
P
P
K
d
d
d
d
d
d
d
d
d
d
d
d
K
P
P
P
P
P
P
P
P
P
P
P
P
P
"}
(13,1,1) = {"
P
K
E
E
E
E
E
E
E
E
E
E
E
K
K
K
K
K
K
K
P
P
P
P
K
d
S
S
S
d
K
P
P
P
P
P
P
P
P
P
P
P
P
K
S
S
S
S
S
S
S
S
S
K
P
P
P
P
P
P
P
P
P
P
P
P
P
P
P
K
d
d
d
d
d
d
d
d
d
d
d
d
K
P
P
P
P
P
P
P
P
P
P
P
P
P
"}
(14,1,1) = {"
P
K
E
E
E
E
E
E
E
E
E
E
E
K
P
P
P
P
K
K
K
K
K
K
K
d
S
S
S
d
K
P
P
P
P
P
P
P
P
P
P
P
P
K
S
S
S
S
S
S
S
S
S
K
P
P
P
P
P
P
P
P
P
P
P
P
P
P
P
K
d
d
d
d
d
d
d
d
d
d
d
d
K
P
P
P
P
P
P
P
P
P
P
P
P
P
"}
(15,1,1) = {"
P
K
K
K
K
K
K
K
E
E
E
E
E
K
P
P
P
P
K
d
d
d
d
d
K
d
S
S
S
d
K
K
K
K
K
K
K
K
K
K
K
K
K
K
S
S
S
S
S
S
S
S
S
K
K
K
K
K
K
K
K
K
K
K
K
K
K
K
K
K
K
d
d
d
d
d
d
d
d
d
d
d
K
P
P
P
P
P
P
P
P
P
P
P
P
P
"}
(16,1,1) = {"
P
K
E
E
E
E
E
E
E
E
E
E
E
K
P
P
P
P
K
d
d
d
d
d
d
d
S
S
S
d
d
d
d
d
d
d
d
d
d
d
d
d
d
d
S
S
S
S
S
S
S
S
S
d
d
d
d
d
d
d
d
d
d
d
d
d
d
d
d
d
d
d
d
d
d
d
d
d
d
d
d
d
K
P
P
P
P
P
P
P
P
P
P
P
P
P
"}
(17,1,1) = {"
P
K
E
E
E
E
E
E
E
E
E
E
E
K
P
P
P
P
K
d
d
d
d
d
d
d
S
S
S
S
S
S
S
S
S
S
S
S
S
S
S
S
S
S
S
S
S
S
S
S
S
S
S
S
S
S
S
S
S
S
S
S
S
S
S
S
S
S
S
S
S
S
S
S
S
d
d
d
d
d
d
d
K
P
P
P
P
P
P
P
P
P
P
P
P
P
"}
(18,1,1) = {"
P
K
E
E
E
E
E
E
E
E
E
E
E
K
P
P
P
P
K
d
d
d
d
d
d
d
S
S
S
S
S
S
S
S
S
S
S
S
S
S
S
S
S
S
S
S
S
S
S
S
S
S
S
S
S
S
S
S
S
S
S
S
S
S
S
S
S
S
S
S
S
S
S
S
S
d
d
d
d
d
d
d
K
P
P
P
P
P
P
P
P
P
P
P
P
P
"}
(19,1,1) = {"
P
K
E
E
E
E
K
K
K
K
K
K
K
K
P
P
P
P
K
d
d
d
d
d
d
d
S
S
S
S
S
S
S
S
S
S
S
S
S
S
S
S
S
S
S
S
S
S
S
S
S
S
S
S
S
S
S
S
S
S
S
S
S
S
S
S
S
S
S
S
S
S
S
S
S
d
d
d
d
d
d
d
K
P
P
P
P
P
P
P
P
P
P
P
P
P
"}
(20,1,1) = {"
P
K
E
E
E
E
K
P
P
P
P
P
P
P
P
P
P
P
K
d
d
d
d
d
d
d
d
d
d
d
d
d
d
d
d
d
d
d
d
d
d
d
d
d
S
S
S
S
S
S
S
S
S
d
d
d
d
d
d
d
d
d
d
d
d
d
d
d
d
d
d
d
S
S
S
d
d
d
d
d
d
d
K
P
P
P
P
P
P
P
P
P
P
P
P
P
"}
(21,1,1) = {"
P
K
E
E
E
E
K
P
P
P
P
P
P
P
P
P
P
P
K
d
d
d
d
d
d
d
d
d
d
d
K
K
K
K
K
K
K
K
K
K
K
K
K
K
S
S
S
S
S
S
S
S
S
K
K
K
K
K
K
K
K
K
K
K
K
K
K
K
K
K
K
d
S
S
S
d
K
d
d
d
d
d
K
P
P
P
K
K
K
K
K
K
P
P
P
P
"}
(22,1,1) = {"
P
K
E
E
E
E
K
P
P
P
P
P
P
P
P
P
P
P
K
d
d
d
d
d
d
d
d
d
d
d
d
K
P
P
P
P
P
P
P
P
P
P
P
K
S
S
S
S
S
S
S
S
S
K
P
P
P
P
P
P
P
P
P
P
P
P
P
P
P
P
K
d
S
S
S
d
K
K
K
K
K
K
K
P
P
P
K
E
E
E
E
E
P
P
P
P
"}
(23,1,1) = {"
P
K
E
E
E
E
K
P
P
P
P
P
P
P
P
P
P
P
K
d
d
d
d
d
d
d
d
d
d
d
d
K
P
P
P
P
P
P
P
P
P
P
P
K
S
S
S
S
S
S
S
S
S
K
P
P
P
P
P
P
P
P
P
P
P
P
P
P
P
P
K
d
S
S
S
d
K
P
P
P
P
P
P
P
P
P
K
E
E
E
E
E
P
P
P
P
"}
(24,1,1) = {"
P
K
E
E
E
E
K
P
P
P
P
P
P
P
P
P
P
P
K
d
d
d
d
d
d
d
d
d
d
d
d
K
P
P
P
P
P
P
P
P
P
P
P
K
S
S
S
S
S
S
S
S
S
K
P
P
P
P
P
P
P
P
P
P
P
P
P
P
P
P
K
d
S
S
S
d
K
P
P
P
P
P
P
P
P
P
K
E
E
E
E
E
P
P
P
P
"}
(25,1,1) = {"
P
K
E
E
E
E
K
P
P
P
P
P
P
P
P
P
P
P
K
d
d
d
d
d
d
d
d
d
d
d
d
K
P
P
P
P
P
P
P
P
P
P
P
K
S
S
S
S
S
S
S
S
S
K
P
P
P
P
P
P
P
P
P
P
P
P
P
P
P
P
K
d
S
S
S
d
K
P
P
P
P
P
P
P
P
P
K
E
E
K
K
K
P
P
P
P
"}
(26,1,1) = {"
P
K
E
E
E
E
K
P
P
P
P
P
P
P
P
P
P
P
K
d
d
d
d
d
d
d
d
d
d
d
d
K
P
P
P
P
P
P
P
P
P
P
P
K
S
S
S
S
S
S
S
S
S
K
P
P
P
P
P
P
P
P
P
P
P
P
P
P
P
P
K
d
S
S
S
d
K
P
P
P
P
P
P
P
P
P
K
E
E
E
q
K
P
P
P
P
"}
(27,1,1) = {"
P
K
E
E
E
E
K
P
P
P
P
P
P
P
P
P
P
P
K
K
K
K
K
K
K
K
K
K
K
K
K
K
P
P
P
P
P
P
P
P
P
P
P
K
S
S
S
S
S
S
S
S
S
K
P
P
P
P
P
P
P
P
P
P
P
P
P
P
P
P
K
d
S
S
S
d
K
P
P
P
P
P
P
P
P
P
K
E
E
E
q
K
P
P
P
P
"}
(28,1,1) = {"
P
K
K
K
K
K
K
P
P
P
P
P
P
P
P
P
P
P
P
P
P
P
P
P
P
P
P
P
P
P
P
P
P
P
P
P
P
P
P
P
P
P
P
K
S
S
S
S
S
S
S
S
S
K
P
P
P
P
P
P
P
P
P
P
P
P
P
P
P
P
K
d
S
S
S
d
K
P
P
P
P
P
P
P
P
P
K
E
E
E
q
K
P
P
P
P
"}
(29,1,1) = {"
P
P
P
P
P
P
P
P
P
P
P
P
P
P
P
P
P
P
P
P
P
P
P
P
P
P
P
P
P
P
P
P
P
P
P
P
P
P
P
P
P
P
P
K
S
S
S
S
S
S
S
S
S
K
P
P
P
P
P
P
P
P
P
P
P
P
P
P
P
P
K
d
S
S
S
d
K
P
P
P
P
P
P
P
P
P
K
K
K
K
K
K
P
P
P
P
"}
(30,1,1) = {"
P
P
P
P
P
P
P
P
P
P
P
P
P
P
P
P
P
P
P
P
P
P
P
P
P
P
P
P
P
P
P
P
P
P
P
P
P
P
P
P
P
P
P
K
S
S
S
S
S
S
S
S
S
K
P
P
P
P
P
P
P
P
P
P
P
P
P
P
K
K
K
d
S
S
S
d
K
P
P
P
P
P
P
P
P
P
P
P
P
P
P
P
P
P
P
P
"}
(31,1,1) = {"
P
P
P
P
P
P
P
P
P
P
P
P
P
P
P
P
P
P
P
P
P
P
P
P
P
P
P
P
P
P
P
P
P
P
P
P
P
P
P
P
P
P
P
K
S
S
S
S
S
S
S
S
S
K
P
P
P
P
P
P
P
P
P
P
P
P
P
P
K
l
l
d
S
S
S
d
K
P
P
P
P
P
P
P
P
P
P
P
P
P
P
P
P
P
P
P
"}
(32,1,1) = {"
P
P
P
P
P
P
P
P
P
P
P
P
P
P
P
P
P
P
P
P
P
P
P
P
P
P
P
P
P
P
P
P
P
P
P
P
P
P
P
P
P
P
P
K
S
S
S
S
S
S
S
S
S
K
P
P
P
P
P
P
P
P
P
P
P
P
P
P
K
d
d
d
d
d
d
d
K
P
P
P
P
P
P
P
P
P
P
P
P
P
P
P
P
P
P
P
"}
(33,1,1) = {"
P
P
P
P
P
P
P
P
P
P
P
P
P
P
P
P
P
P
P
P
P
P
P
P
P
P
P
P
P
P
P
P
P
P
P
P
P
P
P
P
P
P
P
K
S
S
S
S
S
S
S
S
S
K
P
P
P
P
P
P
P
P
P
P
P
P
P
P
K
d
d
d
d
d
d
d
K
P
P
P
P
P
P
P
P
P
P
P
P
P
P
P
P
P
P
P
"}
(34,1,1) = {"
P
P
P
P
P
P
P
P
P
P
P
P
P
P
P
P
P
P
P
P
P
P
P
P
P
P
P
P
P
P
P
P
P
P
P
P
P
P
P
P
P
P
P
K
K
K
K
K
K
K
K
K
K
K
P
P
P
P
P
P
P
P
P
P
P
P
P
P
K
K
K
K
K
K
K
K
K
P
P
P
P
P
P
P
P
P
P
P
P
P
P
P
P
P
P
P
"}
(35,1,1) = {"
P
P
P
P
P
P
P
P
P
P
P
P
P
P
P
P
P
P
P
P
P
P
P
P
P
P
P
P
P
P
P
P
P
P
P
P
P
P
P
P
P
P
P
P
P
P
P
P
P
P
P
P
P
P
P
P
P
P
P
P
P
P
P
P
P
P
P
P
P
P
P
P
P
P
P
P
P
P
P
P
P
P
P
P
P
P
P
P
P
P
P
P
P
P
P
P
"}

(1,1,2) = {"
A
A
A
A
A
A
A
A
A
A
A
A
A
A
A
A
A
A
A
A
A
A
A
A
A
A
A
A
A
A
A
A
A
A
A
A
A
A
A
A
A
A
A
A
A
A
A
A
A
A
A
A
A
A
A
A
A
A
A
A
A
A
A
A
A
A
A
A
A
A
A
A
A
A
A
A
A
A
A
A
A
A
A
A
A
A
A
A
A
A
A
A
A
A
A
A
"}
(2,1,2) = {"
A
A
A
A
A
A
A
A
A
A
A
A
A
A
A
A
A
A
A
A
A
A
A
A
A
A
A
A
A
A
A
A
A
A
A
A
A
A
A
A
A
A
A
A
A
A
A
A
A
A
A
A
A
A
A
A
A
A
A
A
A
A
A
A
A
A
A
A
A
A
A
A
A
A
A
A
A
A
A
A
A
A
A
A
A
A
A
A
A
A
A
A
A
A
A
A
"}
(3,1,2) = {"
A
B
B
B
B
B
B
B
B
B
B
B
B
B
B
B
B
B
B
B
B
B
B
B
B
B
B
B
B
B
B
B
B
B
B
B
B
a
a
a
a
a
a
a
x
x
x
x
x
x
x
x
x
a
a
a
a
a
a
a
k
k
k
k
k
k
k
k
k
k
k
k
k
k
k
k
k
k
k
k
k
k
k
k
k
k
k
k
k
k
k
k
k
k
k
A
"}
(4,1,2) = {"
A
B
B
B
B
B
B
B
B
B
B
B
B
B
B
B
B
B
B
B
B
B
B
G
G
G
G
G
B
B
B
G
G
G
G
G
B
a
a
a
a
a
a
a
x
x
x
x
x
x
x
x
x
a
a
a
a
a
a
a
k
D
D
D
D
D
k
k
k
D
D
D
D
D
k
e
e
e
e
e
e
e
e
e
e
e
k
k
k
k
k
k
k
k
k
A
"}
(5,1,2) = {"
A
B
B
B
B
B
B
B
B
B
B
B
B
B
B
B
B
B
B
B
B
B
B
x
x
G
G
G
B
B
B
G
G
G
G
G
B
a
a
a
a
a
a
a
x
x
x
x
x
x
x
x
x
a
a
a
a
a
a
a
k
D
D
D
D
D
k
k
k
D
D
D
D
D
k
e
e
e
e
e
e
e
e
e
e
e
k
k
k
k
k
k
k
k
k
A
"}
(6,1,2) = {"
A
B
B
B
B
B
B
B
B
B
B
B
B
B
B
B
B
B
B
B
B
B
B
G
G
G
G
G
B
B
B
G
G
G
G
G
B
a
a
a
a
a
a
a
x
x
x
x
x
x
x
x
x
a
a
a
a
a
a
a
k
D
D
D
D
D
k
k
k
D
D
D
D
D
D
e
e
e
e
e
e
e
e
e
e
e
k
k
k
k
k
k
k
k
k
A
"}
(7,1,2) = {"
A
B
B
B
B
B
B
B
B
B
B
B
B
B
B
B
B
B
B
B
B
B
B
G
G
G
G
G
B
B
B
G
G
G
G
G
B
a
a
a
a
a
a
a
x
x
x
x
x
x
x
x
x
a
a
a
a
a
a
a
k
D
D
D
D
D
k
k
k
D
D
D
D
D
D
e
e
e
e
e
e
e
e
e
e
e
k
k
k
k
k
k
k
k
k
A
"}
(8,1,2) = {"
A
B
B
B
B
x
G
j
B
B
B
B
B
B
B
B
B
B
B
B
B
B
B
G
G
G
G
G
B
B
B
G
G
G
G
G
B
a
a
a
a
a
a
a
x
x
x
x
x
x
x
x
x
a
a
a
a
a
a
a
k
D
D
D
D
D
k
k
k
D
D
D
D
D
D
e
e
e
e
e
e
e
e
e
e
e
k
k
k
k
k
k
k
k
k
A
"}
(9,1,2) = {"
A
B
B
B
B
x
G
j
B
B
B
B
B
B
B
B
B
B
B
B
B
B
B
B
B
G
B
B
B
B
B
G
G
G
G
G
w
a
a
a
a
a
a
a
x
x
x
x
x
x
x
x
x
a
a
a
a
a
a
a
Y
D
D
D
D
D
k
k
k
D
D
D
D
D
D
e
e
e
e
e
e
e
e
e
D
D
k
k
k
k
k
k
k
k
k
A
"}
(10,1,2) = {"
A
B
B
B
B
x
G
j
B
B
B
B
B
B
B
B
B
B
B
B
B
B
B
G
G
G
G
G
B
B
B
G
G
G
G
G
w
a
a
a
a
a
a
a
x
x
x
x
x
x
x
x
x
a
a
a
a
a
a
a
Y
D
D
D
D
D
k
k
k
D
D
D
D
D
D
e
e
e
e
e
e
e
e
e
C
C
k
k
k
k
k
k
k
k
k
A
"}
(11,1,2) = {"
A
B
B
B
B
B
B
B
B
B
B
B
B
B
B
B
B
B
B
B
B
B
B
G
G
G
G
G
B
B
B
G
G
G
G
G
w
a
a
a
a
a
a
a
x
x
x
x
x
x
x
x
x
a
a
a
a
a
a
a
Y
D
D
D
D
D
k
k
k
D
D
D
D
D
k
e
e
e
e
e
e
e
e
e
k
k
k
k
k
k
k
k
k
k
k
A
"}
(12,1,2) = {"
A
B
B
B
B
B
B
B
B
B
B
B
B
B
B
B
B
B
B
B
B
B
B
s
s
G
G
G
B
B
B
G
G
G
G
G
B
a
a
a
a
a
a
a
x
x
x
x
x
x
x
x
x
a
a
a
a
a
a
a
k
D
D
D
D
D
k
k
k
D
D
D
D
D
k
D
D
e
e
e
e
e
e
e
k
k
k
k
k
k
k
k
k
k
k
A
"}
(13,1,2) = {"
A
B
B
B
B
B
B
B
B
B
B
B
B
B
G
G
G
G
G
G
G
G
G
G
G
G
G
G
B
B
B
G
G
G
G
G
B
a
a
a
a
a
a
a
x
x
x
x
x
x
x
x
x
a
a
a
a
a
a
a
k
D
D
D
D
D
k
k
k
D
D
D
D
D
k
D
D
e
e
e
e
e
e
e
k
k
k
k
k
k
k
k
k
k
k
A
"}
(14,1,2) = {"
A
B
B
B
B
B
B
B
B
B
B
B
B
B
G
G
G
G
G
G
G
G
G
G
G
G
G
G
B
B
B
G
G
G
G
G
B
a
a
a
a
a
a
a
x
x
x
x
x
x
x
x
x
a
a
a
a
a
a
a
k
D
D
D
D
D
k
k
k
D
D
D
D
D
k
C
C
e
e
e
e
e
e
e
k
k
k
k
k
k
k
k
k
k
k
A
"}
(15,1,2) = {"
A
B
B
B
B
B
B
B
B
B
B
B
B
B
G
G
B
B
B
B
B
B
B
G
G
G
G
G
B
B
B
G
G
G
G
G
B
a
a
a
a
a
a
a
x
x
x
x
x
x
x
x
x
a
a
a
a
a
a
a
k
D
D
D
D
D
k
k
k
D
D
D
D
D
k
k
k
e
e
e
e
e
e
e
e
e
k
k
k
k
k
k
k
k
k
A
"}
(16,1,2) = {"
A
B
B
B
B
B
B
B
B
B
B
B
B
B
G
G
B
B
B
B
B
B
B
G
G
G
G
G
G
G
G
G
G
G
G
G
B
a
a
a
a
a
a
a
b
b
b
b
b
b
b
b
b
a
a
a
a
a
a
a
k
D
D
D
D
D
D
D
D
D
D
D
D
D
k
k
k
e
e
e
e
e
e
e
e
e
k
k
k
k
k
k
k
k
k
A
"}
(17,1,2) = {"
A
B
B
B
B
B
B
B
B
B
B
B
B
B
G
G
B
B
B
B
B
B
B
G
G
G
G
G
G
G
G
G
G
G
G
G
B
a
a
a
a
a
a
a
G
G
G
G
G
G
G
G
G
a
a
a
a
a
a
a
k
D
D
D
D
D
D
D
D
D
D
D
D
D
k
k
k
e
e
e
e
e
e
e
e
e
k
k
k
k
k
k
k
k
k
A
"}
(18,1,2) = {"
A
B
B
B
B
B
B
B
B
B
B
B
B
B
G
G
B
B
B
B
B
B
B
G
G
G
G
G
G
G
G
G
G
G
G
G
B
a
a
a
a
a
a
a
G
G
G
G
G
G
G
G
G
a
a
a
a
a
a
a
k
D
D
D
D
D
D
D
D
D
D
D
D
D
k
k
k
k
k
k
D
D
k
k
k
k
k
k
k
k
k
k
k
k
k
A
"}
(19,1,2) = {"
A
B
B
B
B
B
B
B
B
B
e
e
e
e
e
e
e
e
e
e
B
B
B
G
G
G
G
G
G
G
G
G
G
G
G
G
B
a
a
a
a
a
a
a
G
G
G
G
G
G
G
G
G
a
a
a
a
a
a
a
k
D
D
D
D
D
D
D
D
D
D
D
D
D
k
k
k
k
k
k
D
D
k
k
k
k
k
k
k
k
k
k
k
k
k
A
"}
(20,1,2) = {"
A
B
B
B
B
B
B
B
B
B
e
e
e
e
e
e
e
e
e
e
B
B
B
G
G
G
G
G
G
G
G
G
G
G
G
G
B
a
a
a
a
a
a
a
J
J
J
J
J
J
J
J
J
a
a
a
a
a
a
a
k
D
D
D
D
D
D
D
D
D
D
D
D
D
k
k
k
k
k
k
D
D
k
k
k
k
k
k
k
k
k
k
k
k
k
A
"}
(21,1,2) = {"
A
B
B
B
B
B
B
B
B
B
e
e
e
e
e
e
e
e
e
e
B
B
B
G
G
G
G
G
B
B
B
G
G
G
G
G
B
a
a
a
a
a
a
a
x
x
x
x
x
x
x
x
x
a
a
a
a
a
a
a
k
D
D
D
D
D
k
k
k
D
D
D
D
D
k
k
k
k
k
k
D
D
k
k
k
k
k
k
k
k
k
k
k
k
k
A
"}
(22,1,2) = {"
A
B
B
B
B
B
B
B
B
B
e
e
e
e
e
e
e
e
e
e
M
M
B
G
G
G
G
G
B
B
B
G
G
G
G
G
B
a
a
a
a
a
a
a
x
x
x
x
x
x
x
x
x
a
a
a
a
a
a
a
k
D
D
D
D
D
k
k
k
D
D
D
D
D
D
D
D
D
D
D
D
D
k
k
k
k
k
k
k
k
k
k
k
k
k
A
"}
(23,1,2) = {"
A
B
B
B
B
B
B
B
B
B
e
e
e
e
e
e
e
e
e
e
G
G
B
G
G
G
G
G
B
B
B
G
G
G
G
G
B
a
a
a
a
a
a
a
x
x
x
x
x
x
x
x
x
a
a
a
a
a
a
a
k
D
D
D
D
D
k
k
k
D
D
D
D
D
D
D
D
D
D
D
D
D
k
k
k
k
k
k
k
k
k
k
k
k
k
A
"}
(24,1,2) = {"
A
B
B
B
B
B
B
B
B
B
G
G
e
e
e
e
e
e
e
e
G
G
B
G
G
G
G
G
B
B
B
G
G
G
G
G
B
a
a
a
a
a
a
a
x
x
x
x
x
x
x
x
x
a
a
a
a
a
a
a
k
D
D
D
D
D
k
k
k
D
D
D
U
U
k
k
k
k
k
k
k
k
k
k
k
k
k
k
k
k
k
k
k
k
k
A
"}
(25,1,2) = {"
A
B
B
B
B
B
B
B
B
B
Q
Q
e
e
e
e
e
e
e
e
e
e
B
G
G
G
G
G
B
B
B
G
G
G
G
G
B
a
a
a
a
a
a
a
x
x
x
x
x
x
x
x
x
a
a
a
a
a
a
a
k
D
D
D
D
D
k
k
k
D
D
D
D
D
k
k
k
k
k
k
k
k
k
k
k
k
k
k
k
k
k
k
k
k
k
A
"}
(26,1,2) = {"
A
B
B
B
B
B
B
B
B
B
B
B
e
e
e
e
e
e
e
e
e
e
G
G
G
G
G
G
B
B
B
G
G
G
G
G
w
a
a
a
a
a
a
a
x
x
x
x
x
x
x
x
x
a
a
a
a
a
a
a
Y
D
D
D
D
D
k
k
k
D
D
D
D
D
k
k
k
k
k
k
k
k
k
k
k
k
k
k
o
D
x
k
k
k
k
A
"}
(27,1,2) = {"
A
B
B
B
B
B
B
B
B
B
B
B
e
e
e
e
e
e
e
e
e
e
G
G
G
G
G
G
B
B
B
G
G
G
G
G
w
a
a
a
a
a
a
a
x
x
x
x
x
x
x
x
x
a
a
a
a
a
a
a
Y
D
D
D
D
D
k
k
k
k
k
D
k
k
k
k
k
k
k
k
k
k
k
k
k
k
k
k
o
D
x
k
k
k
k
A
"}
(28,1,2) = {"
A
B
B
B
B
B
B
B
B
B
B
B
e
e
e
e
e
e
e
e
e
e
G
G
G
G
G
G
B
B
B
G
G
G
G
G
w
a
a
a
a
a
a
a
x
x
x
x
x
x
x
x
x
a
a
a
a
a
a
a
Y
D
D
D
D
D
k
k
k
D
D
D
D
D
k
k
k
k
k
k
k
k
k
k
k
k
k
k
o
D
x
k
k
k
k
A
"}
(29,1,2) = {"
A
B
B
B
B
B
B
B
B
B
B
B
e
e
e
e
e
e
e
e
e
e
G
G
G
G
G
G
B
B
B
G
G
G
G
G
B
a
a
a
a
a
a
a
x
x
x
x
x
x
x
x
x
a
a
a
a
a
a
a
k
D
D
D
D
D
k
k
k
D
D
D
D
D
k
k
k
k
k
k
k
k
k
k
k
k
k
k
k
k
k
k
k
k
k
A
"}
(30,1,2) = {"
A
B
B
B
B
B
B
B
B
B
e
e
e
e
e
e
e
e
e
e
e
e
G
G
G
G
G
G
B
B
B
G
G
G
G
G
B
a
a
a
a
a
a
a
x
x
x
x
x
x
x
x
x
a
a
a
a
a
a
a
k
D
D
D
D
D
k
k
k
D
D
D
D
D
k
k
k
k
k
k
k
k
k
k
k
k
k
k
k
k
k
k
k
k
k
A
"}
(31,1,2) = {"
A
B
B
B
B
B
B
B
B
B
e
e
e
e
e
e
e
e
e
e
e
e
B
G
G
G
G
G
B
B
B
G
G
G
G
G
B
a
a
a
a
a
a
a
x
x
x
x
x
x
x
x
x
a
a
a
a
a
a
a
k
D
D
D
D
D
k
k
k
x
x
D
D
D
k
k
k
k
k
k
k
k
k
k
k
k
k
k
k
k
k
k
k
k
k
A
"}
(32,1,2) = {"
A
B
B
B
B
B
B
B
B
B
e
e
e
e
e
e
e
e
e
e
e
e
B
G
G
G
G
G
B
B
B
G
G
G
G
G
B
a
a
a
a
a
a
a
x
x
x
x
x
x
x
x
x
a
a
a
a
a
a
a
k
D
D
D
D
D
k
k
k
D
D
D
D
D
k
k
k
k
k
k
k
k
k
k
k
k
k
k
k
k
k
k
k
k
k
A
"}
(33,1,2) = {"
A
B
B
B
B
B
B
B
B
B
B
B
B
B
B
B
B
B
B
B
B
B
B
B
B
B
B
B
B
B
B
B
B
B
B
B
B
a
a
a
a
a
a
a
x
x
x
x
x
x
x
x
x
a
a
a
a
a
a
a
k
k
k
k
k
k
k
k
k
k
k
k
k
k
k
k
k
k
k
k
k
k
k
k
k
k
k
k
k
k
k
k
k
k
k
A
"}
(34,1,2) = {"
A
A
A
A
A
A
A
A
A
A
A
A
A
A
A
A
A
A
A
A
A
A
A
A
A
A
A
A
A
A
A
A
A
A
A
A
A
A
A
A
A
A
A
A
A
A
A
A
A
A
A
A
A
A
A
A
A
A
A
A
A
A
A
A
A
A
A
A
A
A
A
A
A
A
A
A
A
A
A
A
A
A
A
A
A
A
A
A
A
A
A
A
A
A
A
A
"}
(35,1,2) = {"
A
A
A
A
A
A
A
A
A
A
A
A
A
A
A
A
A
A
A
A
A
A
A
A
A
A
A
A
A
A
A
A
A
A
A
A
A
A
A
A
A
A
A
A
A
A
A
A
A
A
A
A
A
A
A
A
A
A
A
A
A
A
A
A
A
A
A
A
A
A
A
A
A
A
A
A
A
A
A
A
A
A
A
A
A
A
A
A
A
A
A
A
A
A
A
A
"}

(1,1,3) = {"
A
A
A
A
A
A
A
A
A
A
A
A
A
A
A
A
A
A
A
A
A
A
A
A
A
A
A
A
A
A
A
A
A
A
A
A
A
A
A
A
A
A
A
A
A
A
A
A
A
A
A
A
A
A
A
A
A
A
A
A
A
A
A
A
A
A
A
A
A
A
A
A
A
A
A
A
A
A
A
A
A
A
A
A
A
A
A
A
A
A
A
A
A
A
A
A
"}
(2,1,3) = {"
A
A
A
A
A
A
A
A
A
A
A
A
A
A
A
A
A
A
A
A
A
A
A
A
A
A
A
A
A
A
A
A
A
A
A
A
A
A
A
A
A
A
A
A
A
A
A
A
A
A
A
A
A
A
A
A
A
A
A
A
A
A
A
A
A
k
k
k
k
k
k
k
k
k
A
A
A
A
A
A
A
A
A
A
A
A
A
A
A
A
A
A
A
A
A
A
"}
(3,1,3) = {"
A
B
B
B
B
B
B
B
B
B
B
B
B
B
B
B
B
B
B
B
B
B
B
B
B
B
B
B
B
B
B
B
B
B
B
B
B
x
x
x
x
x
x
x
x
x
x
x
x
x
x
x
x
x
x
x
x
x
x
x
k
k
k
k
k
k
W
D
D
D
D
D
W
k
k
k
k
k
k
k
k
k
k
k
k
k
k
k
k
k
k
k
k
k
k
A
"}
(4,1,3) = {"
A
B
B
B
B
B
B
B
B
B
B
B
B
B
B
B
B
B
B
B
B
B
B
B
B
B
B
B
B
B
B
B
G
G
G
G
B
x
x
x
x
x
x
x
x
x
x
x
x
x
x
x
x
x
x
x
x
x
x
x
k
D
D
D
D
k
W
D
D
D
D
D
W
k
k
x
x
x
x
x
x
x
x
x
x
x
D
D
k
k
k
k
k
k
k
A
"}
(5,1,3) = {"
A
B
B
B
B
B
B
B
B
B
B
B
B
B
B
B
B
B
B
B
B
B
B
B
B
G
G
G
G
G
G
n
G
G
G
G
m
x
x
x
x
x
x
x
x
x
x
x
x
x
x
x
x
x
x
x
x
x
x
x
k
D
D
D
D
k
W
D
D
D
D
D
W
k
k
x
x
x
x
x
x
x
x
x
x
x
D
D
k
k
k
k
k
k
k
A
"}
(6,1,3) = {"
A
B
B
B
B
B
B
B
B
B
B
B
B
B
B
B
B
B
B
B
B
B
B
B
B
G
G
G
G
G
G
n
G
G
G
G
m
x
x
x
x
x
x
x
x
x
x
x
x
x
x
x
x
x
x
x
x
x
x
x
f
D
D
D
D
k
W
D
D
D
D
D
W
k
k
x
x
x
x
x
x
x
x
x
x
x
D
D
k
k
k
k
k
k
k
A
"}
(7,1,3) = {"
A
B
B
B
B
B
B
B
B
B
B
B
B
B
B
B
B
B
B
B
B
B
B
B
B
G
G
G
G
G
G
B
G
G
G
G
m
x
x
x
x
x
x
x
x
x
x
x
x
x
x
x
x
x
x
x
x
x
x
x
f
D
D
D
D
k
k
k
k
O
O
k
k
k
k
x
x
x
x
x
x
x
x
x
x
x
D
D
k
k
k
k
k
k
k
A
"}
(8,1,3) = {"
A
B
B
B
B
x
x
x
G
G
G
G
G
G
G
G
G
G
G
G
G
G
G
G
B
G
B
B
B
B
B
B
G
G
G
G
m
x
x
x
x
x
x
x
x
x
x
x
x
x
x
x
x
x
x
x
x
x
x
x
f
D
D
D
D
k
D
D
D
D
D
D
D
k
k
x
x
x
x
x
x
x
x
x
x
x
D
D
k
k
k
k
k
k
k
A
"}
(9,1,3) = {"
A
B
B
B
B
x
x
x
G
G
G
G
G
G
G
G
G
G
G
G
G
G
G
G
B
G
G
G
G
G
i
B
G
G
G
G
m
x
x
x
x
x
x
x
x
x
x
x
x
x
x
x
x
x
x
x
x
x
x
x
f
D
D
D
D
k
D
D
D
D
D
D
D
k
k
x
x
x
x
x
x
x
x
x
x
x
D
D
k
k
k
k
k
k
k
A
"}
(10,1,3) = {"
A
B
B
B
B
x
x
x
G
G
G
G
G
G
G
G
G
G
G
G
G
G
G
G
B
G
G
G
G
G
i
B
G
G
G
G
m
x
x
x
x
x
x
x
x
x
x
x
x
x
x
x
x
x
x
x
x
x
x
x
f
D
D
D
D
k
D
D
D
D
D
D
D
k
k
x
x
x
x
x
x
x
x
x
x
x
D
D
k
k
k
k
k
k
k
A
"}
(11,1,3) = {"
A
B
B
B
B
B
B
B
B
B
B
B
B
B
B
B
B
B
B
B
B
G
G
G
B
G
G
G
G
G
i
B
G
G
G
G
m
x
x
x
x
x
x
x
x
x
x
x
x
x
x
x
x
x
x
x
x
x
x
x
f
D
D
D
D
k
k
k
k
O
O
k
k
k
k
x
x
x
x
x
x
x
x
x
D
D
D
D
k
k
k
k
k
k
k
A
"}
(12,1,3) = {"
A
B
B
B
B
B
B
B
B
B
G
G
G
G
G
G
G
G
G
G
G
G
G
G
B
G
G
G
G
G
i
B
G
G
G
G
m
x
x
x
x
x
x
x
x
x
x
x
x
x
x
x
x
x
x
x
x
x
x
x
f
D
D
D
D
k
D
D
D
D
D
D
D
k
k
x
x
x
x
x
x
x
x
x
D
D
D
D
k
k
k
k
k
k
k
A
"}
(13,1,3) = {"
A
B
B
B
B
B
B
B
B
B
G
G
G
G
G
G
G
G
G
G
G
G
G
G
B
G
G
G
G
G
i
B
G
G
G
G
m
x
x
x
x
x
x
x
x
x
x
x
x
x
x
x
x
x
x
x
x
x
x
x
f
D
D
D
D
D
D
D
D
D
D
D
D
k
k
x
x
x
x
x
x
x
x
x
D
D
D
D
k
k
k
k
k
k
k
A
"}
(14,1,3) = {"
A
B
B
B
B
B
B
B
B
B
G
G
G
G
G
G
G
G
G
G
G
G
G
G
B
G
G
G
G
G
i
B
G
G
G
G
B
x
x
x
x
x
x
x
x
x
x
x
x
x
x
x
x
x
x
x
x
x
x
x
k
D
D
D
D
D
D
D
D
D
D
D
D
k
k
x
x
x
x
x
x
x
x
x
D
D
D
D
k
k
k
k
k
k
k
A
"}
(15,1,3) = {"
A
B
B
B
B
B
B
B
B
B
G
G
G
B
B
B
B
B
B
B
B
B
B
B
B
B
B
B
B
B
B
B
G
G
G
G
B
B
x
x
x
x
x
x
x
x
x
x
x
x
x
x
x
x
x
x
x
x
x
k
k
D
D
D
D
k
D
D
D
D
D
D
D
D
D
D
D
D
D
D
D
D
D
D
D
D
D
D
k
k
k
k
k
k
k
A
"}
(16,1,3) = {"
A
B
B
B
B
B
B
B
B
B
G
G
G
G
G
G
G
G
G
G
G
G
G
G
B
G
G
G
G
G
G
B
G
G
G
G
G
m
x
x
x
G
G
G
G
G
G
G
G
G
G
G
G
G
G
G
x
x
x
f
D
D
D
D
D
k
D
D
D
D
D
D
D
D
D
D
D
D
D
D
D
D
D
D
D
D
D
D
k
k
k
k
k
k
k
A
"}
(17,1,3) = {"
A
B
B
B
B
B
B
B
B
B
G
G
G
G
G
G
G
G
G
G
G
G
G
G
G
G
G
G
G
x
G
B
G
G
G
G
G
m
x
x
x
X
X
X
X
X
X
X
X
X
X
X
X
X
X
X
x
x
x
f
D
D
D
D
D
k
D
x
D
D
D
D
D
k
k
k
k
k
k
k
k
k
k
k
k
k
k
k
k
k
k
k
k
k
k
A
"}
(18,1,3) = {"
A
B
B
B
B
B
B
B
B
B
G
G
G
G
G
G
G
G
G
G
G
G
G
G
B
G
G
G
G
x
G
B
G
G
G
G
G
m
x
x
x
G
G
G
G
G
G
G
G
G
G
G
G
G
G
G
x
x
x
f
D
D
D
D
D
k
D
x
D
D
D
D
D
k
D
D
D
D
D
D
D
D
D
D
D
D
k
k
k
k
k
k
k
k
k
A
"}
(19,1,3) = {"
A
B
B
B
B
B
B
B
B
B
B
B
B
B
B
B
B
B
B
B
B
B
B
B
B
G
G
G
G
x
G
B
G
G
G
G
G
m
x
x
x
I
I
I
I
I
I
I
I
I
I
I
I
I
I
I
x
x
x
f
D
D
D
D
D
k
D
x
D
D
D
D
D
D
D
D
D
D
D
D
D
D
D
D
D
D
k
k
k
k
k
k
k
k
k
A
"}
(20,1,3) = {"
A
B
B
B
B
B
B
B
G
G
G
G
G
G
G
G
G
G
G
G
G
G
G
G
G
G
G
G
G
G
G
B
G
G
G
G
G
m
x
x
x
G
G
G
G
G
G
G
G
G
G
G
G
G
G
G
x
x
x
f
D
D
D
D
D
k
D
D
D
D
D
D
D
k
D
D
D
D
D
D
D
D
D
D
D
D
k
k
k
k
k
k
k
k
k
A
"}
(21,1,3) = {"
A
B
B
B
B
B
B
B
G
G
G
G
G
G
G
G
G
G
G
G
G
G
G
G
G
G
G
G
G
G
G
B
G
G
G
G
B
B
x
x
x
x
x
x
x
x
x
x
x
x
x
x
x
x
x
x
x
x
x
k
k
D
D
D
D
k
k
k
k
k
k
k
k
k
k
k
k
k
k
k
k
k
k
D
D
D
k
k
k
k
k
k
k
k
k
A
"}
(22,1,3) = {"
A
B
B
B
B
B
B
B
G
G
x
x
x
x
x
x
x
x
x
x
x
x
G
G
B
G
G
G
G
G
G
G
G
G
G
G
B
x
x
x
x
x
x
x
x
x
x
x
x
x
x
x
x
x
x
x
x
x
x
x
k
D
D
D
D
k
W
D
D
D
D
D
D
k
D
D
D
D
D
D
D
D
D
D
D
D
k
k
k
k
k
k
k
k
k
A
"}
(23,1,3) = {"
A
B
B
B
B
B
B
B
G
G
x
x
x
x
x
x
x
x
x
x
x
x
G
G
B
G
G
G
G
G
G
G
G
G
G
G
m
x
x
x
x
x
x
x
x
x
x
x
x
x
x
x
x
x
x
x
x
x
x
x
f
D
D
D
D
k
W
D
D
D
D
D
D
k
D
D
D
D
D
D
D
D
D
D
D
D
k
k
k
k
k
k
k
k
k
A
"}
(24,1,3) = {"
A
B
B
B
B
B
B
B
G
G
x
x
x
x
x
x
x
x
x
x
x
x
G
G
B
G
G
G
G
G
G
B
G
G
G
G
m
x
x
x
x
x
x
x
x
x
x
x
x
x
x
x
x
x
x
x
x
x
x
x
f
D
D
D
D
k
W
D
D
D
D
D
D
k
D
D
D
D
D
D
D
D
D
D
D
D
k
k
k
k
k
k
k
k
k
A
"}
(25,1,3) = {"
A
B
B
B
B
B
B
B
G
G
x
x
x
x
x
x
x
x
x
x
x
x
B
B
B
B
B
V
V
B
B
B
G
G
G
G
m
x
x
x
x
x
x
x
x
x
x
x
x
x
x
x
x
x
x
x
x
x
x
x
f
D
D
D
D
k
W
D
D
D
D
D
D
k
D
D
D
k
k
k
k
k
k
k
k
k
k
k
k
k
k
k
k
k
k
A
"}
(26,1,3) = {"
A
B
B
B
B
B
B
B
G
G
G
G
x
x
x
x
x
x
x
x
x
x
B
B
B
G
G
G
G
G
G
B
G
G
G
G
m
x
x
x
x
x
x
x
x
x
x
x
x
x
x
x
x
x
x
x
x
x
x
x
f
D
D
D
D
k
W
D
D
D
D
D
D
k
D
D
D
D
D
D
D
D
D
D
D
D
D
D
x
x
x
k
k
k
k
A
"}
(27,1,3) = {"
A
B
B
B
B
B
B
B
G
G
G
G
x
x
x
x
x
x
x
x
x
x
B
B
B
G
G
G
G
G
G
B
G
G
G
G
m
x
x
x
x
x
x
x
x
x
x
x
x
x
x
x
x
x
x
x
x
x
x
x
f
D
D
D
D
k
W
D
D
D
D
D
D
k
D
D
D
D
D
D
D
D
D
D
D
D
D
D
x
x
x
k
k
k
k
A
"}
(28,1,3) = {"
A
B
B
B
B
B
B
B
G
G
G
G
x
x
x
x
x
x
x
x
x
x
B
B
B
G
G
G
G
G
G
B
G
G
G
G
m
x
x
x
x
x
x
x
x
x
x
x
x
x
x
x
x
x
x
x
x
x
x
x
f
D
D
D
D
k
k
k
k
k
k
D
D
k
D
D
D
D
D
D
D
D
D
D
D
D
D
D
x
x
x
k
k
k
k
A
"}
(29,1,3) = {"
A
B
B
B
B
B
B
B
G
G
G
G
x
x
x
x
x
x
x
x
x
x
B
B
B
B
B
V
V
B
B
B
G
G
G
G
m
x
x
x
x
x
x
x
x
x
x
x
x
x
x
x
x
x
x
x
x
x
x
x
f
D
D
D
D
k
D
D
D
D
D
D
D
k
k
k
k
k
k
k
k
k
k
k
k
k
k
k
k
k
k
k
k
k
k
A
"}
(30,1,3) = {"
A
B
B
B
B
B
B
B
B
B
x
x
x
x
x
x
x
x
x
x
x
x
B
B
B
i
G
G
G
G
i
B
G
G
G
G
m
x
x
x
x
x
x
x
x
x
x
x
x
x
x
x
x
x
x
x
x
x
x
x
f
D
D
D
D
N
D
D
D
D
D
D
D
k
k
k
k
k
k
k
k
k
k
k
k
k
k
k
k
k
k
k
k
k
k
A
"}
(31,1,3) = {"
A
B
B
B
B
B
B
B
B
B
x
x
x
x
x
x
x
x
x
x
x
x
B
B
B
i
G
G
G
G
i
B
G
G
G
G
m
x
x
x
x
x
x
x
x
x
x
x
x
x
x
x
x
x
x
x
x
x
x
x
f
D
D
D
D
N
D
D
D
D
D
D
D
k
k
k
k
k
k
k
k
k
k
k
k
k
k
k
k
k
k
k
k
k
k
A
"}
(32,1,3) = {"
A
B
B
B
B
B
B
B
B
B
x
x
x
x
x
x
x
x
x
x
x
x
B
B
B
i
G
G
G
G
i
B
G
G
G
G
B
x
x
x
x
x
x
x
x
x
x
x
x
x
x
x
x
x
x
x
x
x
x
x
k
D
D
D
D
k
k
k
k
k
k
k
k
k
k
k
k
k
k
k
k
k
k
k
k
k
k
k
k
k
k
k
k
k
k
A
"}
(33,1,3) = {"
A
B
B
B
B
B
B
B
B
B
B
B
B
B
B
B
B
B
B
B
B
B
B
B
B
i
G
G
G
G
i
B
B
B
B
B
B
x
x
x
x
x
x
x
x
x
x
x
x
x
x
x
x
x
x
x
x
x
x
x
k
k
k
k
k
k
k
k
k
k
k
k
k
k
k
k
k
k
k
k
k
k
k
k
k
k
k
k
k
k
k
k
k
k
k
A
"}
(34,1,3) = {"
A
A
A
A
A
A
A
A
A
A
A
A
A
A
A
A
A
A
A
A
A
A
A
A
B
B
B
B
B
B
B
B
A
A
A
A
A
A
A
A
A
A
A
A
A
A
A
A
A
A
A
A
A
A
A
A
A
A
A
A
A
A
A
A
A
A
A
A
A
A
A
A
A
A
A
A
A
A
A
A
A
A
A
A
A
A
A
A
A
A
A
A
A
A
A
A
"}
(35,1,3) = {"
A
A
A
A
A
A
A
A
A
A
A
A
A
A
A
A
A
A
A
A
A
A
A
A
A
A
A
A
A
A
A
A
A
A
A
A
A
A
A
A
A
A
A
A
A
A
A
A
A
A
A
A
A
A
A
A
A
A
A
A
A
A
A
A
A
A
A
A
A
A
A
A
A
A
A
A
A
A
A
A
A
A
A
A
A
A
A
A
A
A
A
A
A
A
A
A
"}
