//MAP CONVERTED BY dmm2tgm.py THIS HEADER COMMENT PREVENTS RECONVERSION, DO NOT REMOVE
"af" = (
/obj/effect/decal/cleanable/rubble,
/turf/open/indestructible/plating,
/turf/open/floor/catwalk_floor/iron_white,
/area/centcom/central_command_areas/holding)
"al" = (
/obj/machinery/plumbing/tank,
/turf/open/floor/mineral/plastitanium,
/area/centcom/central_command_areas/holding)
"az" = (
/obj/structure/halflife/trash/cardboard,
/turf/open/indestructible/plating,
/area/centcom/central_command_areas/holding)
"aB" = (
/turf/closed/indestructible/reinforced/titanium{
	name = "white chamber wall"
	},
/area/centcom/central_command_areas/holding)
"aC" = (
/turf/open/indestructible/plating,
/turf/open/floor/catwalk_floor/iron_white,
/area/centcom/central_command_areas/holding)
"aL" = (
/obj/structure/chair,
/obj/effect/decal/cleanable/blood/gibs,
/turf/open/floor/mineral/titanium/tiled/white,
/area/centcom/central_command_areas/holding)
"aQ" = (
/obj/structure/table/halflife/metal/constructed,
/obj/item/storage/fancy/egg_box,
/turf/open/indestructible/plating,
/area/centcom/central_command_areas/holding)
"bh" = (
/mob/living/basic/parrot,
/turf/open/floor/plating/indoor/woodc/wide,
/area/centcom/central_command_areas/holding)
"bH" = (
/obj/structure/fence/door,
/turf/open/floor/plating/ground/sidewalk/cobblestone,
/area/centcom/central_command_areas/holding)
"cW" = (
/turf/open/floor/pod/dark,
/area/centcom/central_command_areas/holding)
"dg" = (
/turf/closed/wall/mineral/titanium/survival{
	name = "chamber wall";
	desc = "A reflective wall able to deflect blasts from teleortation equipment- as long as its portal-based."
	},
/turf/open/indestructible/plating,
/area/centcom/central_command_areas/holding)
"dM" = (
/turf/closed/indestructible/rock,
/turf/open/indestructible/plating,
/turf/open/indestructible/plating,
/area/centcom/central_command_areas/holding)
"ee" = (
/obj/item/chair/halflife/metal/broken,
/obj/item/food/canned/halflife/seafood/expired,
/turf/open/floor/plating/indoor/woodc/wide,
/area/centcom/central_command_areas/holding)
"eg" = (
/obj/structure/reagent_dispensers/watertank,
/turf/open/floor/plating/indoor/woodc/wide,
/area/centcom/central_command_areas/holding)
"eo" = (
/turf/open/floor/plating/ground/sidewalk/cobblestone,
/area/centcom/central_command_areas/holding)
"fu" = (
/obj/structure/closet/secure_closet/freezer/fridge,
/obj/item/food/meat/slab/halflife,
/obj/item/reagent_containers/condiment/rice,
/obj/item/food/meat/slab/xen,
/obj/item/food/meat/slab/xen,
/obj/item/food/meat/slab/xen,
/obj/item/reagent_containers/condiment/milk,
/turf/open/indestructible/plating,
/turf/open/floor/catwalk_floor/iron_white,
/area/centcom/central_command_areas/holding)
"gd" = (
/obj/structure/table/halflife/no_smooth/wood,
/obj/item/knife/shiv,
/turf/open/floor/plating/indoor/woodc/wide,
/area/centcom/central_command_areas/holding)
"gu" = (
/obj/structure/broken_flooring/plating/always_floorplane/directional/west,
/turf/open/halflife/water/medium,
/area/centcom/central_command_areas/holding)
"gy" = (
/obj/effect/turf_decal/box/red,
/turf/open/floor/mineral/titanium/tiled,
/area/centcom/central_command_areas/holding)
"ho" = (
/obj/machinery/space_heater/improvised_chem_heater,
/obj/item/reagent_containers/cup/soup_pot,
/turf/open/indestructible/plating,
/turf/open/floor/catwalk_floor/iron_white,
/area/centcom/central_command_areas/holding)
"hq" = (
/turf/open/halflife/water/shallow,
/area/centcom/central_command_areas/holding)
"hO" = (
/obj/structure/chair/stool/bar/directional/east,
/obj/effect/decal/cleanable/dirt/dust,
/turf/open/indestructible/plating,
/turf/open/floor/catwalk_floor/iron_smooth,
/area/centcom/central_command_areas/holding)
"im" = (
/obj/machinery/plumbing/tank,
/obj/machinery/light/cold/dim/directional/east,
/turf/open/floor/mineral/plastitanium,
/area/centcom/central_command_areas/holding)
"iH" = (
/obj/effect/turf_decal/box/white,
/turf/closed/indestructible/rock,
/area/centcom/central_command_areas/holding)
"iQ" = (
/obj/structure/closet/crate/wooden,
/obj/item/reagent_containers/cup/glass/bottle/whiskey,
/turf/open/floor/plating/indoor/woodc/wide,
/area/centcom/central_command_areas/holding)
"iW" = (
/obj/machinery/vending/hydroseeds,
/turf/open/floor/plating/ground/sidewalk/cobblestone,
/area/centcom/central_command_areas/holding)
"jb" = (
/obj/effect/decal/cleanable/rubble,
/obj/machinery/iv_drip/saline,
/turf/open/floor/mineral/titanium/tiled/white,
/area/centcom/central_command_areas/holding)
"jf" = (
/obj/effect/decal/cleanable/robot_debris/up,
/turf/open/floor/mineral/plastitanium,
/area/centcom/central_command_areas/holding)
"jG" = (
/turf/closed/indestructible/rock,
/area/centcom/central_command_areas/holding)
"jJ" = (
/obj/structure/table/halflife/metal/constructed/cobbled,
/obj/item/screwdriver,
/obj/item/wrench,
/obj/item/weldingtool/mini,
/turf/open/indestructible/plating,
/turf/open/floor/catwalk_floor,
/area/centcom/central_command_areas/holding)
"kl" = (
/obj/effect/decal/cleanable/rubble,
/obj/structure/table/halflife/metal/constructed/cobbled,
/obj/item/storage/test_tube_rack/full,
/turf/open/indestructible/plating,
/turf/open/floor/catwalk_floor/iron_white,
/area/centcom/central_command_areas/holding)
"kx" = (
/obj/item/trash/can,
/turf/open/floor/mineral/plastitanium,
/area/centcom/central_command_areas/holding)
"kI" = (
/obj/structure/weightmachine/weightlifter,
/turf/open/floor/plating/indoor/woodc/wide,
/area/centcom/central_command_areas/holding)
"lh" = (
/obj/effect/turf_decal/box,
/obj/effect/landmark/holding_facility,
/turf/open/floor/mineral/titanium/tiled/white,
/area/centcom/central_command_areas/holding)
"lx" = (
/obj/effect/decal/cleanable/rubble,
/obj/effect/decal/cleanable/dirt/dust,
/turf/open/indestructible/plating,
/turf/open/floor/catwalk_floor/iron_smooth,
/area/centcom/central_command_areas/holding)
"mj" = (
/turf/open/floor/mineral/titanium,
/area/centcom/central_command_areas/holding)
"mw" = (
/obj/structure/curtain/cloth,
/obj/item/stack/sheet/mineral/wood,
/turf/open/floor/plating/indoor/woodc/wide,
/area/centcom/central_command_areas/holding)
"mE" = (
/obj/structure/railing/halflife/solo,
/obj/structure/dresser,
/obj/item/seeds/firelemon,
/turf/open/floor/plating/indoor/tile/navy,
/area/centcom/central_command_areas/holding)
"nn" = (
/obj/item/stack/sheet/scrap_metal,
/turf/open/floor/plating/indoor/woodc/wide,
/area/centcom/central_command_areas/holding)
"oC" = (
/obj/effect/decal/cleanable/robot_debris/old,
/turf/open/indestructible/plating,
/turf/open/floor/catwalk_floor/iron_white,
/area/centcom/central_command_areas/holding)
"pK" = (
/obj/item/stack/sheet/scrap_copper,
/turf/open/floor/plating/indoor/woodc/wide,
/area/centcom/central_command_areas/holding)
"pN" = (
/obj/effect/decal/cleanable/dirt/dust,
/turf/open/floor/mineral/plastitanium,
/area/centcom/central_command_areas/holding)
"qx" = (
/obj/item/flashlight/flare/torch,
/obj/structure/halflife/trash_decal,
/obj/item/fishing_rod/telescopic,
/turf/open/floor/plating/indoor/woodc/wide,
/area/centcom/central_command_areas/holding)
"rj" = (
/obj/effect/decal/cleanable/dirt/dust,
/turf/open/indestructible/plating,
/turf/open/floor/catwalk_floor/iron_smooth,
/area/centcom/central_command_areas/holding)
"rn" = (
/obj/structure/railing/halflife/solo,
/turf/open/floor/plating/indoor/tile/navy,
/area/centcom/central_command_areas/holding)
"sk" = (
/turf/closed/indestructible/rock,
/turf/open/indestructible/plating,
/area/centcom/central_command_areas/holding)
"sW" = (
/obj/effect/decal/cleanable/blood,
/turf/open/floor/mineral/titanium/tiled/white,
/area/centcom/central_command_areas/holding)
"tS" = (
/obj/structure/fermenting_barrel,
/obj/item/food/nutripaste,
/obj/item/food/nutripaste,
/obj/item/food/nutripaste,
/obj/item/food/nutripaste,
/obj/item/food/nutripaste,
/obj/item/food/nutripaste,
/turf/open/floor/plating/indoor/woodc/wide,
/area/centcom/central_command_areas/holding)
"uv" = (
/turf/open/floor/plating/indoor/woodc/wide,
/area/centcom/central_command_areas/holding)
"vH" = (
/obj/structure/chair/stool/bar/directional/east,
/turf/open/indestructible/plating,
/turf/open/floor/catwalk_floor,
/area/centcom/central_command_areas/holding)
"wc" = (
/obj/item/toy/cards/deck,
/turf/open/floor/plating/indoor/woodc/wide,
/area/centcom/central_command_areas/holding)
"wp" = (
/obj/item/reagent_containers/cup/glass/trophy/gold_cup{
	desc = "Congratulations! You have won the Thinking Outside The Box OFFICIAL Aperture Science award! Unfortunately, you can not pawn off our portal gun that easily. Return to the trial chamber and deposit the portal gun to open the exit."
	},
/turf/open/space/basic,
/turf/open/indestructible/plating,
/area/centcom/central_command_areas/holding)
"wQ" = (
/obj/structure/bed/halflife/bedframe/wire,
/obj/machinery/light/built/directional/north,
/obj/item/clothing/under/misc/syndicate_souvenir,
/turf/open/floor/plating/indoor/tile/navy,
/area/centcom/central_command_areas/holding)
"xe" = (
/obj/structure/c_transit_tube,
/turf/open/floor/plating/indoor/tile/black,
/area/centcom/central_command_areas/holding)
"xB" = (
/obj/effect/decal/cleanable/blood/drip,
/turf/open/floor/mineral/titanium/tiled,
/area/centcom/central_command_areas/holding)
"xK" = (
/obj/structure/window/reinforced/plasma/plastitanium/indestructible,
/turf/closed/indestructible/grille,
/turf/open/indestructible/plating,
/area/centcom/central_command_areas/holding)
"yz" = (
/turf/open/indestructible/plating,
/turf/open/floor/catwalk_floor,
/area/centcom/central_command_areas/holding)
"zc" = (
/obj/machinery/door/airlock/titanium,
/obj/structure/barricade/wooden/crude,
/turf/open/space/basic,
/turf/open/indestructible/plating,
/area/centcom/central_command_areas/holding)
"zt" = (
/turf/open/floor/mineral/titanium/tiled,
/area/centcom/central_command_areas/holding)
"zN" = (
/turf/open/floor/mineral/plastitanium,
/area/centcom/central_command_areas/holding)
"zU" = (
/obj/item/trash/can/food/halflife/crisps,
/turf/open/floor/mineral/titanium/tiled,
/area/centcom/central_command_areas/holding)
"Aa" = (
/obj/item/trash/can/food/halflife/beans,
/turf/open/floor/mineral/titanium/tiled/white,
/area/centcom/central_command_areas/holding)
"Am" = (
/obj/item/reagent_containers/cup/glass/waterbottle,
/turf/open/floor/plating/indoor/woodc/wide,
/area/centcom/central_command_areas/holding)
"An" = (
/turf/open/floor/circuit/red,
/area/centcom/central_command_areas/holding)
"Ar" = (
/obj/item/fishing_rod,
/turf/open/floor/mineral/plastitanium,
/area/centcom/central_command_areas/holding)
"At" = (
/obj/structure/window/reinforced/plasma/spawner/directional/south,
/obj/machinery/plumbing/output/tap,
/turf/open/indestructible/plating,
/turf/open/floor/catwalk_floor/iron_white,
/area/centcom/central_command_areas/holding)
"AO" = (
/obj/structure/c_transit_tube/station/reverse{
	desc = "Looks like this would be your token out of here if it was still functional.";
	name = "portal gun return station"
	},
/turf/open/floor/plating/indoor/tile/black,
/area/centcom/central_command_areas/holding)
"Bw" = (
/obj/effect/decal/cleanable/rubble,
/obj/structure/rack,
/obj/item/reagent_containers/cup/glass/waterbottle/empty,
/turf/open/indestructible/plating,
/turf/open/floor/catwalk_floor/iron_white,
/area/centcom/central_command_areas/holding)
"BB" = (
/obj/effect/spawner/random/decoration/glowstick/on,
/turf/open/indestructible/plating,
/turf/open/floor/catwalk_floor,
/area/centcom/central_command_areas/holding)
"BZ" = (
/obj/machinery/gateway{
	desc = "A larger-then-average stationary portal that links to far-away locations.";
	name = "Staff Testing Return Station"
	},
/turf/open/floor/pod/dark,
/area/centcom/central_command_areas/holding)
"CD" = (
/obj/item/pipe,
/obj/effect/decal/cleanable/dirt/dust,
/turf/open/floor/mineral/plastitanium,
/area/centcom/central_command_areas/holding)
"CG" = (
/obj/structure/fence/door,
/turf/open/floor/mineral/plastitanium,
/area/centcom/central_command_areas/holding)
"CZ" = (
/obj/item/surgery_tray/full,
/turf/open/floor/mineral/titanium,
/area/centcom/central_command_areas/holding)
"Dp" = (
/turf/open/halflife/water/medium,
/area/centcom/central_command_areas/holding)
"Ea" = (
/obj/item/trash/halflife/nutrient_bar_waste/water,
/obj/machinery/hydroponics/soil,
/obj/machinery/light/built/directional/east,
/turf/open/floor/plating/ground/dirt,
/area/centcom/central_command_areas/holding)
"Ed" = (
/obj/structure/halflife/trash_decal,
/turf/open/floor/plating/indoor/woodc/wide,
/area/centcom/central_command_areas/holding)
"Es" = (
/obj/structure/table/halflife/metal/constructed/cobbled,
/turf/open/indestructible/plating,
/turf/open/floor/catwalk_floor,
/area/centcom/central_command_areas/holding)
"EQ" = (
/obj/machinery/light/built/directional/north,
/turf/open/floor/pod/dark,
/area/centcom/central_command_areas/holding)
"FU" = (
/obj/structure/showcase/machinery/microwave,
/turf/open/indestructible/plating,
/turf/open/floor/catwalk_floor/iron_white,
/area/centcom/central_command_areas/holding)
"Ht" = (
/obj/effect/decal/cleanable/oil,
/obj/structure/chair/stool/bar/directional/east,
/turf/open/indestructible/plating,
/turf/open/floor/catwalk_floor,
/area/centcom/central_command_areas/holding)
"HU" = (
/obj/machinery/hydroponics/soil,
/turf/open/floor/plating/ground/dirt,
/area/centcom/central_command_areas/holding)
"HW" = (
/obj/structure/emergency_shield,
/obj/effect/invisible_wall,
/turf/open/floor/pod/light,
/area/centcom/central_command_areas/holding)
"Ii" = (
/obj/machinery/light/built/directional/south,
/turf/open/floor/mineral/plastitanium,
/area/centcom/central_command_areas/holding)
"IY" = (
/obj/structure/mannequin/wood,
/turf/open/floor/plating/indoor/woodc/wide,
/area/centcom/central_command_areas/holding)
"Jb" = (
/obj/structure/rack,
/obj/effect/decal/cleanable/rubble,
/obj/item/bait_can/worm,
/obj/item/shovel,
/obj/item/cultivator/rake,
/turf/open/floor/plating/ground/dirt,
/area/centcom/central_command_areas/holding)
"Jj" = (
/obj/item/rack_parts,
/turf/open/indestructible/plating,
/turf/open/floor/catwalk_floor/iron_white,
/turf/open/floor/catwalk_floor/iron_white,
/area/centcom/central_command_areas/holding)
"JH" = (
/obj/item/pipe,
/turf/open/floor/plating/ground/dirt,
/area/centcom/central_command_areas/holding)
"JR" = (
/turf/open/floor/pod/light,
/area/centcom/central_command_areas/holding)
"JV" = (
/obj/structure/railing/halflife/solo,
/obj/item/crowbar/large/emergency,
/turf/open/floor/plating/indoor/tile/navy,
/area/centcom/central_command_areas/holding)
"Kb" = (
/obj/effect/decal/cleanable/dirt/dust,
/obj/item/flashlight,
/turf/open/indestructible/plating,
/turf/open/floor/catwalk_floor/iron_smooth,
/area/centcom/central_command_areas/holding)
"KF" = (
/obj/effect/decal/cleanable/rubble,
/turf/open/floor/plating/ground/sidewalk/cobblestone,
/area/centcom/central_command_areas/holding)
"Lp" = (
/obj/structure/halflife/trash_decal,
/turf/open/floor/mineral/titanium/tiled/white,
/area/centcom/central_command_areas/holding)
"Lr" = (
/obj/effect/turf_decal/delivery,
/turf/open/floor/plating/indoor/woodc/wide,
/area/centcom/central_command_areas/holding)
"LA" = (
/obj/structure/spirit_board,
/turf/open/indestructible/plating,
/turf/open/floor/catwalk_floor/iron_white,
/area/centcom/central_command_areas/holding)
"LE" = (
/obj/structure/c_transit_tube,
/turf/open/floor/plating/ground/dirt,
/area/centcom/central_command_areas/holding)
"LK" = (
/obj/machinery/stasis,
/turf/open/floor/mineral/titanium/tiled/white,
/area/centcom/central_command_areas/holding)
"Nt" = (
/obj/item/disk/holodisk,
/turf/open/halflife/water/shallow,
/area/centcom/central_command_areas/holding)
"NU" = (
/obj/structure/fake_stairs/wood/directional/north,
/obj/structure/barricade/wooden/crude,
/turf/open/floor/plating/indoor/woodc/wide,
/area/centcom/central_command_areas/holding)
"Oc" = (
/obj/item/food/cake/birthday,
/obj/structure/table/abductor,
/turf/open/floor/circuit/red,
/area/centcom/central_command_areas/holding)
"Ok" = (
/obj/machinery/hydroponics/soil,
/obj/effect/decal/cleanable/rubble,
/turf/open/floor/plating/ground/dirt,
/area/centcom/central_command_areas/holding)
"Oo" = (
/obj/structure/fermenting_barrel,
/obj/item/food/cracker,
/obj/item/food/cracker,
/obj/item/food/cracker,
/obj/item/food/cracker,
/obj/item/food/cracker,
/obj/item/food/cracker,
/obj/item/food/cracker,
/obj/item/food/cracker,
/obj/item/food/cracker,
/obj/item/food/cracker,
/obj/item/food/cracker,
/obj/item/food/cracker,
/obj/item/food/cracker,
/obj/item/food/cracker,
/obj/item/food/cracker,
/obj/item/food/cracker,
/turf/open/floor/plating/indoor/woodc/wide,
/area/centcom/central_command_areas/holding)
"Op" = (
/obj/item/pipe,
/turf/open/floor/mineral/plastitanium,
/area/centcom/central_command_areas/holding)
"OA" = (
/turf/closed/wall/mineral/titanium/survival{
	name = "chamber wall";
	desc = "A reflective wall able to deflect blasts from teleortation equipment- as long as its portal-based."
	},
/turf/open/indestructible/plating,
/turf/open/indestructible/plating,
/area/centcom/central_command_areas/holding)
"OQ" = (
/obj/structure/bed/halflife/bedframe/wire,
/obj/item/clothing/under/misc/syndicate_souvenir,
/turf/open/floor/plating/indoor/tile/navy,
/area/centcom/central_command_areas/holding)
"Ry" = (
/obj/item/food/bait/worm,
/turf/open/floor/plating/indoor/woodc/wide,
/area/centcom/central_command_areas/holding)
"RA" = (
/obj/structure/halflife/trash_decal,
/turf/open/floor/mineral/plastitanium,
/area/centcom/central_command_areas/holding)
"RD" = (
/obj/item/crowbar/red,
/turf/open/floor/plating/indoor/woodc/wide,
/area/centcom/central_command_areas/holding)
"RK" = (
/obj/effect/turf_decal/box/white,
/obj/effect/turf_decal/box/white,
/turf/closed/indestructible/rock,
/area/centcom/central_command_areas/holding)
"Sc" = (
/obj/item/food/canned/halflife/seafood/expired,
/turf/open/floor/plating/indoor/woodc/wide,
/area/centcom/central_command_areas/holding)
"SW" = (
/turf/open/floor/mineral/titanium/tiled/white,
/area/centcom/central_command_areas/holding)
"UW" = (
/obj/effect/decal/cleanable/rubble,
/turf/open/floor/mineral/plastitanium,
/area/centcom/central_command_areas/holding)
"Vj" = (
/obj/structure/fake_stairs/directional/west,
/turf/open/floor/plating/indoor/tile/kitchen,
/area/centcom/central_command_areas/holding)
"VI" = (
/obj/structure/closet/crate/trashcart,
/obj/machinery/holopad,
/turf/open/floor/mineral/titanium/tiled/white,
/turf/open/indestructible/plating,
/area/centcom/central_command_areas/holding)
"VO" = (
/turf/closed/indestructible/syndicate,
/area/centcom/central_command_areas/holding)
"VW" = (
/obj/item/chair/halflife/metal/red/broken,
/obj/item/food/bait/worm,
/turf/open/floor/plating/indoor/woodc/wide,
/area/centcom/central_command_areas/holding)
"Wd" = (
/obj/item/flashlight/flare,
/turf/open/floor/plating/indoor/woodc/wide,
/area/centcom/central_command_areas/holding)
"Wm" = (
/obj/machinery/light/built/directional/south,
/turf/open/floor/mineral/titanium/tiled/white,
/area/centcom/central_command_areas/holding)
"Wy" = (
/obj/structure/broken_flooring/plating/always_floorplane/directional/north,
/turf/open/halflife/water/medium,
/area/centcom/central_command_areas/holding)
"WE" = (
/obj/structure/curtain/cloth,
/obj/structure/barricade/wooden/crude,
/turf/open/floor/plating/indoor/woodc/wide,
/area/centcom/central_command_areas/holding)
"Xj" = (
/obj/effect/decal/cleanable/blood/drip,
/turf/open/floor/mineral/titanium/tiled/white,
/area/centcom/central_command_areas/holding)
"Xn" = (
/obj/structure/bed/halflife/mattress/yellowed,
/turf/open/floor/plating/indoor/woodc/wide,
/area/centcom/central_command_areas/holding)
"XP" = (
/obj/structure/bed/medical,
/turf/open/floor/mineral/titanium/tiled/white,
/area/centcom/central_command_areas/holding)
"Yf" = (
/obj/effect/decal/cleanable/blood/gibs,
/turf/open/floor/mineral/titanium/tiled/white,
/area/centcom/central_command_areas/holding)
"Zj" = (
/turf/closed/wall/halflife/wood,
/area/centcom/central_command_areas/holding)
"Zm" = (
/obj/structure/chair,
/turf/open/floor/mineral/titanium,
/area/centcom/central_command_areas/holding)
"Zs" = (
/obj/structure/lattice/catwalk/hl13,
/turf/open/halflife/water/shallow,
/area/centcom/central_command_areas/holding)

(1,1,1) = {"
jG
jG
jG
jG
jG
jG
jG
jG
jG
jG
jG
jG
jG
jG
jG
jG
jG
jG
jG
jG
jG
jG
jG
jG
jG
jG
jG
jG
jG
jG
jG
jG
"}
(2,1,1) = {"
jG
jG
jG
jG
jG
jG
jG
jG
jG
jG
jG
jG
jG
jG
jG
jG
jG
jG
jG
jG
jG
jG
jG
jG
jG
jG
jG
jG
jG
jG
jG
jG
"}
(3,1,1) = {"
jG
jG
jG
jG
jG
jG
jG
jG
jG
jG
jG
jG
jG
jG
jG
jG
jG
jG
jG
jG
jG
jG
jG
jG
jG
jG
jG
jG
jG
jG
jG
jG
"}
(4,1,1) = {"
jG
jG
jG
jG
jG
jG
jG
jG
jG
jG
jG
jG
jG
jG
jG
jG
jG
jG
jG
jG
jG
jG
jG
iH
iH
RK
RK
RK
jG
jG
jG
jG
"}
(5,1,1) = {"
jG
jG
jG
jG
jG
jG
jG
jG
jG
jG
jG
jG
jG
jG
jG
jG
jG
jG
jG
jG
jG
jG
jG
iH
iH
RK
RK
RK
RK
jG
jG
jG
"}
(6,1,1) = {"
jG
jG
jG
jG
jG
jG
jG
jG
jG
jG
jG
jG
aB
zc
zc
aB
sk
sk
sk
jG
jG
jG
jG
iH
iH
RK
RK
RK
RK
jG
jG
jG
"}
(7,1,1) = {"
jG
jG
jG
jG
jG
jG
jG
jG
jG
jG
aB
aB
aB
Yf
sW
aB
OA
OA
sk
sk
jG
jG
jG
jG
jG
jG
jG
jG
jG
jG
jG
jG
"}
(8,1,1) = {"
jG
jG
jG
jG
jG
jG
jG
jG
jG
jG
aB
SW
Xj
SW
aL
Yf
VI
dg
dg
sk
jG
jG
jG
jG
jG
jG
jG
jG
jG
jG
jG
jG
"}
(9,1,1) = {"
jG
jG
jG
jG
jG
jG
jG
jG
jG
jG
aB
Vj
Vj
SW
lh
Xj
SW
XP
dg
sk
jG
An
An
An
VO
hq
jG
jG
VO
jG
jG
jG
"}
(10,1,1) = {"
jG
jG
jG
jG
jG
jG
jG
jG
jG
jG
aB
OQ
rn
mj
xB
mj
zU
LK
dg
wp
jG
An
Oc
An
jG
hq
jG
hq
VO
jG
jG
jG
"}
(11,1,1) = {"
jG
jG
jG
jG
jG
jG
jG
jG
jG
jG
aB
wQ
JV
xB
mj
gy
CZ
XP
dg
sk
jG
An
An
An
VO
jG
Nt
hq
jG
jG
jG
jG
"}
(12,1,1) = {"
jG
jG
jG
jG
jG
jG
jG
jG
jG
jG
aB
OQ
mE
mj
zt
Zm
zt
Wm
dg
sk
sk
sk
jG
jG
jG
hq
hq
Zs
jG
jG
jG
jG
"}
(13,1,1) = {"
jG
jG
jG
jG
jG
jG
jG
jG
jG
jG
aB
aB
Aa
SW
Lp
SW
SW
jb
dg
dg
dg
dM
jG
jG
jG
Zs
Ar
Zs
VO
jG
jG
jG
"}
(14,1,1) = {"
jG
jG
jG
jG
jG
jG
jG
jG
jG
jG
jG
aB
Op
JH
Op
Op
CD
CD
rj
OA
LA
aC
af
aC
At
Zs
zN
VO
VO
jG
jG
jG
"}
(15,1,1) = {"
jG
jG
jG
jG
jG
jG
jG
jG
jG
jG
jG
aB
LE
jG
xe
AO
UW
jf
Kb
lx
oC
yz
yz
Bw
xK
al
im
VO
jG
jG
jG
jG
"}
(16,1,1) = {"
jG
jG
jG
jG
jG
jG
jG
jG
jG
jG
jG
jG
Ok
eo
KF
bH
kx
pN
dg
hO
Ht
vH
yz
Jj
VO
VO
VO
VO
jG
jG
jG
jG
"}
(17,1,1) = {"
jG
jG
jG
jG
jG
jG
jG
jG
jG
jG
jG
jG
jG
iW
HU
jG
RA
Ii
dg
kl
Es
jJ
yz
aC
FU
jG
jG
jG
jG
jG
jG
jG
"}
(18,1,1) = {"
jG
jG
jG
jG
jG
jG
jG
jG
jG
jG
jG
jG
jG
Jb
zN
CG
zN
zN
dg
fu
af
BB
aQ
aC
ho
jG
jG
jG
jG
jG
jG
jG
"}
(19,1,1) = {"
jG
jG
jG
jG
jG
jG
jG
jG
jG
jG
jG
jG
jG
aB
Ea
jG
zN
zN
dg
dg
aC
aC
af
aC
sk
jG
jG
jG
jG
jG
jG
jG
"}
(20,1,1) = {"
jG
Zj
Zj
Zj
Zj
Zj
Zj
Zj
jG
jG
jG
jG
jG
VO
VO
HW
HW
HW
VO
VO
VO
jG
jG
jG
jG
jG
jG
jG
jG
jG
jG
jG
"}
(21,1,1) = {"
Zj
Zj
Sc
Ed
Lr
bh
pK
Zj
Zj
jG
jG
jG
jG
VO
JR
cW
JR
cW
JR
VO
jG
jG
jG
jG
jG
jG
jG
jG
jG
jG
jG
jG
"}
(22,1,1) = {"
Zj
NU
Am
uv
Ry
Ed
ee
WE
Zj
Zj
Zj
jG
jG
VO
EQ
JR
BZ
JR
cW
VO
jG
jG
jG
jG
jG
jG
jG
jG
jG
jG
jG
jG
"}
(23,1,1) = {"
Zj
NU
iQ
Wd
gd
kI
uv
mw
Xn
qx
Zj
jG
jG
VO
VO
cW
JR
cW
JR
VO
jG
jG
jG
jG
jG
jG
jG
jG
jG
jG
jG
jG
"}
(24,1,1) = {"
Zj
NU
IY
Ry
Am
nn
RD
mw
VW
tS
Zj
jG
jG
jG
VO
VO
VO
VO
VO
VO
jG
jG
jG
jG
jG
jG
jG
jG
jG
jG
jG
jG
"}
(25,1,1) = {"
Zj
NU
Ed
gu
az
Am
Oo
mw
Zj
Zj
Zj
jG
jG
jG
jG
jG
jG
jG
jG
jG
jG
jG
jG
jG
jG
jG
jG
jG
jG
jG
jG
jG
"}
(26,1,1) = {"
Zj
Zj
wc
Dp
Wy
Ry
eg
Zj
Zj
jG
jG
jG
jG
jG
jG
jG
jG
jG
jG
jG
jG
jG
jG
jG
jG
jG
jG
jG
jG
jG
jG
jG
"}
(27,1,1) = {"
jG
Zj
Zj
Zj
Zj
Zj
Zj
Zj
jG
jG
jG
jG
jG
jG
jG
jG
jG
jG
jG
jG
jG
jG
jG
jG
jG
jG
jG
jG
jG
jG
jG
jG
"}
(28,1,1) = {"
jG
jG
jG
jG
jG
jG
jG
jG
jG
jG
jG
jG
jG
jG
jG
jG
jG
jG
jG
jG
jG
jG
jG
jG
jG
jG
jG
jG
jG
jG
jG
jG
"}
(29,1,1) = {"
jG
jG
jG
jG
jG
jG
jG
jG
jG
jG
jG
jG
jG
jG
jG
jG
jG
jG
jG
jG
jG
jG
jG
jG
jG
jG
jG
jG
jG
jG
jG
jG
"}
(30,1,1) = {"
jG
jG
jG
jG
jG
jG
jG
jG
jG
jG
jG
jG
jG
jG
jG
jG
jG
jG
jG
jG
jG
jG
jG
jG
jG
jG
jG
jG
jG
jG
jG
jG
"}
(31,1,1) = {"
jG
jG
jG
jG
jG
jG
jG
jG
jG
jG
jG
jG
jG
jG
jG
jG
jG
jG
jG
jG
jG
jG
jG
jG
jG
jG
jG
jG
jG
jG
jG
jG
"}
(32,1,1) = {"
jG
jG
jG
jG
jG
jG
jG
jG
jG
jG
jG
jG
jG
jG
jG
jG
jG
jG
jG
jG
jG
jG
jG
jG
jG
jG
jG
jG
jG
jG
jG
jG
"}
