//MAP CONVERTED BY dmm2tgm.py THIS HEADER COMMENT PREVENTS RECONVERSION, DO NOT REMOVE
"af" = (
/obj/structure/halflife/trash/papers/three,
/turf/open/floor/plating/ground/sidewalk/inner,
/area/centcom/central_command_areas/holding)
"aB" = (
/obj/structure/chair/sofa/hl13bench,
/turf/open/floor/plating/ground/dirt,
/area/centcom/central_command_areas/holding)
"aC" = (
/obj/structure/chair/sofa/hl13bench{
	dir = 1
	},
/turf/open/floor/plating/ground/dirt/alt,
/area/centcom/central_command_areas/holding)
"bH" = (
/obj/effect/turf_decal/weather/dirt{
	dir = 1
	},
/turf/open/halflife/water/shallow,
/area/centcom/central_command_areas/holding)
"cW" = (
/obj/effect/turf_decal/weather/dirt{
	dir = 5
	},
/turf/open/halflife/water/shallow,
/area/centcom/central_command_areas/holding)
"dg" = (
/turf/open/floor/plating/ground/sidewalk,
/area/centcom/central_command_areas/holding)
"ee" = (
/obj/machinery/light/small/directional/west,
/turf/open/floor/plating/indoor/woodc/mosaic,
/area/centcom/central_command_areas/holding)
"eg" = (
/obj/structure/chair/halflife/metal/folding,
/turf/open/floor/plating/indoor/cafeteria,
/area/centcom/central_command_areas/holding)
"eo" = (
/obj/machinery/power/halflife/streetlamphalt,
/turf/open/misc/grass/jungle/station,
/area/centcom/central_command_areas/holding)
"fu" = (
/obj/machinery/light/small/directional/south,
/turf/open/floor/plating/ground/sidewalk,
/area/centcom/central_command_areas/holding)
"gd" = (
/obj/machinery/light/small/directional/west,
/turf/open/floor/plating/indoor/carpet,
/area/centcom/central_command_areas/holding)
"gy" = (
/obj/effect/turf_decal/halflife/covering/wallpaper/red,
/turf/closed/wall/halflife/concrete,
/area/centcom/central_command_areas/holding)
"ho" = (
/obj/item/reagent_containers/cup/soda_cans/breenwater/purple,
/turf/open/floor/plating/indoor/cafeteria,
/area/centcom/central_command_areas/holding)
"hq" = (
/obj/machinery/door/unpowered/halflife/seethrough/metal{
	dir = 4
	},
/turf/open/floor/plating/indoor/carpet,
/area/centcom/central_command_areas/holding)
"hO" = (
/obj/machinery/power/halflife/streetlamphalt{
	dir = 1
	},
/turf/open/misc/grass/jungle/station,
/area/centcom/central_command_areas/holding)
"iH" = (
/obj/structure/chair/halflife/metal/folding{
	dir = 1
	},
/obj/machinery/light/small/directional/east,
/turf/open/floor/plating/indoor/cafeteria,
/area/centcom/central_command_areas/holding)
"iQ" = (
/obj/structure/halflife/trash/papers/three{
	dir = 8
	},
/turf/open/floor/plating/ground/sidewalk/inner,
/area/centcom/central_command_areas/holding)
"iW" = (
/obj/effect/turf_decal/halflife/covering/paint/red,
/turf/closed/wall/halflife/concrete,
/area/centcom/central_command_areas/holding)
"jb" = (
/obj/structure/halflife/trash/papers/two{
	dir = 1
	},
/turf/open/floor/plating/ground/sidewalk/inner,
/area/centcom/central_command_areas/holding)
"jf" = (
/obj/effect/turf_decal/weather/dirt{
	dir = 10
	},
/turf/open/halflife/water/shallow,
/area/centcom/central_command_areas/holding)
"jG" = (
/obj/structure/table/halflife/wood/bar,
/turf/open/floor/plating/indoor/carpet,
/area/centcom/central_command_areas/holding)
"kl" = (
/obj/item/food/rationpack/worstgrade,
/turf/open/floor/plating/indoor/cafeteria,
/area/centcom/central_command_areas/holding)
"kI" = (
/obj/structure/halflife/trash/garbage,
/turf/open/floor/plating/ground/sidewalk/inner,
/area/centcom/central_command_areas/holding)
"lh" = (
/obj/structure/table/halflife/wood/bar,
/obj/machinery/light/small/directional/west,
/turf/open/floor/plating/indoor/woodc/mosaic,
/area/centcom/central_command_areas/holding)
"lx" = (
/obj/structure/table/halflife/no_smooth/large/metal{
	dir = 1
	},
/obj/item/food/nutripaste,
/turf/open/floor/plating/indoor/cafeteria,
/area/centcom/central_command_areas/holding)
"lI" = (
/obj/structure/table/halflife/no_smooth/large/metal{
	dir = 1
	},
/obj/item/reagent_containers/cup/soda_cans/breenwater/yellow,
/turf/open/floor/plating/indoor/cafeteria,
/area/centcom/central_command_areas/holding)
"mj" = (
/obj/structure/flora/bush/fullgrass/style_random,
/turf/open/floor/plating/ground/dirt,
/area/centcom/central_command_areas/holding)
"mw" = (
/obj/effect/turf_decal/siding/thinplating{
	dir = 1
	},
/turf/open/floor/plating/ground/sidewalk/inner,
/area/centcom/central_command_areas/holding)
"pK" = (
/obj/machinery/door/unpowered/halflife/seethrough/metal{
	dir = 8
	},
/turf/open/floor/plating/indoor/cafeteria,
/area/centcom/central_command_areas/holding)
"pN" = (
/obj/effect/turf_decal/weather/dirt,
/turf/open/halflife/water/shallow,
/area/centcom/central_command_areas/holding)
"qx" = (
/obj/structure/chair/halflife/metal/stool,
/obj/machinery/light/small/directional/east,
/turf/open/floor/plating/indoor/carpet,
/area/centcom/central_command_areas/holding)
"rj" = (
/obj/structure/halflife/trash/cardboard{
	dir = 8
	},
/turf/open/floor/plating/indoor/carpet,
/area/centcom/central_command_areas/holding)
"rn" = (
/turf/open/floor/plating/indoor/woodc/mosaic,
/area/centcom/central_command_areas/holding)
"uv" = (
/obj/structure/halflife/trash/wood{
	dir = 1
	},
/turf/open/misc/grass/jungle/station,
/area/centcom/central_command_areas/holding)
"wc" = (
/turf/closed/indestructible/syndicate,
/area/centcom/central_command_areas/holding)
"wV" = (
/obj/structure/table/halflife/wood/bar,
/obj/structure/halflife/trash/glass/basic,
/turf/open/floor/plating/indoor/woodc/mosaic,
/area/centcom/central_command_areas/holding)
"xe" = (
/turf/open/misc/grass/jungle/station,
/area/centcom/central_command_areas/holding)
"xB" = (
/obj/structure/halflife/trash/papers/two{
	dir = 8
	},
/turf/open/floor/plating/ground/sidewalk/inner,
/area/centcom/central_command_areas/holding)
"yz" = (
/obj/machinery/door/unpowered/halflife/seethrough/metal,
/turf/open/floor/plating/indoor/concrete/bricks,
/area/centcom/central_command_areas/holding)
"zc" = (
/obj/machinery/jukebox,
/turf/open/floor/plating/indoor/woodc/mosaic,
/area/centcom/central_command_areas/holding)
"zN" = (
/obj/machinery/power/halflife/streetlamphalt{
	dir = 4
	},
/turf/open/misc/grass/jungle/station,
/area/centcom/central_command_areas/holding)
"zU" = (
/obj/structure/window/fulltile,
/turf/open/floor/plating/indoor/concrete/bricks,
/area/centcom/central_command_areas/holding)
"Am" = (
/obj/structure/halflife/trash/books/pile_alt,
/turf/open/floor/plating/indoor/cafeteria,
/area/centcom/central_command_areas/holding)
"An" = (
/obj/machinery/light/small/directional/east,
/turf/open/floor/plating/ground/sidewalk,
/area/centcom/central_command_areas/holding)
"Ar" = (
/obj/structure/chair/halflife/metal/folding,
/obj/machinery/light/small/directional/east,
/turf/open/floor/plating/indoor/cafeteria,
/area/centcom/central_command_areas/holding)
"AO" = (
/obj/effect/turf_decal/weather/dirt{
	dir = 9
	},
/turf/open/halflife/water/shallow,
/area/centcom/central_command_areas/holding)
"Bw" = (
/obj/machinery/light/small/directional/north,
/turf/open/floor/plating/ground/sidewalk,
/area/centcom/central_command_areas/holding)
"BB" = (
/obj/structure/table/halflife/wood/bar,
/turf/open/floor/plating/indoor/woodc/mosaic,
/area/centcom/central_command_areas/holding)
"CD" = (
/obj/machinery/light/small/directional/west,
/turf/open/floor/plating/ground/sidewalk,
/area/centcom/central_command_areas/holding)
"CG" = (
/obj/structure/chair/halflife/metal/folding,
/obj/machinery/light/small/directional/west,
/turf/open/floor/plating/indoor/cafeteria,
/area/centcom/central_command_areas/holding)
"Ea" = (
/obj/structure/table/halflife/wood/bar,
/obj/machinery/light/small/directional/east,
/turf/open/floor/plating/indoor/woodc/mosaic,
/area/centcom/central_command_areas/holding)
"Ed" = (
/turf/cordon,
/area/centcom/central_command_areas/holding)
"FU" = (
/obj/structure/halflife/trash/cardboard{
	dir = 4
	},
/turf/open/floor/plating/ground/sidewalk,
/area/centcom/central_command_areas/holding)
"Ht" = (
/obj/structure/flora/bush/fullgrass/style_random,
/turf/open/floor/plating/ground/dirt/alt,
/area/centcom/central_command_areas/holding)
"HU" = (
/obj/structure/table/halflife/wood/bar,
/obj/item/reagent_containers/cup/glass/bottle/beer/light,
/turf/open/floor/plating/indoor/woodc/mosaic,
/area/centcom/central_command_areas/holding)
"HW" = (
/obj/machinery/power/halflife/streetlamphalt{
	dir = 8
	},
/turf/open/misc/grass/jungle/station,
/area/centcom/central_command_areas/holding)
"Jj" = (
/obj/structure/halflife/trash/garbage,
/turf/open/floor/plating/ground/dirt/alt,
/area/centcom/central_command_areas/holding)
"JR" = (
/turf/open/floor/plating/indoor/cafeteria,
/area/centcom/central_command_areas/holding)
"JV" = (
/obj/structure/chair/halflife/metal/stool,
/turf/open/floor/plating/indoor/carpet,
/area/centcom/central_command_areas/holding)
"LE" = (
/turf/open/floor/plating/ground/dirt,
/area/centcom/central_command_areas/holding)
"LK" = (
/obj/structure/halflife/trash/papers/three{
	dir = 1
	},
/turf/open/floor/plating/ground/sidewalk/inner,
/area/centcom/central_command_areas/holding)
"Nt" = (
/obj/structure/table/halflife/wood/bar,
/obj/machinery/light/small/directional/east,
/obj/item/reagent_containers/cup/glass/bottle/beer/light,
/turf/open/floor/plating/indoor/woodc/mosaic,
/area/centcom/central_command_areas/holding)
"NU" = (
/obj/structure/chair/halflife/metal/folding{
	dir = 1
	},
/obj/machinery/light/small/directional/west,
/turf/open/floor/plating/indoor/cafeteria,
/area/centcom/central_command_areas/holding)
"Ok" = (
/obj/structure/flora/bush/fullgrass/style_random,
/turf/open/misc/grass/jungle/station,
/area/centcom/central_command_areas/holding)
"Op" = (
/turf/open/floor/plating/ground/dirt/alt,
/area/centcom/central_command_areas/holding)
"OQ" = (
/obj/structure/chair/halflife/metal/folding{
	dir = 1
	},
/turf/open/floor/plating/indoor/cafeteria,
/area/centcom/central_command_areas/holding)
"Ry" = (
/turf/open/halflife/water/shallow,
/area/centcom/central_command_areas/holding)
"RA" = (
/obj/effect/turf_decal/weather/dirt{
	dir = 4
	},
/turf/open/halflife/water/shallow,
/area/centcom/central_command_areas/holding)
"RK" = (
/turf/closed/mineral/random,
/area/centcom/central_command_areas/holding)
"Sc" = (
/obj/structure/table/halflife/no_smooth/large/metal{
	dir = 1
	},
/obj/structure/halflife/trash/food/misc,
/turf/open/floor/plating/indoor/cafeteria,
/area/centcom/central_command_areas/holding)
"UW" = (
/obj/effect/turf_decal/weather/dirt{
	dir = 8
	},
/turf/open/halflife/water/shallow,
/area/centcom/central_command_areas/holding)
"Vj" = (
/obj/effect/turf_decal/siding/thinplating{
	dir = 1
	},
/obj/machinery/power/halflife/streetlamphalt{
	dir = 1
	},
/turf/open/floor/plating/ground/sidewalk/inner,
/area/centcom/central_command_areas/holding)
"VO" = (
/turf/open/floor/plating/ground/sidewalk/inner,
/area/centcom/central_command_areas/holding)
"VW" = (
/obj/structure/table/halflife/wood/bar,
/obj/structure/halflife/trash/glass/basic,
/turf/open/floor/plating/indoor/carpet,
/area/centcom/central_command_areas/holding)
"Wm" = (
/obj/effect/turf_decal/weather/dirt{
	dir = 6
	},
/turf/open/halflife/water/shallow,
/area/centcom/central_command_areas/holding)
"Xn" = (
/turf/open/floor/plating/indoor/carpet,
/area/centcom/central_command_areas/holding)
"XP" = (
/obj/structure/table/halflife/no_smooth/large/metal{
	dir = 1
	},
/turf/open/floor/plating/indoor/cafeteria,
/area/centcom/central_command_areas/holding)
"Zj" = (
/turf/closed/wall/halflife/concrete,
/area/centcom/central_command_areas/holding)
"Zs" = (
/obj/structure/chair/sofa/hl13bench,
/turf/open/floor/plating/ground/dirt/alt,
/area/centcom/central_command_areas/holding)

(1,1,1) = {"
wc
wc
wc
wc
wc
wc
wc
wc
wc
wc
wc
wc
wc
wc
wc
wc
wc
wc
wc
wc
wc
wc
wc
wc
wc
wc
wc
wc
wc
wc
wc
wc
"}
(2,1,1) = {"
wc
Zj
Zj
Zj
Zj
Zj
Zj
Zj
Zj
Zj
Zj
Zj
Zj
Zj
Zj
Zj
Zj
Zj
Zj
Zj
Zj
Zj
Zj
Zj
Zj
Zj
Zj
Zj
Zj
Zj
Zj
wc
"}
(3,1,1) = {"
wc
Zj
Ed
Ry
Ry
Ry
Ry
mw
VO
kI
gy
BB
lh
rn
rn
rn
ee
Xn
Xn
Xn
gd
rj
Zj
VO
VO
VO
VO
VO
RK
RK
RK
wc
"}
(4,1,1) = {"
wc
Zj
Ed
Ry
Ry
Ry
Ry
Vj
VO
VO
gy
BB
rn
rn
rn
rn
HU
JV
Xn
Xn
JV
VW
Zj
VO
VO
VO
VO
VO
RK
RK
RK
wc
"}
(5,1,1) = {"
wc
Zj
Ed
Ry
Ry
Ry
Ry
mw
VO
VO
gy
BB
rn
rn
rn
rn
HU
JV
Xn
Xn
JV
jG
Zj
VO
VO
VO
VO
RK
RK
RK
RK
wc
"}
(6,1,1) = {"
wc
Zj
Ed
Ry
Ry
Ry
Ry
mw
VO
VO
gy
wV
Ea
rn
zc
rn
Nt
JV
Xn
Xn
qx
jG
Zj
VO
VO
VO
VO
VO
RK
RK
RK
wc
"}
(7,1,1) = {"
wc
Zj
Ed
Ry
Ry
Ry
Ry
mw
VO
VO
Zj
Zj
Zj
Zj
Zj
Zj
Zj
gy
hq
Zj
Zj
Zj
Zj
VO
VO
VO
VO
VO
VO
RK
RK
wc
"}
(8,1,1) = {"
wc
Zj
Ed
Ry
Ry
Ry
Ry
mw
VO
LK
VO
VO
VO
VO
VO
VO
VO
VO
VO
VO
VO
VO
jb
VO
VO
VO
VO
VO
VO
RK
RK
wc
"}
(9,1,1) = {"
wc
Zj
Ed
Ry
Ry
Ry
Ry
mw
VO
dg
An
dg
dg
An
dg
dg
dg
dg
dg
An
dg
dg
An
dg
VO
VO
VO
VO
VO
RK
RK
wc
"}
(10,1,1) = {"
wc
Zj
Ed
Ry
Ry
Ry
Ry
mw
VO
dg
Zj
Zj
Zj
Zj
zU
zU
zU
zU
zU
Zj
Zj
Zj
Zj
dg
VO
VO
xB
VO
VO
RK
RK
wc
"}
(11,1,1) = {"
wc
Zj
Ed
Ry
Ry
Ry
Ry
mw
VO
dg
Zj
xe
xe
LE
LE
LE
Ht
Op
Op
Jj
Op
Ok
Zj
dg
VO
VO
VO
VO
VO
RK
RK
wc
"}
(12,1,1) = {"
wc
Zj
Ed
Ry
Ry
Ry
Ry
mw
VO
dg
zU
LE
LE
mj
xe
xe
xe
xe
Op
Op
xe
xe
zU
dg
VO
VO
VO
VO
VO
RK
RK
wc
"}
(13,1,1) = {"
wc
Zj
Ed
Ry
Ry
Ry
Ry
mw
VO
dg
zU
aB
LE
xe
xe
xe
zN
xe
xe
Ok
xe
aC
zU
dg
VO
VO
VO
VO
RK
RK
RK
wc
"}
(14,1,1) = {"
wc
Zj
Ed
Ry
Ry
Ry
Ry
mw
VO
dg
zU
LE
LE
Ht
Op
xe
Op
Ht
xe
xe
xe
xe
zU
dg
VO
VO
VO
RK
RK
RK
RK
wc
"}
(15,1,1) = {"
wc
Zj
Ed
Ry
Ry
Ry
Ry
mw
VO
fu
Zj
xe
LE
xe
xe
AO
UW
jf
LE
xe
Op
xe
Zj
Bw
VO
VO
VO
RK
RK
RK
RK
wc
"}
(16,1,1) = {"
wc
Zj
Ed
Ry
Ry
Ry
Ry
mw
VO
dg
yz
Op
Ok
eo
xe
bH
Ry
pN
LE
hO
Ht
xe
yz
dg
VO
VO
VO
VO
RK
RK
RK
wc
"}
(17,1,1) = {"
wc
Zj
Ed
Ry
Ry
Ry
Ry
mw
VO
fu
Zj
Op
xe
Op
xe
cW
RA
Wm
xe
xe
Op
Op
Zj
Bw
VO
VO
VO
VO
RK
RK
RK
wc
"}
(18,1,1) = {"
wc
Zj
Ed
Ry
Ry
Ry
Ry
mw
VO
dg
zU
Op
xe
xe
Ok
xe
Op
Op
xe
xe
LE
Op
zU
dg
VO
VO
VO
VO
VO
RK
RK
wc
"}
(19,1,1) = {"
wc
Zj
Ed
Ry
Ry
Ry
Ry
mw
VO
dg
zU
Zs
xe
xe
xe
xe
HW
xe
Op
Ok
xe
aC
zU
dg
VO
VO
VO
VO
VO
RK
RK
wc
"}
(20,1,1) = {"
wc
Zj
Ed
Ry
Ry
Ry
Ry
mw
VO
dg
zU
Ht
uv
xe
mj
LE
LE
LE
mj
xe
xe
xe
zU
dg
VO
VO
VO
VO
RK
RK
RK
wc
"}
(21,1,1) = {"
wc
Zj
Ed
Ry
Ry
Ry
Ry
mw
VO
dg
Zj
Op
LE
LE
Op
Op
Op
Op
Op
Op
xe
xe
Zj
dg
VO
VO
VO
VO
RK
RK
RK
wc
"}
(22,1,1) = {"
wc
Zj
Ed
Ry
Ry
Ry
Ry
mw
VO
FU
Zj
Zj
Zj
Zj
zU
zU
zU
zU
zU
Zj
Zj
Zj
Zj
dg
VO
VO
VO
VO
VO
RK
RK
wc
"}
(23,1,1) = {"
wc
Zj
Ed
Ry
Ry
Ry
Ry
mw
VO
dg
CD
dg
dg
CD
dg
dg
dg
dg
dg
CD
dg
dg
CD
dg
VO
VO
VO
RK
RK
RK
RK
wc
"}
(24,1,1) = {"
wc
Zj
Ed
Ry
Ry
Ry
Ry
mw
VO
VO
VO
VO
VO
iQ
VO
VO
VO
VO
VO
VO
VO
VO
VO
VO
VO
VO
RK
RK
RK
RK
RK
wc
"}
(25,1,1) = {"
wc
Zj
Ed
Ry
Ry
Ry
Ry
mw
VO
VO
Zj
Zj
Zj
Zj
Zj
Zj
Zj
iW
pK
Zj
Zj
Zj
Zj
VO
VO
VO
RK
RK
RK
RK
RK
wc
"}
(26,1,1) = {"
wc
Zj
Ed
Ry
Ry
Ry
Ry
mw
VO
VO
iW
XP
NU
JR
eg
lx
NU
JR
JR
JR
CG
XP
Zj
VO
VO
VO
VO
RK
RK
RK
RK
wc
"}
(27,1,1) = {"
wc
Zj
Ed
Ry
Ry
Ry
Ry
mw
VO
VO
iW
JR
OQ
JR
eg
Am
OQ
JR
JR
JR
eg
JR
Zj
VO
VO
VO
VO
VO
RK
RK
RK
wc
"}
(28,1,1) = {"
wc
Zj
Ed
Ry
Ry
Ry
Ry
mw
VO
VO
iW
JR
JR
JR
JR
JR
JR
JR
JR
JR
JR
JR
Zj
kI
VO
VO
VO
VO
RK
RK
RK
wc
"}
(29,1,1) = {"
wc
Zj
Ed
Ry
Ry
Ry
Ry
Vj
af
VO
iW
lI
OQ
JR
eg
XP
OQ
JR
JR
JR
eg
Sc
Zj
VO
VO
VO
VO
VO
RK
RK
RK
wc
"}
(30,1,1) = {"
wc
Zj
Ed
Ry
Ry
Ry
Ry
mw
VO
VO
iW
JR
iH
JR
eg
kl
iH
JR
JR
JR
Ar
ho
Zj
VO
VO
VO
VO
VO
VO
RK
RK
wc
"}
(31,1,1) = {"
wc
Zj
Zj
Zj
Zj
Zj
Zj
Zj
Zj
Zj
Zj
Zj
Zj
Zj
Zj
Zj
Zj
Zj
Zj
Zj
Zj
Zj
Zj
Zj
Zj
Zj
Zj
Zj
Zj
Zj
Zj
wc
"}
(32,1,1) = {"
wc
wc
wc
wc
wc
wc
wc
wc
wc
wc
wc
wc
wc
wc
wc
wc
wc
wc
wc
wc
wc
wc
wc
wc
wc
wc
wc
wc
wc
wc
wc
wc
"}
