//MAP CONVERTED BY dmm2tgm.py THIS HEADER COMMENT PREVENTS RECONVERSION, DO NOT REMOVE
"bi" = (
/obj/structure/halflife/trash/wood{
	dir = 6
	},
/turf/open/floor/plating/ground/sidewalk,
/area/deathmatch)
"by" = (
/obj/structure/table/halflife/wood/bar,
/obj/item/reagent_containers/cup/glass/bottle/beer/light,
/turf/open/floor/plating/indoor/woodc,
/area/deathmatch)
"db" = (
/obj/structure/halflife/trash/cardboard,
/obj/effect/spawner/random/halflife/loot/deathmatch/uprising,
/turf/open/floor/plating/indoor/woodc,
/area/deathmatch)
"dd" = (
/obj/structure/halflife/trash/papers/one{
	dir = 8
	},
/turf/open/floor/plating/indoor/woodc,
/area/deathmatch)
"eN" = (
/obj/item/stack/sheet/halflife/brick,
/turf/open/floor/plating/indoor/woodc,
/area/deathmatch)
"eX" = (
/obj/machinery/light/directional/north,
/turf/open/floor/plating/indoor/woodc,
/area/deathmatch)
"ft" = (
/obj/structure/table/halflife/wood,
/turf/open/floor/plating/indoor/woodc,
/area/deathmatch)
"hl" = (
/obj/machinery/door/unpowered/halflife/seethrough/metal,
/turf/open/floor/plating/indoor/woodc,
/area/deathmatch)
"jd" = (
/obj/structure/halflife/storage/large/shelf/wood,
/obj/effect/spawner/random/halflife/loot/deathmatch/uprising,
/turf/open/floor/plating/indoor/woodc,
/area/deathmatch)
"jD" = (
/turf/open/floor/plating/indoor/tile/kitchen,
/area/deathmatch)
"jO" = (
/turf/open/floor/plating/ground/grass,
/area/deathmatch)
"jV" = (
/obj/structure/closet/crate/bin,
/obj/effect/spawner/random/halflife/loot/deathmatch/uprising,
/turf/open/floor/plating/ground/sidewalk,
/area/deathmatch)
"ke" = (
/turf/open/floor/plating/ground/sidewalk,
/area/deathmatch)
"lV" = (
/obj/effect/spawner/random/halflife/loot/deathmatch/uprising,
/obj/structure/table/halflife/wood,
/turf/open/floor/plating/indoor/woodc,
/area/deathmatch)
"mL" = (
/obj/structure/halflife/trash/cardboard{
	dir = 4
	},
/obj/effect/spawner/random/halflife/loot/deathmatch/uprising,
/turf/open/floor/plating/indoor/woodc,
/area/deathmatch)
"mV" = (
/obj/structure/table/halflife/metal,
/obj/item/knife/kitchen,
/turf/open/floor/plating/indoor/tile/kitchen,
/area/deathmatch)
"na" = (
/obj/structure/chair/halflife/metal/stool,
/turf/open/floor/plating/indoor/woodc,
/area/deathmatch)
"nh" = (
/obj/structure/halflife/trash/papers/one{
	dir = 1
	},
/turf/open/floor/plating/indoor/woodc,
/area/deathmatch)
"qG" = (
/obj/structure/window/fulltile,
/turf/open/floor/plating/indoor/woodc,
/area/deathmatch)
"qN" = (
/obj/item/stack/sheet/halflife/brick,
/turf/open/floor/plating/ground/sidewalk/inner,
/area/deathmatch)
"ri" = (
/obj/machinery/power/halflife/streetlamphalt,
/turf/open/floor/plating/ground/sidewalk,
/area/deathmatch)
"tQ" = (
/obj/effect/spawner/random/halflife/loot/deathmatch/uprising,
/turf/open/floor/plating/ground/sidewalk/inner,
/area/deathmatch)
"tW" = (
/obj/structure/halflife/trash/garbage,
/turf/open/floor/plating/ground/sidewalk/inner,
/area/deathmatch)
"uh" = (
/obj/machinery/door/unpowered/halflife/seethrough/metal{
	dir = 8
	},
/turf/open/floor/plating/indoor/woodc,
/area/deathmatch)
"un" = (
/turf/open/floor/plating/indoor/woodc,
/area/deathmatch)
"vD" = (
/obj/structure/halflife/trash/papers/two{
	dir = 1
	},
/turf/open/floor/plating/indoor/woodc,
/area/deathmatch)
"vO" = (
/obj/machinery/light/directional/west,
/turf/open/floor/plating/indoor/woodc,
/area/deathmatch)
"wi" = (
/obj/structure/halflife/trash/papers/two{
	dir = 1
	},
/turf/open/floor/plating/ground/sidewalk/inner,
/area/deathmatch)
"wy" = (
/obj/effect/landmark/deathmatch_player_spawn,
/turf/open/floor/plating/indoor/woodc,
/area/deathmatch)
"wC" = (
/obj/machinery/light/directional/east,
/turf/open/floor/plating/indoor/woodc,
/area/deathmatch)
"xz" = (
/obj/effect/spawner/random/halflife/loot/deathmatch/uprising,
/obj/structure/closet/crate/bin,
/turf/open/floor/plating/ground/sidewalk,
/area/deathmatch)
"yd" = (
/obj/effect/landmark/deathmatch_player_spawn,
/turf/open/floor/plating/ground/brickroad{
	dir = 1
	},
/area/deathmatch)
"yf" = (
/obj/structure/halflife/trash/papers/two,
/turf/open/floor/plating/ground/sidewalk/inner,
/area/deathmatch)
"yo" = (
/obj/structure/halflife/trash/cardboard{
	dir = 4;
	pixel_y = 9
	},
/turf/open/floor/plating/indoor/woodc,
/area/deathmatch)
"AU" = (
/obj/structure/halflife/trash/papers/two{
	dir = 1
	},
/turf/open/floor/plating/ground/sidewalk,
/area/deathmatch)
"Br" = (
/obj/item/stack/sheet/halflife/brick,
/turf/open/floor/plating/ground/sidewalk,
/area/deathmatch)
"Dh" = (
/obj/structure/halflife/trash/papers/two,
/turf/open/floor/plating/indoor/woodc,
/area/deathmatch)
"Dz" = (
/obj/structure/halflife/sign/bar{
	pixel_y = 0
	},
/turf/closed/wall/halflife/brick,
/area/deathmatch)
"Fg" = (
/obj/machinery/power/halflife/streetlamphalt,
/turf/open/floor/plating/ground/sidewalk/inner,
/area/deathmatch)
"FZ" = (
/turf/open/floor/plating/ground/brickroad{
	dir = 1
	},
/area/deathmatch)
"Gm" = (
/obj/effect/spawner/random/halflife/loot/deathmatch/uprising,
/turf/open/floor/plating/ground/sidewalk,
/area/deathmatch)
"IL" = (
/obj/structure/table/halflife/wood,
/obj/effect/spawner/random/halflife/loot/deathmatch/uprising,
/turf/open/floor/plating/indoor/woodc,
/area/deathmatch)
"Jx" = (
/obj/machinery/door/unpowered/halflife/seethrough/metal{
	dir = 4
	},
/turf/open/floor/plating/indoor/woodc,
/area/deathmatch)
"JJ" = (
/obj/structure/halflife/trash/papers/two{
	dir = 8
	},
/turf/open/floor/plating/ground/brickroad{
	dir = 1
	},
/area/deathmatch)
"Kx" = (
/obj/structure/table/halflife/metal,
/obj/effect/spawner/random/halflife/loot/deathmatch/uprising,
/turf/open/floor/plating/indoor/tile/kitchen,
/area/deathmatch)
"KG" = (
/obj/effect/spawner/random/halflife/loot/deathmatch/uprising,
/turf/open/floor/plating/ground/brickroad,
/area/deathmatch)
"Ln" = (
/turf/open/floor/plating/ground/brickroad,
/area/deathmatch)
"LK" = (
/obj/effect/landmark/deathmatch_player_spawn,
/turf/open/floor/plating/ground/sidewalk/inner,
/area/deathmatch)
"MM" = (
/turf/closed/wall/halflife/brick,
/area/deathmatch)
"NF" = (
/obj/effect/spawner/random/halflife/loot/deathmatch/uprising,
/turf/open/floor/plating/ground/brickroad{
	dir = 1
	},
/area/deathmatch)
"QY" = (
/obj/machinery/door/unpowered/halflife/seethrough/metal,
/turf/open/floor/plating/indoor/tile/kitchen,
/area/deathmatch)
"Rp" = (
/obj/machinery/light/directional/east,
/obj/structure/table/halflife/metal,
/turf/open/floor/plating/indoor/tile/kitchen,
/area/deathmatch)
"RQ" = (
/obj/effect/landmark/deathmatch_player_spawn,
/turf/open/floor/plating/ground/brickroad,
/area/deathmatch)
"Tj" = (
/obj/structure/table/halflife/wood/bar,
/obj/effect/spawner/random/halflife/loot/deathmatch/uprising,
/turf/open/floor/plating/indoor/woodc,
/area/deathmatch)
"Tn" = (
/obj/effect/spawner/random/halflife/loot/deathmatch/uprising,
/turf/open/floor/plating/indoor/woodc,
/area/deathmatch)
"TO" = (
/obj/machinery/power/halflife/streetlamphalt,
/turf/open/floor/plating/ground/grass,
/area/deathmatch)
"UI" = (
/turf/open/floor/plating/ground/sidewalk/inner,
/area/deathmatch)
"VV" = (
/obj/structure/halflife/trash/garbage,
/turf/open/floor/plating/indoor/woodc,
/area/deathmatch)
"Ws" = (
/turf/closed/indestructible/riveted,
/area/deathmatch)
"WG" = (
/obj/structure/halflife/trash/papers/one,
/turf/open/floor/plating/ground/sidewalk,
/area/deathmatch)
"XY" = (
/obj/structure/table/halflife/wood,
/obj/structure/halflife/trash/papers/one{
	dir = 8
	},
/turf/open/floor/plating/indoor/woodc,
/area/deathmatch)
"Yn" = (
/obj/structure/table/halflife/metal,
/turf/open/floor/plating/indoor/tile/kitchen,
/area/deathmatch)
"YR" = (
/obj/structure/table/halflife/wood/bar,
/turf/open/floor/plating/indoor/woodc,
/area/deathmatch)
"ZD" = (
/obj/structure/halflife/trash/cardboard{
	dir = 10
	},
/turf/open/floor/plating/indoor/tile/kitchen,
/area/deathmatch)
"ZN" = (
/obj/structure/halflife/trash/papers/one{
	dir = 8
	},
/turf/open/floor/plating/ground/sidewalk/inner,
/area/deathmatch)

(1,1,1) = {"
Ws
Ws
Ws
Ws
Ws
Ws
Ws
Ws
Ws
Ws
Ws
Ws
Ws
Ws
Ws
Ws
Ws
Ws
Ws
Ws
Ws
Ws
Ws
Ws
Ws
Ws
Ws
Ws
Ws
Ws
Ws
Ws
Ws
Ws
Ws
Ws
Ws
Ws
Ws
"}
(2,1,1) = {"
Ws
MM
MM
MM
MM
MM
MM
MM
MM
MM
MM
MM
MM
MM
MM
MM
MM
MM
MM
MM
MM
MM
MM
MM
MM
MM
MM
MM
MM
MM
MM
MM
MM
MM
MM
MM
MM
MM
Ws
"}
(3,1,1) = {"
Ws
MM
MM
MM
MM
MM
MM
MM
ft
wy
un
un
un
un
un
MM
UI
ri
FZ
FZ
NF
ri
UI
MM
un
un
un
un
ft
MM
MM
MM
MM
MM
MM
MM
MM
MM
Ws
"}
(4,1,1) = {"
Ws
MM
MM
MM
MM
MM
MM
MM
lV
un
un
un
un
un
un
MM
UI
ke
FZ
yd
FZ
ke
UI
MM
eX
un
wy
un
ft
MM
Yn
mV
Yn
MM
MM
MM
MM
MM
Ws
"}
(5,1,1) = {"
Ws
MM
MM
MM
MM
MM
MM
MM
XY
un
Tn
un
un
un
un
MM
UI
ke
NF
FZ
FZ
ke
tQ
qG
un
un
un
Tn
ft
MM
jD
jD
jD
MM
MM
MM
MM
MM
Ws
"}
(6,1,1) = {"
Ws
MM
MM
MM
MM
MM
MM
MM
un
un
un
YR
na
un
un
hl
UI
ke
FZ
FZ
FZ
ke
UI
qG
un
un
un
un
un
QY
jD
jD
ZD
MM
MM
MM
MM
MM
Ws
"}
(7,1,1) = {"
Ws
MM
MM
MM
MM
MM
MM
MM
un
un
un
by
na
un
un
MM
UI
ke
FZ
FZ
FZ
ke
UI
MM
un
un
Tn
un
un
MM
jD
jD
jD
MM
MM
MM
MM
MM
Ws
"}
(8,1,1) = {"
Ws
MM
MM
MM
MM
MM
MM
MM
un
un
un
Tj
na
un
un
Dz
UI
WG
FZ
FZ
FZ
AU
UI
hl
un
un
un
un
un
MM
Yn
Rp
Kx
MM
MM
MM
MM
MM
Ws
"}
(9,1,1) = {"
Ws
MM
MM
MM
MM
MM
MM
MM
yo
un
wC
by
na
un
un
MM
UI
ke
FZ
FZ
FZ
ke
UI
MM
ft
ft
un
un
un
MM
MM
MM
MM
MM
MM
MM
MM
MM
Ws
"}
(10,1,1) = {"
Ws
MM
MM
MM
MM
MM
MM
MM
MM
MM
MM
MM
MM
MM
MM
MM
tW
ke
FZ
FZ
FZ
ke
UI
MM
MM
MM
MM
MM
MM
MM
MM
MM
MM
MM
MM
MM
MM
MM
Ws
"}
(11,1,1) = {"
Ws
MM
MM
MM
MM
MM
MM
MM
lV
ft
IL
MM
UI
UI
UI
UI
UI
ke
FZ
FZ
FZ
ke
UI
UI
UI
UI
UI
MM
IL
ft
ft
un
un
nh
MM
MM
MM
MM
Ws
"}
(12,1,1) = {"
Ws
MM
MM
MM
MM
MM
MM
MM
un
un
un
qG
UI
ke
ke
ke
ke
ri
FZ
FZ
FZ
ri
Br
ke
ke
ke
UI
MM
un
un
un
un
Tn
un
MM
MM
MM
MM
Ws
"}
(13,1,1) = {"
Ws
MM
MM
MM
MM
MM
MM
MM
eX
un
un
qG
UI
ke
Ln
Ln
Ln
Ln
FZ
FZ
FZ
Ln
Ln
Ln
Ln
ke
UI
hl
un
un
un
wy
un
un
MM
MM
MM
MM
Ws
"}
(14,1,1) = {"
Ws
MM
MM
MM
MM
MM
MM
MM
un
un
eN
qG
UI
ke
Ln
Ln
Ln
Ln
FZ
FZ
FZ
Ln
Ln
Ln
Ln
ke
UI
MM
VV
un
un
Tn
un
un
MM
MM
MM
MM
Ws
"}
(15,1,1) = {"
Ws
MM
MM
MM
MM
MM
MM
MM
yo
wy
un
MM
ZN
ke
Ln
Ln
Ln
Ln
FZ
FZ
FZ
Ln
Ln
Ln
Ln
ke
Fg
MM
un
un
un
un
wC
un
MM
MM
MM
MM
Ws
"}
(16,1,1) = {"
Ws
MM
MM
MM
MM
MM
MM
MM
MM
MM
MM
MM
UI
ke
FZ
FZ
FZ
ri
ke
xz
ke
ri
FZ
FZ
FZ
ke
UI
MM
MM
MM
Jx
MM
MM
MM
MM
MM
MM
MM
Ws
"}
(17,1,1) = {"
Ws
MM
tQ
UI
UI
UI
UI
UI
UI
UI
UI
UI
UI
ke
FZ
JJ
FZ
ke
UI
UI
UI
ke
FZ
FZ
FZ
ke
UI
UI
UI
UI
UI
UI
UI
UI
UI
UI
MM
MM
Ws
"}
(18,1,1) = {"
Ws
MM
ke
ke
ri
ke
Gm
ke
ke
ri
ke
ke
ke
ke
FZ
FZ
FZ
ke
UI
jO
UI
ke
FZ
FZ
FZ
ke
ke
ke
ke
ri
ke
ke
Gm
ke
ri
ke
MM
MM
Ws
"}
(19,1,1) = {"
Ws
MM
Ln
Ln
Ln
Ln
Ln
Ln
Ln
Ln
Ln
Ln
Ln
Ln
Ln
Ln
Ln
ke
UI
jO
UI
Gm
Ln
Ln
Ln
Ln
Ln
Ln
Ln
Ln
Ln
Ln
Ln
Ln
Ln
KG
MM
MM
Ws
"}
(20,1,1) = {"
Ws
MM
Ln
RQ
Ln
Ln
Ln
Ln
Ln
Ln
Ln
Ln
Ln
Ln
Ln
Ln
Ln
ke
UI
TO
LK
ke
Ln
Ln
Ln
Ln
Ln
Ln
Ln
Ln
Ln
Ln
Ln
Ln
RQ
Ln
MM
MM
Ws
"}
(21,1,1) = {"
Ws
MM
Ln
Ln
Ln
Ln
Ln
Ln
Ln
Ln
Ln
Ln
Ln
Ln
Ln
Ln
Ln
ke
tQ
jO
UI
ke
Ln
Ln
Ln
Ln
Ln
Ln
Ln
Ln
Ln
Ln
Ln
Ln
Ln
Ln
MM
MM
Ws
"}
(22,1,1) = {"
Ws
MM
ke
ke
ri
ke
ke
ke
ke
ri
ke
ke
ke
ke
FZ
FZ
FZ
bi
UI
jO
UI
ke
FZ
FZ
FZ
ke
ke
ke
ke
ri
ke
ke
ke
ke
ri
Gm
MM
MM
Ws
"}
(23,1,1) = {"
Ws
MM
UI
tQ
UI
yf
UI
UI
UI
UI
UI
UI
qN
ke
FZ
FZ
FZ
ke
UI
UI
UI
ke
FZ
FZ
FZ
ke
UI
wi
UI
UI
UI
UI
UI
UI
UI
UI
MM
MM
Ws
"}
(24,1,1) = {"
Ws
MM
MM
MM
MM
MM
MM
MM
MM
MM
MM
MM
UI
ke
FZ
FZ
FZ
ri
ke
jV
ke
ri
FZ
FZ
FZ
ke
qN
MM
MM
MM
uh
MM
qG
qG
qG
MM
MM
MM
Ws
"}
(25,1,1) = {"
Ws
MM
MM
MM
mL
un
un
un
un
un
un
hl
UI
ke
Ln
Ln
Ln
Ln
FZ
FZ
FZ
Ln
Ln
Ln
KG
ke
Fg
MM
un
un
un
un
un
un
lV
MM
MM
MM
Ws
"}
(26,1,1) = {"
Ws
MM
MM
MM
un
wy
un
un
un
un
un
MM
UI
ke
Ln
Ln
Ln
Ln
FZ
FZ
FZ
Ln
Ln
Ln
Ln
ke
UI
MM
eN
un
un
un
un
un
lV
MM
MM
MM
Ws
"}
(27,1,1) = {"
Ws
MM
MM
MM
un
un
un
un
un
eN
un
qG
UI
ke
Ln
Ln
Ln
Ln
FZ
FZ
FZ
Ln
Ln
Ln
Ln
ke
UI
MM
eX
un
un
un
un
wy
un
MM
MM
MM
Ws
"}
(28,1,1) = {"
Ws
MM
MM
MM
eX
un
un
un
un
un
un
qG
UI
ke
ke
ke
ke
ri
FZ
FZ
FZ
ri
ke
ke
ke
ke
UI
MM
VV
un
un
un
un
un
un
MM
MM
MM
Ws
"}
(29,1,1) = {"
Ws
MM
MM
MM
lV
lV
un
Dh
wC
un
un
qG
UI
UI
qN
UI
UI
ke
FZ
FZ
FZ
ke
UI
UI
UI
UI
tW
MM
un
un
un
un
un
un
un
MM
MM
MM
Ws
"}
(30,1,1) = {"
Ws
MM
MM
MM
MM
MM
MM
MM
MM
MM
uh
MM
MM
MM
MM
MM
UI
ke
FZ
FZ
FZ
ke
yf
MM
uh
MM
MM
MM
MM
MM
MM
IL
un
un
vD
MM
MM
MM
Ws
"}
(31,1,1) = {"
Ws
MM
MM
MM
MM
MM
MM
MM
MM
yo
un
un
vO
un
un
qG
UI
ke
FZ
FZ
FZ
ke
UI
MM
un
un
un
dd
eN
un
MM
ft
un
un
un
MM
MM
MM
Ws
"}
(32,1,1) = {"
Ws
MM
MM
MM
MM
MM
MM
MM
MM
un
un
vD
un
un
un
qG
UI
ke
FZ
FZ
FZ
ke
UI
MM
un
un
un
un
un
un
MM
un
un
un
un
MM
MM
MM
Ws
"}
(33,1,1) = {"
Ws
MM
MM
MM
MM
MM
MM
MM
MM
jd
un
un
un
un
un
MM
UI
ke
FZ
FZ
FZ
ke
UI
qG
un
un
un
un
un
un
hl
un
un
un
un
MM
MM
MM
Ws
"}
(34,1,1) = {"
Ws
MM
MM
MM
MM
MM
MM
MM
MM
un
un
un
un
un
un
hl
UI
Gm
FZ
FZ
FZ
ke
UI
qG
un
un
lV
un
un
un
MM
MM
MM
MM
uh
MM
MM
MM
Ws
"}
(35,1,1) = {"
Ws
MM
MM
MM
MM
MM
MM
MM
MM
un
un
un
un
eN
un
MM
UI
ke
FZ
FZ
NF
ke
UI
qG
un
un
lV
un
un
un
hl
un
ft
VV
un
MM
MM
MM
Ws
"}
(36,1,1) = {"
Ws
MM
MM
MM
MM
MM
MM
MM
MM
IL
un
un
un
un
un
MM
UI
ke
FZ
FZ
FZ
ke
UI
qG
un
un
un
un
un
un
MM
un
un
un
eN
MM
MM
MM
Ws
"}
(37,1,1) = {"
Ws
MM
MM
MM
MM
MM
MM
MM
MM
ft
un
wy
un
un
un
MM
UI
ke
FZ
yd
FZ
ke
UI
qG
un
wy
un
un
un
un
MM
un
un
un
un
MM
MM
MM
Ws
"}
(38,1,1) = {"
Ws
MM
MM
MM
MM
MM
MM
MM
MM
IL
un
un
wC
un
VV
MM
tQ
ri
FZ
FZ
FZ
ri
tW
MM
VV
un
wC
un
un
db
MM
lV
wC
ft
lV
MM
MM
MM
Ws
"}
(39,1,1) = {"
Ws
MM
MM
MM
MM
MM
MM
MM
MM
MM
MM
MM
MM
MM
MM
MM
MM
MM
MM
MM
MM
MM
MM
MM
MM
MM
MM
MM
MM
MM
MM
MM
MM
MM
MM
MM
MM
MM
Ws
"}
(40,1,1) = {"
Ws
Ws
Ws
Ws
Ws
Ws
Ws
Ws
Ws
Ws
Ws
Ws
Ws
Ws
Ws
Ws
Ws
Ws
Ws
Ws
Ws
Ws
Ws
Ws
Ws
Ws
Ws
Ws
Ws
Ws
Ws
Ws
Ws
Ws
Ws
Ws
Ws
Ws
Ws
"}
