//MAP CONVERTED BY dmm2tgm.py THIS HEADER COMMENT PREVENTS RECONVERSION, DO NOT REMOVE
"a" = (
/turf/open/floor/plating/indoor/metal/pipe,
/area/deathmatch)
"c" = (
/obj/effect/decal/cleanable/blood/gibs/limb,
/obj/effect/decal/cleanable/dirt/dust,
/turf/open/floor/plating/indoor/metal/grate,
/area/deathmatch)
"d" = (
/obj/structure/window/reinforced/spawner/directional/south,
/obj/effect/spawner/structure/electrified_grille,
/obj/structure/window/reinforced/spawner/directional/west,
/turf/open/floor/plating/indoor/metal/grate,
/area/deathmatch)
"e" = (
/obj/effect/decal/cleanable/dirt/dust,
/obj/item/flashlight/flare{
	start_on = 1;
	icon_state = "flare-on"
	},
/turf/open/floor/plating/indoor/metal/plate,
/area/deathmatch)
"i" = (
/turf/closed/wall/halflife/metal,
/area/deathmatch)
"k" = (
/obj/structure/cable,
/obj/machinery/power/rtg/debug{
	power_gen = 50000;
	name = "dumb idiot shocker powerer";
	desc = "Dont touch the grilles idiot"
	},
/turf/open/floor/plating/indoor/metal/pipe,
/area/deathmatch)
"l" = (
/obj/effect/spawner/structure/electrified_grille,
/obj/structure/window/reinforced/spawner/directional/east,
/turf/open/floor/plating/indoor/metal/grate,
/area/deathmatch)
"n" = (
/obj/effect/spawner/structure/electrified_grille,
/obj/structure/window/reinforced/spawner/directional/north,
/obj/structure/window/reinforced/spawner/directional/east,
/turf/open/floor/plating/indoor/metal/grate,
/area/deathmatch)
"o" = (
/obj/effect/spawner/random/trash/graffiti,
/obj/effect/decal/cleanable/dirt/dust,
/turf/open/floor/plating/indoor/metal/grate,
/area/deathmatch)
"p" = (
/obj/effect/landmark/deathmatch_player_spawn,
/obj/effect/decal/cleanable/dirt/dust,
/turf/open/floor/plating/indoor/metal/plate,
/area/deathmatch)
"r" = (
/obj/effect/spawner/random/trash/mess,
/obj/effect/decal/cleanable/dirt/dust,
/turf/open/floor/plating/indoor/metal/grate,
/area/deathmatch)
"t" = (
/obj/effect/decal/cleanable/blood/gibs/torso,
/obj/effect/decal/cleanable/dirt/dust,
/turf/open/floor/plating/indoor/metal/plate,
/area/deathmatch)
"u" = (
/obj/structure/cable,
/turf/open/floor/plating/indoor/metal,
/area/deathmatch)
"v" = (
/obj/effect/spawner/structure/electrified_grille,
/obj/structure/window/reinforced/spawner/directional/west,
/turf/open/floor/plating/indoor/metal/grate,
/area/deathmatch)
"y" = (
/obj/effect/decal/cleanable/blood,
/obj/effect/decal/cleanable/dirt/dust,
/turf/open/floor/plating/indoor/metal/grate,
/area/deathmatch)
"D" = (
/obj/effect/decal/cleanable/blood/tracks{
	dir = 4
	},
/obj/effect/decal/cleanable/dirt/dust,
/turf/open/floor/plating/indoor/metal/plate,
/area/deathmatch)
"E" = (
/obj/effect/decal/cleanable/dirt/dust,
/obj/item/flashlight/flare{
	start_on = 1;
	icon_state = "flare-on"
	},
/turf/open/floor/plating/indoor/metal/grate,
/area/deathmatch)
"H" = (
/obj/effect/spawner/structure/electrified_grille,
/obj/structure/window/reinforced/spawner/directional/south,
/obj/structure/window/reinforced/spawner/directional/east,
/turf/open/floor/plating/indoor/metal/grate,
/area/deathmatch)
"I" = (
/obj/effect/decal/cleanable/blood/tracks{
	dir = 10
	},
/obj/effect/decal/cleanable/dirt/dust,
/turf/open/floor/plating/indoor/metal/grate,
/area/deathmatch)
"J" = (
/turf/open/floor/plating/indoor/metal,
/area/deathmatch)
"K" = (
/obj/structure/window/reinforced/spawner/directional/south,
/obj/effect/spawner/structure/electrified_grille,
/turf/open/floor/plating/indoor/metal/grate,
/area/deathmatch)
"L" = (
/obj/structure/chair/halflife/metal/folding{
	dir = 8
	},
/turf/open/floor/plating/indoor/metal,
/area/deathmatch)
"M" = (
/obj/effect/decal/cleanable/blood/tracks,
/obj/effect/decal/cleanable/dirt/dust,
/turf/open/floor/plating/indoor/metal/grate,
/area/deathmatch)
"N" = (
/obj/effect/spawner/structure/electrified_grille,
/obj/structure/window/reinforced/spawner/directional/west,
/obj/structure/window/reinforced/spawner/directional/north,
/turf/open/floor/plating/indoor/metal/grate,
/area/deathmatch)
"O" = (
/obj/effect/spawner/random/trash/graffiti,
/obj/effect/decal/cleanable/dirt/dust,
/turf/open/floor/plating/indoor/metal/plate,
/area/deathmatch)
"Q" = (
/obj/effect/spawner/random/trash/mess,
/obj/effect/decal/cleanable/dirt/dust,
/turf/open/floor/plating/indoor/metal/plate,
/area/deathmatch)
"S" = (
/obj/effect/decal/cleanable/blood/gibs/down,
/obj/effect/decal/cleanable/dirt/dust,
/turf/open/floor/plating/indoor/metal/plate,
/area/deathmatch)
"T" = (
/obj/effect/spawner/structure/electrified_grille,
/obj/structure/window/reinforced/spawner/directional/north,
/turf/open/floor/plating/indoor/metal/grate,
/area/deathmatch)
"U" = (
/obj/effect/decal/cleanable/dirt/dust,
/turf/open/floor/plating/indoor/metal/grate,
/area/deathmatch)
"V" = (
/obj/effect/decal/cleanable/dirt/dust,
/turf/open/floor/plating/indoor/metal/plate,
/area/deathmatch)
"Y" = (
/obj/structure/chair/halflife/metal/folding{
	dir = 4
	},
/turf/open/floor/plating/indoor/metal,
/area/deathmatch)
"Z" = (
/obj/effect/spawner/structure/electrified_grille,
/obj/structure/window/reinforced/spawner/directional/south,
/turf/open/floor/plating/indoor/metal/grate,
/area/deathmatch)

(1,1,1) = {"
i
i
i
i
i
i
i
i
i
i
i
i
i
i
i
"}
(2,1,1) = {"
i
k
u
J
J
J
J
J
J
J
J
J
J
a
i
"}
(3,1,1) = {"
i
a
u
Y
Y
Y
J
J
Y
Y
J
Y
J
a
i
"}
(4,1,1) = {"
i
a
N
v
v
v
v
v
v
v
v
v
d
a
i
"}
(5,1,1) = {"
i
a
T
U
U
U
y
M
I
o
U
U
K
a
i
"}
(6,1,1) = {"
i
a
T
U
e
V
V
p
D
V
V
U
K
a
i
"}
(7,1,1) = {"
i
a
T
U
V
O
V
V
D
V
e
U
Z
a
i
"}
(8,1,1) = {"
i
a
T
U
V
V
Q
V
V
S
V
U
Z
a
i
"}
(9,1,1) = {"
i
a
T
U
p
V
V
V
V
V
p
o
Z
a
i
"}
(10,1,1) = {"
i
a
T
o
V
t
V
V
V
V
V
U
Z
a
i
"}
(11,1,1) = {"
i
a
T
U
V
V
e
V
V
V
V
U
Z
a
i
"}
(12,1,1) = {"
i
a
T
U
V
V
V
p
O
V
V
r
Z
a
i
"}
(13,1,1) = {"
i
a
T
U
U
c
U
U
U
U
U
E
Z
a
i
"}
(14,1,1) = {"
i
a
n
l
l
l
l
l
l
l
l
l
H
a
i
"}
(15,1,1) = {"
i
a
J
L
L
L
L
L
J
L
L
L
L
a
i
"}
(16,1,1) = {"
i
a
J
J
J
J
J
J
J
J
J
J
J
a
i
"}
(17,1,1) = {"
i
i
i
i
i
i
i
i
i
i
i
i
i
i
i
"}
