//MAP CONVERTED BY dmm2tgm.py THIS HEADER COMMENT PREVENTS RECONVERSION, DO NOT REMOVE
"aV" = (
/obj/structure/reagent_dispensers/fueltank,
/turf/open/floor/plating/indoor/metal/smooth,
/area/deathmatch)
"aX" = (
/obj/structure/table/halflife/metal,
/turf/open/floor/plating/indoor/metal/smooth,
/area/deathmatch)
"bm" = (
/obj/machinery/door/airlock/highsecurity/combine,
/turf/open/floor/plating/indoor/metal/combine/alt2,
/area/deathmatch)
"bo" = (
/obj/structure/table/halflife/metal/grate,
/obj/structure/halflife/trash/papers/two,
/turf/open/floor/plating/indoor/metal/smooth,
/area/deathmatch)
"bH" = (
/obj/structure/halflife/pallet,
/turf/open/floor/plating/indoor/metal/combine/alt2,
/area/deathmatch)
"cL" = (
/obj/structure/halflife/road_barrier{
	dir = 8
	},
/turf/open/floor/plating/ground/sidewalk,
/area/deathmatch)
"dt" = (
/obj/effect/turf_decal/siding/thinplating{
	dir = 1
	},
/obj/effect/turf_decal/siding/thinplating,
/obj/structure/halflife/road_barrier{
	dir = 4
	},
/turf/open/floor/plating/ground/brickroad{
	dir = 1
	},
/area/deathmatch)
"fZ" = (
/obj/structure/reagent_dispensers/fueltank,
/turf/open/floor/plating/indoor/metal/combine/alt2,
/area/deathmatch)
"ip" = (
/obj/machinery/vending/breenwater,
/turf/open/floor/plating/indoor/metal/smooth,
/area/deathmatch)
"lc" = (
/obj/effect/landmark/deathmatch_player_spawn,
/obj/machinery/combine_walllight/directional/south,
/turf/open/floor/plating/indoor/metal/combine/alt2,
/area/deathmatch)
"lm" = (
/obj/structure/table/halflife/metal,
/obj/effect/spawner/random/halflife/loot/deathmatch/nexus,
/turf/open/floor/plating/indoor/metal/smooth,
/area/deathmatch)
"lB" = (
/obj/machinery/combine_walllight/directional/west,
/turf/open/floor/plating/indoor/metal/combine/alt2,
/area/deathmatch)
"mI" = (
/obj/structure/table/halflife/metal,
/turf/open/floor/plating/indoor/metal/combine,
/area/deathmatch)
"nC" = (
/obj/structure/table/halflife/metal,
/obj/structure/halflife/trash/papers/three,
/turf/open/floor/plating/indoor/metal/smooth,
/area/deathmatch)
"nV" = (
/turf/open/floor/plating/indoor/metal/combine/alt2,
/area/deathmatch)
"os" = (
/obj/structure/table/halflife/metal/grate,
/turf/open/floor/plating/indoor/metal/smooth,
/area/deathmatch)
"oG" = (
/obj/structure/chair/office/halflife/blue,
/turf/open/floor/plating/indoor/metal/combine,
/area/deathmatch)
"oZ" = (
/turf/cordon,
/area/deathmatch)
"qx" = (
/turf/open/floor/plating/indoor/metal/smooth,
/area/deathmatch)
"qG" = (
/obj/effect/landmark/deathmatch_player_spawn,
/turf/open/floor/plating/indoor/metal/smooth,
/area/deathmatch)
"rt" = (
/obj/machinery/combine_walllight/directional/north,
/turf/open/floor/plating/indoor/metal/combine/alt2,
/area/deathmatch)
"rO" = (
/obj/effect/turf_decal/siding/thinplating{
	dir = 1
	},
/obj/effect/turf_decal/siding/thinplating,
/obj/structure/halflife/road_barrier{
	dir = 8
	},
/turf/open/floor/plating/ground/brickroad{
	dir = 1
	},
/area/deathmatch)
"rP" = (
/obj/structure/halflife/road_barrier/combine,
/turf/open/floor/plating/indoor/metal/smooth,
/area/deathmatch)
"rR" = (
/obj/effect/spawner/random/halflife/loot/deathmatch/nexus,
/turf/open/floor/plating/indoor/metal/smooth,
/area/deathmatch)
"vE" = (
/obj/structure/halflife/storage/large/shelf,
/turf/open/floor/plating/indoor/metal/combine/alt2,
/area/deathmatch)
"wk" = (
/turf/open/floor/plating/ground/sidewalk/inner,
/area/deathmatch)
"wW" = (
/obj/structure/window/fulltile,
/turf/open/floor/plating/indoor/metal/smooth,
/area/deathmatch)
"xm" = (
/turf/closed/wall/halflife/metal,
/area/deathmatch)
"ys" = (
/obj/effect/landmark/deathmatch_player_spawn,
/turf/open/floor/plating/ground/sidewalk/inner,
/area/deathmatch)
"yz" = (
/obj/machinery/combine_walllight/directional/west,
/turf/open/floor/plating/indoor/metal/smooth,
/area/deathmatch)
"zp" = (
/turf/open/floor/plating/indoor/metal/combine,
/area/deathmatch)
"zY" = (
/obj/structure/halflife/storage/large/shelf,
/turf/open/floor/plating/indoor/metal/smooth,
/area/deathmatch)
"BP" = (
/obj/structure/halflife/storage/large/shelf,
/obj/effect/spawner/random/halflife/loot/deathmatch/nexus,
/turf/open/floor/plating/indoor/metal/smooth,
/area/deathmatch)
"Dw" = (
/obj/structure/halflife/road_barrier/combine,
/turf/open/floor/plating/ground/sidewalk,
/area/deathmatch)
"DQ" = (
/obj/machinery/combine_walllight/directional/south,
/turf/open/floor/plating/indoor/metal/combine,
/area/deathmatch)
"Es" = (
/obj/structure/table/halflife/metal/grate,
/obj/structure/halflife/trash/cardboard,
/turf/open/floor/plating/indoor/metal/combine/alt2,
/area/deathmatch)
"EZ" = (
/obj/structure/halflife/road_barrier/concrete{
	dir = 4
	},
/turf/open/floor/plating/indoor/metal/smooth,
/area/deathmatch)
"GF" = (
/obj/effect/landmark/deathmatch_player_spawn,
/turf/open/floor/plating/indoor/metal/combine/alt2,
/area/deathmatch)
"Ha" = (
/obj/machinery/combine_walllight/directional/east,
/turf/open/floor/plating/indoor/metal/combine/alt2,
/area/deathmatch)
"ID" = (
/obj/structure/halflife/storage/large/shelf,
/obj/effect/spawner/random/halflife/loot/deathmatch/nexus,
/turf/open/floor/plating/indoor/metal/combine/alt2,
/area/deathmatch)
"IW" = (
/obj/machinery/combine_walllight/directional/south,
/turf/open/floor/plating/indoor/metal/smooth,
/area/deathmatch)
"Jx" = (
/obj/effect/spawner/random/halflife/loot/deathmatch/nexus,
/turf/open/floor/plating/ground/sidewalk/inner,
/area/deathmatch)
"JJ" = (
/obj/machinery/door/airlock/highsecurity/combine,
/turf/open/floor/plating/indoor/metal/smooth,
/area/deathmatch)
"JV" = (
/obj/effect/turf_decal/siding/thinplating{
	dir = 1
	},
/obj/effect/turf_decal/siding/thinplating,
/turf/open/floor/plating/ground/brickroad{
	dir = 1
	},
/area/deathmatch)
"JZ" = (
/obj/structure/table/halflife/metal/grate,
/obj/effect/spawner/random/halflife/loot/deathmatch/nexus,
/turf/open/floor/plating/indoor/metal/combine/alt2,
/area/deathmatch)
"Ka" = (
/obj/structure/table/halflife/no_smooth/cable_reel,
/turf/open/floor/plating/indoor/metal/combine/alt2,
/area/deathmatch)
"KO" = (
/obj/structure/halflife/trash/garbage,
/turf/open/floor/plating/indoor/metal/combine/alt2,
/area/deathmatch)
"Lj" = (
/obj/structure/halflife/trash/bricks,
/turf/open/floor/plating/ground/sidewalk/inner,
/area/deathmatch)
"Nl" = (
/obj/machinery/combine_walllight/directional/south,
/turf/open/floor/plating/ground/sidewalk/inner,
/area/deathmatch)
"OV" = (
/obj/machinery/combine_walllight/directional/east,
/turf/open/floor/plating/indoor/metal/smooth,
/area/deathmatch)
"Pe" = (
/obj/structure/halflife/barrel/double/grey/one,
/turf/open/floor/plating/indoor/metal/combine/alt2,
/area/deathmatch)
"PY" = (
/obj/structure/halflife/barrel/single/label/one,
/turf/open/floor/plating/indoor/metal/smooth,
/area/deathmatch)
"Qf" = (
/obj/structure/table/halflife/metal/grate,
/turf/open/floor/plating/indoor/metal/combine/alt2,
/area/deathmatch)
"SE" = (
/turf/open/floor/plating/ground/sidewalk,
/area/deathmatch)
"Ur" = (
/obj/structure/halflife/road_barrier{
	dir = 4
	},
/turf/open/floor/plating/ground/sidewalk,
/area/deathmatch)
"Vg" = (
/obj/structure/table/halflife/metal/grate,
/obj/effect/spawner/random/halflife/loot/deathmatch/nexus,
/turf/open/floor/plating/indoor/metal/smooth,
/area/deathmatch)
"Wc" = (
/obj/structure/halflife/barrel/double/grey/two,
/turf/open/floor/plating/indoor/metal/combine/alt2,
/area/deathmatch)
"XG" = (
/turf/closed/indestructible/riveted,
/area/deathmatch)
"ZG" = (
/turf/closed/wall/halflife/brick,
/area/deathmatch)
"ZJ" = (
/obj/structure/table/halflife/metal,
/obj/structure/halflife/trash/books,
/turf/open/floor/plating/indoor/metal/combine,
/area/deathmatch)

(1,1,1) = {"
XG
XG
XG
XG
XG
XG
XG
XG
XG
XG
XG
XG
XG
XG
XG
XG
XG
XG
XG
XG
XG
XG
XG
XG
XG
XG
XG
XG
XG
XG
"}
(2,1,1) = {"
XG
xm
xm
xm
xm
xm
xm
xm
xm
xm
xm
xm
xm
xm
xm
xm
xm
xm
xm
xm
xm
xm
xm
oZ
oZ
oZ
oZ
oZ
ZG
XG
"}
(3,1,1) = {"
XG
xm
JZ
Qf
nV
Ha
nV
nV
GF
xm
Vg
OV
Vg
xm
BP
qx
qx
OV
qx
qx
qx
qG
xm
wk
Ur
dt
Ur
ys
ZG
XG
"}
(4,1,1) = {"
XG
xm
Qf
nV
nV
nV
nV
nV
nV
xm
qx
qx
qx
xm
qx
qx
qx
rP
qx
qx
qx
qx
xm
wk
SE
JV
SE
wk
ZG
XG
"}
(5,1,1) = {"
XG
xm
Qf
nV
nV
nV
nV
nV
nV
bm
qx
qx
qx
wW
qx
qx
qx
rP
qx
qx
qx
aV
xm
Nl
SE
JV
SE
wk
ZG
XG
"}
(6,1,1) = {"
XG
xm
JZ
Qf
nV
nV
nV
nV
Wc
xm
qx
qx
qx
JJ
qx
qx
qx
qx
qx
qx
qx
os
xm
wk
SE
JV
SE
wk
ZG
XG
"}
(7,1,1) = {"
XG
xm
xm
xm
xm
xm
bm
xm
xm
xm
qx
qx
qx
wW
qx
qx
qx
rP
qx
qx
qx
Vg
xm
Jx
SE
JV
SE
Lj
ZG
XG
"}
(8,1,1) = {"
XG
xm
nC
qx
qx
qx
qx
qx
qx
wW
qx
qx
qx
xm
xm
xm
xm
xm
xm
JJ
xm
xm
xm
wk
SE
JV
SE
wk
ZG
XG
"}
(9,1,1) = {"
XG
xm
lm
qx
qx
qx
qx
qx
qx
JJ
qx
qx
qG
xm
Vg
os
Vg
qx
qx
qx
qx
qx
xm
wk
SE
JV
SE
wk
ZG
XG
"}
(10,1,1) = {"
XG
xm
aX
qx
yz
qx
qx
qx
qx
wW
qx
qx
EZ
xm
qx
qx
qx
qx
qx
qx
qx
qx
wW
wk
SE
JV
SE
wk
ZG
XG
"}
(11,1,1) = {"
XG
xm
xm
xm
xm
xm
JJ
xm
xm
xm
IW
qx
qx
xm
qx
qx
qx
qx
yz
qx
qx
qx
xm
wk
SE
JV
SE
wk
ZG
XG
"}
(12,1,1) = {"
XG
xm
vE
nV
fZ
Qf
nV
nV
JZ
xm
qx
qx
qx
xm
wW
JJ
wW
xm
xm
xm
xm
xm
xm
wk
SE
JV
SE
wk
ZG
XG
"}
(13,1,1) = {"
XG
xm
nV
nV
nV
Qf
nV
nV
Qf
xm
qx
qx
qx
xm
qx
qx
qx
qx
qx
qx
qx
qx
xm
wk
Dw
JV
SE
wk
ZG
XG
"}
(14,1,1) = {"
XG
xm
KO
nV
nV
nV
nV
nV
Ka
xm
qx
qx
qx
xm
zp
zp
mI
qx
qx
qx
qx
qx
xm
Nl
Dw
JV
SE
wk
ZG
XG
"}
(15,1,1) = {"
XG
xm
lc
nV
nV
nV
nV
nV
rt
xm
xm
JJ
xm
xm
DQ
oG
mI
qG
qx
qx
qx
qx
JJ
wk
SE
JV
SE
wk
ZG
XG
"}
(16,1,1) = {"
XG
xm
bH
nV
nV
Pe
nV
nV
Ka
xm
qx
qx
qx
xm
zp
zp
ZJ
qx
qx
qx
qx
qx
xm
wk
Dw
JV
SE
wk
ZG
XG
"}
(17,1,1) = {"
XG
xm
ID
nV
nV
Qf
nV
nV
Es
xm
qx
qx
qx
xm
qx
qx
qx
qx
qx
yz
qx
ip
xm
wk
Dw
JV
SE
wk
ZG
XG
"}
(18,1,1) = {"
XG
xm
nV
nV
nV
Qf
nV
nV
Qf
xm
qx
qx
qx
xm
wW
JJ
wW
xm
xm
xm
xm
xm
xm
wk
SE
JV
SE
wk
ZG
XG
"}
(19,1,1) = {"
XG
xm
xm
xm
xm
xm
JJ
xm
xm
xm
IW
qx
qx
xm
qx
qx
qx
qx
OV
qx
qx
qx
xm
wk
SE
JV
SE
wk
ZG
XG
"}
(20,1,1) = {"
XG
xm
aX
qx
OV
qx
qx
qx
qx
wW
qx
qx
EZ
xm
qx
qx
qx
qx
qx
qx
qx
qx
wW
wk
SE
JV
SE
wk
ZG
XG
"}
(21,1,1) = {"
XG
xm
lm
qx
qx
qx
qx
qx
qx
JJ
qx
qx
qG
xm
Vg
bo
Vg
qx
qx
qx
qx
qx
xm
wk
SE
JV
SE
wk
ZG
XG
"}
(22,1,1) = {"
XG
xm
aX
qx
qx
qx
qx
qx
qx
wW
qx
qx
qx
xm
xm
xm
xm
xm
xm
JJ
xm
xm
xm
wk
SE
JV
SE
wk
ZG
XG
"}
(23,1,1) = {"
XG
xm
xm
xm
xm
xm
bm
xm
xm
xm
qx
qx
qx
wW
qx
qx
qx
rP
qx
qx
qx
Vg
xm
Jx
SE
JV
SE
wk
ZG
XG
"}
(24,1,1) = {"
XG
xm
Pe
nV
nV
nV
nV
nV
nV
xm
qx
qx
qx
JJ
qx
qx
qx
qx
qx
qx
qx
os
xm
wk
SE
JV
SE
wk
ZG
XG
"}
(25,1,1) = {"
XG
xm
nV
nV
nV
nV
nV
nV
nV
bm
qx
qx
qx
wW
qx
qx
qx
rP
qx
qx
qx
PY
xm
wk
SE
JV
SE
wk
ZG
XG
"}
(26,1,1) = {"
XG
xm
nV
nV
nV
nV
nV
nV
nV
xm
qx
qx
qx
xm
qx
qx
qx
rP
qx
qx
qx
qx
xm
Nl
SE
JV
SE
wk
ZG
XG
"}
(27,1,1) = {"
XG
xm
nV
nV
nV
nV
nV
nV
JZ
xm
qx
qx
qx
xm
zY
qx
qx
rP
qx
qx
qx
qx
xm
wk
SE
JV
SE
wk
ZG
XG
"}
(28,1,1) = {"
XG
xm
GF
nV
nV
lB
JZ
Qf
Qf
xm
Vg
yz
Vg
xm
rR
qx
qx
yz
qx
qx
qx
qG
xm
ys
cL
rO
cL
wk
ZG
XG
"}
(29,1,1) = {"
XG
xm
xm
xm
xm
xm
xm
xm
xm
xm
xm
xm
xm
xm
xm
xm
xm
xm
xm
xm
xm
xm
xm
oZ
oZ
oZ
oZ
oZ
ZG
XG
"}
(30,1,1) = {"
XG
XG
XG
XG
XG
XG
XG
XG
XG
XG
XG
XG
XG
XG
XG
XG
XG
XG
XG
XG
XG
XG
XG
XG
XG
XG
XG
XG
XG
XG
"}
