//MAP CONVERTED BY dmm2tgm.py THIS HEADER COMMENT PREVENTS RECONVERSION, DO NOT REMOVE
"a" = (
/turf/open/floor/plating/ground/sidewalk/inner,
/area/deathmatch)
"b" = (
/obj/structure/halflife/road_barrier/combine,
/turf/open/floor/plating/ground/sidewalk,
/area/deathmatch)
"c" = (
/obj/effect/turf_decal/siding/thinplating{
	dir = 1
	},
/obj/effect/turf_decal/siding/thinplating,
/turf/open/floor/plating/ground/brickroad{
	dir = 1
	},
/area/deathmatch)
"d" = (
/obj/machinery/combine_walllight/directional/south,
/turf/open/floor/plating/indoor/metal/combine,
/area/deathmatch)
"e" = (
/turf/open/floor/plating/ground/sidewalk,
/area/deathmatch)
"f" = (
/obj/structure/chair/office/halflife/blue,
/turf/open/floor/plating/indoor/metal/combine,
/area/deathmatch)
"g" = (
/obj/machinery/combine_walllight/directional/east,
/turf/open/floor/plating/indoor/metal/smooth,
/area/deathmatch)
"h" = (
/obj/structure/halflife/storage/large/shelf,
/turf/open/floor/plating/indoor/metal/combine/alt2,
/area/deathmatch)
"j" = (
/obj/machinery/combine_walllight/directional/north,
/turf/open/floor/plating/indoor/metal/combine/alt2,
/area/deathmatch)
"k" = (
/obj/effect/spawner/random/halflife/loot/deathmatch/nexus,
/turf/open/floor/plating/indoor/metal/smooth,
/area/deathmatch)
"l" = (
/obj/structure/halflife/storage/large/shelf,
/obj/effect/spawner/random/halflife/loot/deathmatch/nexus,
/turf/open/floor/plating/indoor/metal/smooth,
/area/deathmatch)
"m" = (
/obj/machinery/vending/breenwater,
/turf/open/floor/plating/indoor/metal/smooth,
/area/deathmatch)
"n" = (
/obj/effect/spawner/random/halflife/loot/deathmatch/nexus,
/turf/open/floor/plating/ground/sidewalk/inner,
/area/deathmatch)
"p" = (
/obj/effect/landmark/deathmatch_player_spawn,
/turf/open/floor/plating/indoor/metal/combine/alt2,
/area/deathmatch)
"q" = (
/obj/structure/halflife/road_barrier{
	dir = 4
	},
/turf/open/floor/plating/ground/sidewalk,
/area/deathmatch)
"r" = (
/obj/structure/table/halflife/metal,
/turf/open/floor/plating/indoor/metal/combine,
/area/deathmatch)
"s" = (
/obj/structure/table/halflife/metal,
/turf/open/floor/plating/indoor/metal/smooth,
/area/deathmatch)
"t" = (
/obj/structure/table/halflife/metal/grate,
/turf/open/floor/plating/indoor/metal/smooth,
/area/deathmatch)
"v" = (
/turf/closed/indestructible/riveted,
/area/deathmatch)
"w" = (
/obj/structure/table/halflife/metal,
/obj/effect/spawner/random/halflife/loot/deathmatch/nexus,
/turf/open/floor/plating/indoor/metal/smooth,
/area/deathmatch)
"x" = (
/obj/effect/turf_decal/siding/thinplating{
	dir = 1
	},
/obj/effect/turf_decal/siding/thinplating,
/obj/structure/halflife/road_barrier{
	dir = 4
	},
/turf/open/floor/plating/ground/brickroad{
	dir = 1
	},
/area/deathmatch)
"y" = (
/obj/machinery/combine_walllight/directional/west,
/turf/open/floor/plating/indoor/metal/smooth,
/area/deathmatch)
"z" = (
/obj/structure/halflife/road_barrier{
	dir = 8
	},
/turf/open/floor/plating/ground/sidewalk,
/area/deathmatch)
"A" = (
/obj/effect/landmark/deathmatch_player_spawn,
/turf/open/floor/plating/ground/sidewalk/inner,
/area/deathmatch)
"B" = (
/obj/structure/window/fulltile,
/turf/open/floor/plating/indoor/metal/smooth,
/area/deathmatch)
"C" = (
/obj/machinery/combine_walllight/directional/south,
/turf/open/floor/plating/ground/sidewalk/inner,
/area/deathmatch)
"E" = (
/obj/structure/halflife/road_barrier/combine,
/turf/open/floor/plating/indoor/metal/smooth,
/area/deathmatch)
"F" = (
/obj/structure/halflife/pallet,
/turf/open/floor/plating/indoor/metal/combine/alt2,
/area/deathmatch)
"H" = (
/turf/cordon,
/area/deathmatch)
"I" = (
/obj/structure/table/halflife/metal/grate,
/turf/open/floor/plating/indoor/metal/combine/alt2,
/area/deathmatch)
"J" = (
/obj/structure/halflife/storage/large/shelf,
/obj/effect/spawner/random/halflife/loot/deathmatch/nexus,
/turf/open/floor/plating/indoor/metal/combine/alt2,
/area/deathmatch)
"K" = (
/obj/structure/table/halflife/metal/grate,
/obj/effect/spawner/random/halflife/loot/deathmatch/nexus,
/turf/open/floor/plating/indoor/metal/combine/alt2,
/area/deathmatch)
"L" = (
/turf/closed/wall/halflife/brick,
/area/deathmatch)
"N" = (
/obj/structure/table/halflife/no_smooth/cable_reel,
/turf/open/floor/plating/indoor/metal/combine/alt2,
/area/deathmatch)
"O" = (
/obj/machinery/door/airlock/highsecurity/combine,
/turf/open/floor/plating/indoor/metal/smooth,
/area/deathmatch)
"P" = (
/turf/open/floor/plating/indoor/metal/combine,
/area/deathmatch)
"Q" = (
/obj/machinery/combine_walllight/directional/south,
/turf/open/floor/plating/indoor/metal/smooth,
/area/deathmatch)
"R" = (
/obj/effect/landmark/deathmatch_player_spawn,
/turf/open/floor/plating/indoor/metal/smooth,
/area/deathmatch)
"S" = (
/turf/open/floor/plating/indoor/metal/smooth,
/area/deathmatch)
"T" = (
/obj/structure/halflife/storage/large/shelf,
/turf/open/floor/plating/indoor/metal/smooth,
/area/deathmatch)
"U" = (
/turf/open/floor/plating/indoor/metal/combine/alt2,
/area/deathmatch)
"W" = (
/obj/structure/table/halflife/metal/grate,
/obj/effect/spawner/random/halflife/loot/deathmatch/nexus,
/turf/open/floor/plating/indoor/metal/smooth,
/area/deathmatch)
"X" = (
/obj/effect/turf_decal/siding/thinplating{
	dir = 1
	},
/obj/effect/turf_decal/siding/thinplating,
/obj/structure/halflife/road_barrier{
	dir = 8
	},
/turf/open/floor/plating/ground/brickroad{
	dir = 1
	},
/area/deathmatch)
"Y" = (
/obj/structure/halflife/road_barrier/concrete{
	dir = 4
	},
/turf/open/floor/plating/indoor/metal/smooth,
/area/deathmatch)
"Z" = (
/turf/closed/wall/halflife/metal,
/area/deathmatch)

(1,1,1) = {"
v
v
v
v
v
v
v
v
v
v
v
v
v
v
v
v
v
v
v
v
v
v
v
v
v
v
v
v
v
v
"}
(2,1,1) = {"
v
Z
Z
Z
Z
Z
Z
Z
Z
Z
Z
Z
Z
Z
Z
Z
Z
Z
Z
Z
Z
Z
Z
H
H
H
H
H
L
v
"}
(3,1,1) = {"
v
Z
W
t
S
g
S
S
R
Z
W
g
W
Z
l
S
S
g
S
S
S
R
Z
a
q
x
q
A
L
v
"}
(4,1,1) = {"
v
Z
t
S
S
S
S
S
S
Z
S
S
S
Z
S
S
S
E
S
S
S
S
Z
a
e
c
e
a
L
v
"}
(5,1,1) = {"
v
Z
t
S
S
S
S
S
S
O
S
S
S
B
S
S
S
E
S
S
S
S
Z
C
e
c
e
a
L
v
"}
(6,1,1) = {"
v
Z
W
t
S
S
S
S
S
Z
S
S
S
O
S
S
S
S
S
S
S
t
Z
a
e
c
e
a
L
v
"}
(7,1,1) = {"
v
Z
Z
Z
Z
Z
O
Z
Z
Z
S
S
S
B
S
S
S
E
S
S
S
W
Z
n
e
c
e
a
L
v
"}
(8,1,1) = {"
v
Z
s
S
S
S
S
S
S
B
S
S
S
Z
Z
Z
Z
Z
Z
O
Z
Z
Z
a
e
c
e
a
L
v
"}
(9,1,1) = {"
v
Z
w
S
S
S
S
S
S
O
S
S
R
Z
W
t
W
S
S
S
S
S
Z
a
e
c
e
a
L
v
"}
(10,1,1) = {"
v
Z
s
S
y
S
S
S
S
B
S
S
Y
Z
S
S
S
S
S
S
S
S
B
a
e
c
e
a
L
v
"}
(11,1,1) = {"
v
Z
Z
Z
Z
Z
O
Z
Z
Z
Q
S
S
Z
S
S
S
S
y
S
S
S
Z
a
e
c
e
a
L
v
"}
(12,1,1) = {"
v
Z
h
U
U
I
U
U
K
Z
S
S
S
Z
B
O
B
Z
Z
Z
Z
Z
Z
a
e
c
e
a
L
v
"}
(13,1,1) = {"
v
Z
U
U
U
I
U
U
I
Z
S
S
S
Z
S
S
S
S
S
S
S
S
Z
a
b
c
e
a
L
v
"}
(14,1,1) = {"
v
Z
U
U
U
U
U
U
N
Z
S
S
S
Z
P
P
r
S
S
S
S
S
Z
C
b
c
e
a
L
v
"}
(15,1,1) = {"
v
Z
p
U
U
U
U
U
j
Z
Z
O
Z
Z
d
f
r
R
S
S
S
S
O
a
e
c
e
a
L
v
"}
(16,1,1) = {"
v
Z
F
U
U
U
U
U
N
Z
S
S
S
Z
P
P
r
S
S
S
S
S
Z
a
b
c
e
a
L
v
"}
(17,1,1) = {"
v
Z
J
U
U
I
U
U
I
Z
S
S
S
Z
S
S
S
S
S
S
S
m
Z
a
b
c
e
a
L
v
"}
(18,1,1) = {"
v
Z
U
U
U
I
U
U
I
Z
S
S
S
Z
B
O
B
Z
Z
Z
Z
Z
Z
a
e
c
e
a
L
v
"}
(19,1,1) = {"
v
Z
Z
Z
Z
Z
O
Z
Z
Z
Q
S
S
Z
S
S
S
S
g
S
S
S
Z
a
e
c
e
a
L
v
"}
(20,1,1) = {"
v
Z
s
S
g
S
S
S
S
B
S
S
Y
Z
S
S
S
S
S
S
S
S
B
a
e
c
e
a
L
v
"}
(21,1,1) = {"
v
Z
w
S
S
S
S
S
S
O
S
S
R
Z
W
t
W
S
S
S
S
S
Z
a
e
c
e
a
L
v
"}
(22,1,1) = {"
v
Z
s
S
S
S
S
S
S
B
S
S
S
Z
Z
Z
Z
Z
Z
O
Z
Z
Z
a
e
c
e
a
L
v
"}
(23,1,1) = {"
v
Z
Z
Z
Z
Z
O
Z
Z
Z
S
S
S
B
S
S
S
E
S
S
S
W
Z
n
e
c
e
a
L
v
"}
(24,1,1) = {"
v
Z
S
S
S
S
S
S
S
Z
S
S
S
O
S
S
S
S
S
S
S
t
Z
a
e
c
e
a
L
v
"}
(25,1,1) = {"
v
Z
S
S
S
S
S
S
S
O
S
S
S
B
S
S
S
E
S
S
S
S
Z
a
e
c
e
a
L
v
"}
(26,1,1) = {"
v
Z
S
S
S
S
S
S
S
Z
S
S
S
Z
S
S
S
E
S
S
S
S
Z
C
e
c
e
a
L
v
"}
(27,1,1) = {"
v
Z
S
S
S
S
S
S
W
Z
S
S
S
Z
T
S
S
E
S
S
S
S
Z
a
e
c
e
a
L
v
"}
(28,1,1) = {"
v
Z
R
S
S
y
W
t
t
Z
W
y
W
Z
k
S
S
y
S
S
S
R
Z
A
z
X
z
a
L
v
"}
(29,1,1) = {"
v
Z
Z
Z
Z
Z
Z
Z
Z
Z
Z
Z
Z
Z
Z
Z
Z
Z
Z
Z
Z
Z
Z
H
H
H
H
H
L
v
"}
(30,1,1) = {"
v
v
v
v
v
v
v
v
v
v
v
v
v
v
v
v
v
v
v
v
v
v
v
v
v
v
v
v
v
v
"}
