//MAP CONVERTED BY dmm2tgm.py THIS HEADER COMMENT PREVENTS RECONVERSION, DO NOT REMOVE
"a" = (
/obj/structure/flora/bush/fullgrass/style_random,
/turf/open/floor/plating/ground/dirt,
/area/deathmatch)
"b" = (
/obj/structure/flora/tree/jungle/small/style_random,
/turf/open/floor/plating/ground/dirt,
/area/deathmatch)
"d" = (
/obj/effect/light_emitter/fake_outdoors,
/turf/open/floor/plating/ground/dirt,
/area/deathmatch)
"e" = (
/turf/cordon,
/area/deathmatch)
"g" = (
/turf/open/floor/plating/ground/grass,
/area/deathmatch)
"h" = (
/obj/structure/flora/tree/jungle/small/style_random,
/turf/open/floor/plating/ground/dirt/alt,
/area/deathmatch)
"i" = (
/obj/structure/flora/bush/sparsegrass/style_random,
/turf/open/floor/plating/ground/dirt/alt,
/area/deathmatch)
"k" = (
/obj/effect/turf_decal/weather/dirt{
	dir = 4
	},
/turf/open/halflife/water/shallow,
/area/deathmatch)
"m" = (
/obj/structure/flora/bush/fullgrass/style_random,
/obj/effect/light_emitter/fake_outdoors,
/obj/effect/landmark/deathmatch_player_spawn,
/turf/open/floor/plating/ground/dirt/alt,
/area/deathmatch)
"n" = (
/obj/effect/turf_decal/weather/dirt{
	dir = 4
	},
/obj/effect/turf_decal/weather/dirt{
	dir = 8
	},
/turf/open/halflife/water/shallow,
/area/deathmatch)
"o" = (
/obj/effect/light_emitter/fake_outdoors,
/turf/open/floor/plating/ground/dirt/alt,
/area/deathmatch)
"p" = (
/obj/effect/turf_decal/weather/dirt{
	dir = 5
	},
/turf/open/halflife/water/shallow,
/area/deathmatch)
"q" = (
/obj/effect/turf_decal/weather/dirt,
/turf/open/halflife/water/shallow,
/area/deathmatch)
"s" = (
/obj/effect/landmark/deathmatch_player_spawn,
/turf/open/floor/plating/ground/grass,
/area/deathmatch)
"t" = (
/obj/effect/turf_decal/weather/dirt{
	dir = 6
	},
/turf/open/halflife/water/shallow,
/area/deathmatch)
"u" = (
/obj/structure/flora/bush/fullgrass/style_random,
/obj/effect/light_emitter/fake_outdoors,
/turf/open/floor/plating/ground/dirt,
/area/deathmatch)
"v" = (
/obj/effect/landmark/deathmatch_player_spawn,
/turf/open/floor/plating/ground/dirt,
/area/deathmatch)
"w" = (
/obj/structure/flora/bush/fullgrass/style_random,
/turf/open/floor/plating/ground/grass,
/area/deathmatch)
"x" = (
/obj/effect/turf_decal/weather/dirt{
	dir = 9
	},
/obj/effect/turf_decal/weather/dirt{
	dir = 10
	},
/turf/open/halflife/water/shallow,
/area/deathmatch)
"y" = (
/turf/open/floor/plating/ground/dirt/alt,
/area/deathmatch)
"z" = (
/obj/effect/turf_decal/weather/dirt{
	dir = 1
	},
/obj/effect/turf_decal/weather/dirt,
/turf/open/halflife/water/shallow,
/area/deathmatch)
"A" = (
/obj/structure/flora/tree/jungle/style_random,
/turf/open/floor/plating/ground/dirt/alt,
/area/deathmatch)
"B" = (
/obj/structure/flora/bush/sparsegrass/style_random,
/turf/open/floor/plating/ground/dirt,
/area/deathmatch)
"C" = (
/obj/effect/turf_decal/weather/dirt{
	dir = 10
	},
/turf/open/halflife/water/shallow,
/area/deathmatch)
"D" = (
/obj/structure/flora/tree/jungle/small/style_random,
/turf/open/floor/plating/ground/grass,
/area/deathmatch)
"E" = (
/obj/effect/light_emitter/fake_outdoors,
/turf/open/floor/plating/ground/grass,
/area/deathmatch)
"H" = (
/obj/effect/turf_decal/weather/dirt{
	dir = 8
	},
/obj/effect/turf_decal/weather/dirt{
	dir = 4
	},
/turf/open/halflife/water/shallow,
/area/deathmatch)
"I" = (
/obj/structure/flora/tree/jungle/small/style_random,
/obj/effect/light_emitter/fake_outdoors,
/turf/open/floor/plating/ground/grass,
/area/deathmatch)
"J" = (
/obj/structure/flora/tree/jungle/style_random,
/turf/open/floor/plating/ground/grass,
/area/deathmatch)
"K" = (
/obj/structure/flora/bush/fullgrass/style_random,
/turf/open/floor/plating/ground/dirt/alt,
/area/deathmatch)
"L" = (
/obj/effect/landmark/deathmatch_player_spawn,
/turf/open/floor/plating/ground/dirt/alt,
/area/deathmatch)
"P" = (
/obj/effect/turf_decal/weather/dirt{
	dir = 8
	},
/turf/open/halflife/water/shallow,
/area/deathmatch)
"Q" = (
/obj/structure/flora/bush/sparsegrass/style_random,
/obj/effect/light_emitter/fake_outdoors,
/turf/open/floor/plating/ground/dirt,
/area/deathmatch)
"R" = (
/obj/effect/turf_decal/weather/dirt{
	dir = 9
	},
/turf/open/halflife/water/shallow,
/area/deathmatch)
"S" = (
/obj/effect/turf_decal/weather/dirt{
	dir = 1
	},
/turf/open/halflife/water/shallow,
/area/deathmatch)
"T" = (
/obj/structure/flora/bush/sparsegrass/style_random,
/turf/open/floor/plating/ground/grass,
/area/deathmatch)
"U" = (
/obj/structure/flora/tree/jungle/style_random,
/turf/open/floor/plating/ground/dirt,
/area/deathmatch)
"W" = (
/turf/open/halflife/water/shallow,
/area/deathmatch)
"X" = (
/obj/structure/flora/bush/fullgrass/style_random,
/obj/effect/light_emitter/fake_outdoors,
/turf/open/floor/plating/ground/dirt/alt,
/area/deathmatch)
"Z" = (
/turf/open/floor/plating/ground/dirt,
/area/deathmatch)

(1,1,1) = {"
e
e
e
e
e
e
e
e
e
e
e
e
e
e
e
e
e
e
e
e
e
e
e
e
e
e
e
e
e
e
e
e
e
e
e
e
e
e
e
e
e
e
e
e
e
e
e
e
e
e
"}
(2,1,1) = {"
e
Z
Z
g
Z
g
g
g
g
g
Z
Z
Z
g
g
g
w
g
Z
y
y
Z
Z
y
y
y
y
y
y
y
y
y
y
y
Z
Z
g
g
g
g
g
g
g
g
g
g
g
g
g
e
"}
(3,1,1) = {"
e
Z
s
g
g
g
g
g
Z
Z
Z
y
y
Z
Z
g
Z
g
Z
Z
K
y
Z
Z
y
L
y
Z
Z
Z
Z
Z
Z
Z
Z
Z
a
Z
g
g
g
g
g
g
g
g
s
g
g
e
"}
(4,1,1) = {"
e
g
g
g
g
Z
g
Z
g
Z
a
y
y
Z
Z
g
Z
g
Z
Z
Z
Z
Z
Z
Z
b
Z
Z
Z
Z
g
g
Z
b
Z
Z
a
Z
Z
Z
a
a
g
J
w
g
g
w
g
e
"}
(5,1,1) = {"
e
g
Z
w
B
Z
g
B
g
Z
Z
Z
Z
Z
w
Z
y
w
g
g
g
g
g
Z
Z
Z
K
y
y
Z
Z
g
w
Z
Z
Z
Z
Z
Z
Z
Z
Z
Z
g
g
Z
g
g
g
e
"}
(6,1,1) = {"
e
g
Z
g
Z
d
g
a
g
g
g
d
Z
Z
g
Z
D
E
g
g
g
Z
g
E
g
Z
y
Z
B
Q
Z
g
g
g
Z
d
Z
Z
Z
Z
b
d
Z
g
Z
Z
g
E
g
e
"}
(7,1,1) = {"
e
g
g
Z
y
y
a
Z
g
g
b
Z
a
g
Z
g
g
Z
Z
a
g
Z
Z
Z
Z
Z
y
Z
b
Z
Z
Z
g
g
g
Z
Z
a
Z
Z
Z
Z
Z
Z
Z
a
g
g
g
e
"}
(8,1,1) = {"
e
g
g
y
K
Z
g
g
g
g
Z
Z
Z
g
g
Z
Z
g
g
g
g
g
b
g
Z
Z
y
Z
Z
Z
w
g
g
g
D
g
g
g
g
Z
g
Z
g
Z
Z
g
g
g
g
e
"}
(9,1,1) = {"
e
g
Z
y
Z
g
Z
g
w
Z
a
Z
Z
g
g
Z
Z
Z
g
g
a
Z
Z
g
g
g
a
y
Z
Z
Z
Z
g
Z
g
g
g
Z
Z
g
g
g
Z
Z
g
Z
g
g
g
e
"}
(10,1,1) = {"
e
Z
y
b
g
Z
g
g
a
Z
B
Z
Z
Z
Z
a
Z
Z
Z
g
g
g
Z
Z
Z
Z
Z
Z
y
Z
B
Z
Z
g
g
g
g
Z
g
g
Z
Z
g
g
Z
D
Z
w
g
e
"}
(11,1,1) = {"
e
Z
y
Z
g
g
Z
Z
Z
Z
Z
B
Z
Z
Z
Z
Z
a
a
Z
Z
Z
g
g
Z
Z
Z
Z
Z
y
i
Z
Z
Z
g
T
Z
g
D
g
Z
g
g
Z
Z
Z
Z
g
g
e
"}
(12,1,1) = {"
e
Z
y
a
Z
d
Z
y
Z
a
Z
d
Z
b
Z
Z
Z
d
Z
Z
Z
Z
B
E
T
g
g
Z
Z
d
y
y
Z
g
w
E
Z
g
g
Z
Z
d
Z
Z
Z
g
Z
d
a
e
"}
(13,1,1) = {"
e
Z
y
K
y
K
y
y
Z
Z
Z
Z
Z
Z
Z
Z
Z
Z
Z
Z
Z
Z
Z
Z
T
g
Z
g
a
Z
Z
Z
y
Z
Z
Z
g
g
g
Z
Z
B
Z
Z
Z
g
Z
U
Z
e
"}
(14,1,1) = {"
e
Z
y
K
Z
Z
Z
Z
b
Z
g
Z
Z
a
a
Z
Z
a
K
a
Z
Z
Z
Z
g
g
g
g
g
g
Z
Z
y
y
Z
Z
g
g
g
Z
Z
Z
Z
Z
T
Z
Z
Z
Z
e
"}
(15,1,1) = {"
e
Z
y
Z
Z
g
g
Z
Z
g
Z
Z
Z
Z
Z
Z
Z
Z
Z
y
y
b
Z
Z
Z
g
g
g
g
g
w
Z
Z
i
Z
g
g
g
g
Z
Z
Z
Z
b
g
Z
Z
Z
Z
e
"}
(16,1,1) = {"
e
y
y
a
g
g
w
g
g
g
Z
Z
Z
Z
v
Z
g
Z
Z
y
y
y
Z
B
Z
Z
Z
Z
g
g
b
g
Z
Z
Z
s
Z
g
g
B
Z
Z
Z
Z
Z
Z
Z
Z
Z
e
"}
(17,1,1) = {"
e
y
Z
a
g
Z
g
g
g
B
Z
Z
Z
a
Z
g
g
Z
Z
B
y
Z
y
Z
Z
a
Z
Z
g
Z
g
g
g
Z
g
Z
Z
g
Z
Z
g
g
Z
Z
Z
Z
i
Z
Z
e
"}
(18,1,1) = {"
e
Z
Z
Z
g
E
Z
g
Z
Z
Z
d
Z
Z
Z
J
T
d
Z
Z
y
y
y
o
Z
a
Z
Z
Z
E
Z
T
g
Z
Z
d
Z
g
Z
g
Z
E
Z
Z
Z
Z
y
o
Z
e
"}
(19,1,1) = {"
e
Z
Z
Z
Z
g
g
g
Z
Z
a
Z
Z
g
g
T
Z
Z
Z
Z
a
y
Z
B
Z
Z
Z
Z
B
g
Z
g
Z
Z
Z
Z
g
g
g
b
D
Z
B
Z
a
Z
y
y
a
e
"}
(20,1,1) = {"
e
Z
Z
a
g
g
Z
b
Z
Z
Z
Z
Z
g
g
Z
Z
Z
a
Z
Z
R
P
H
C
Z
b
Z
Z
g
Z
Z
y
y
Z
Z
g
g
Z
g
Z
Z
B
Z
Z
y
y
y
Z
e
"}
(21,1,1) = {"
e
Z
g
w
w
Z
Z
Z
Z
g
Z
Z
g
Z
w
b
Z
Z
a
Z
Z
S
t
y
p
C
Z
Z
g
Z
Z
i
y
y
a
a
Z
g
g
g
Z
Z
Z
Z
y
Z
y
Z
Z
e
"}
(22,1,1) = {"
e
Z
g
g
Z
Z
Z
Z
Z
g
Z
Z
g
Z
Z
g
g
Z
Z
Z
Z
z
y
y
y
p
C
Z
a
Z
Z
y
y
Z
Z
g
g
Z
Z
Z
Z
B
y
y
Z
b
Z
Z
Z
e
"}
(23,1,1) = {"
e
g
Z
g
Z
Z
B
Z
a
g
Z
Z
g
g
g
Z
g
Z
Z
Z
B
S
C
Z
x
Z
S
a
Z
Z
y
Z
Z
Z
Z
g
g
g
Z
Z
Z
Z
y
y
y
Z
y
Z
Z
e
"}
(24,1,1) = {"
e
g
Z
Z
a
d
Z
Z
Z
Z
Z
E
g
Z
Z
Z
Z
d
Z
y
y
p
q
m
S
n
W
Z
Z
X
y
Z
Z
g
g
E
g
Z
Z
Z
Z
d
h
y
Z
Z
L
d
a
e
"}
(25,1,1) = {"
e
g
v
Z
Z
Z
y
Z
g
g
Z
Z
g
Z
a
g
Z
Z
Z
Z
Z
Z
p
P
q
y
S
C
y
a
Z
b
g
g
g
Z
Z
Z
Z
Z
Z
Z
Z
Z
a
Z
y
Z
Z
e
"}
(26,1,1) = {"
e
Z
g
Z
Z
a
y
Z
g
Z
g
Z
T
g
g
Z
Z
Z
a
Z
Z
K
Z
S
q
B
S
t
Z
Z
Z
Z
g
Z
Z
g
Z
Z
Z
a
Z
y
Z
Z
Z
Z
y
y
Z
e
"}
(27,1,1) = {"
e
Z
Z
Z
Z
y
y
b
g
a
g
g
Z
g
g
w
Z
B
Z
Z
Z
y
Z
p
k
n
t
Z
Z
Z
Z
g
w
g
g
Z
Z
Z
Z
y
Z
Z
Z
Z
Z
Z
Z
y
Z
e
"}
(28,1,1) = {"
e
Z
Z
B
y
Z
y
Z
g
g
Z
g
Z
g
g
w
Z
Z
Z
b
Z
y
K
a
Z
Z
Z
g
Z
g
g
w
g
Z
Z
Z
Z
Z
Z
Z
Z
Z
Z
a
Z
Z
Z
Z
Z
e
"}
(29,1,1) = {"
e
Z
Z
y
Z
y
Z
Z
g
g
Z
Z
Z
g
g
g
g
Z
Z
Z
Z
Z
Z
Z
Z
Z
w
g
Z
Z
Z
a
Z
Z
Z
Z
Z
i
y
Z
Z
Z
Z
Z
Z
g
g
Z
Z
e
"}
(30,1,1) = {"
e
Z
Z
y
K
o
Z
a
g
g
Z
d
D
g
Z
w
Z
E
Z
Z
a
Z
Z
d
Z
Z
g
b
Z
d
Z
Z
Z
Z
Z
o
y
y
Z
Z
B
d
Z
Z
g
Z
Z
u
Z
e
"}
(31,1,1) = {"
e
Z
Z
a
Z
y
Z
Z
g
g
g
Z
w
g
g
g
g
g
Z
a
Z
Z
Z
Z
Z
g
Z
Z
Z
Z
Z
B
y
y
y
i
y
y
Z
Z
Z
g
g
g
g
Z
Z
y
Z
e
"}
(32,1,1) = {"
e
Z
Z
y
y
y
Z
Z
Z
B
g
g
g
g
g
g
g
Z
g
g
Z
Z
Z
g
B
g
Z
Z
Z
Z
y
i
y
Z
y
Z
Z
Z
Z
g
g
Z
B
g
D
Z
y
y
Z
e
"}
(33,1,1) = {"
e
Z
Z
y
y
K
Z
Z
g
Z
Z
Z
T
g
g
w
Z
g
g
g
Z
Z
Z
g
Z
g
Z
Z
Z
Z
Z
Z
Z
Z
y
Z
Z
Z
g
Z
Z
Z
g
g
g
Z
y
Z
Z
e
"}
(34,1,1) = {"
e
Z
B
y
y
y
Z
U
g
Z
Z
Z
Z
Z
g
g
g
Z
g
g
Z
g
g
Z
g
Z
g
Z
Z
Z
Z
Z
Z
y
Z
Z
b
g
Z
w
g
g
g
g
g
Z
Z
Z
Z
e
"}
(35,1,1) = {"
e
Z
Z
y
y
Z
Z
Z
Z
a
Z
Z
a
a
s
Z
g
g
Z
Z
T
g
Z
g
U
g
g
Z
w
g
g
Z
y
y
Z
Z
g
g
g
w
w
g
Z
g
w
a
g
g
Z
e
"}
(36,1,1) = {"
e
Z
Z
Z
Z
d
Z
Z
Z
y
Z
d
Z
a
Z
g
g
I
Z
Z
Z
g
Z
d
g
g
g
g
a
d
Z
Z
y
Z
a
d
s
Z
g
Z
Z
E
g
g
g
g
g
d
g
e
"}
(37,1,1) = {"
e
Z
Z
Z
Z
a
g
Z
Z
Z
y
y
y
Z
Z
Z
Z
g
g
Z
Z
g
g
g
g
g
g
Z
g
g
Z
Z
y
Z
Z
Z
g
g
Z
a
Z
g
g
g
g
g
Z
g
g
e
"}
(38,1,1) = {"
e
Z
Z
Z
Z
g
D
Z
Z
i
i
Z
U
y
Z
Z
Z
Z
a
Z
Z
Z
w
w
g
g
Z
g
Z
Z
Z
y
Z
Z
U
g
g
g
a
a
g
g
Z
g
g
A
Z
g
Z
e
"}
(39,1,1) = {"
e
g
Z
Z
Z
g
g
Z
Z
Z
y
y
y
K
Z
Z
Z
Z
Z
Z
T
g
g
Z
Z
Z
Z
Z
Z
Z
y
Z
Z
Z
Z
g
g
Z
a
g
g
Z
g
Z
g
y
Z
g
Z
e
"}
(40,1,1) = {"
e
g
Z
Z
g
g
Z
Z
a
Z
Z
Z
Z
Z
Z
g
Z
Z
Z
g
g
Z
Z
Z
Z
Z
B
Z
Z
K
y
Z
Z
a
g
g
Z
Z
g
g
g
g
Z
g
Z
Z
g
a
Z
e
"}
(41,1,1) = {"
e
Z
Z
g
g
g
Z
Z
Z
Z
Z
Z
Z
Z
Z
Z
Z
Z
Z
Z
Z
Z
Z
Z
Z
Z
Z
Z
y
y
Z
Z
Z
g
g
g
g
Z
Z
g
g
Z
Z
g
Z
g
Z
Z
Z
e
"}
(42,1,1) = {"
e
g
Z
g
g
E
g
g
Z
g
Z
E
Z
b
Z
Z
a
d
Z
Z
Z
Z
Z
d
a
Z
Z
y
y
d
Z
Z
Z
Z
Z
d
g
D
Z
Z
Z
d
g
g
D
Z
Z
d
Z
e
"}
(43,1,1) = {"
e
g
g
a
Z
Z
g
g
g
g
g
g
g
Z
Z
a
a
y
y
K
a
Z
Z
Z
a
Z
Z
h
Z
Z
Z
B
Z
Z
g
Z
Z
g
Z
B
B
Z
g
g
Z
Z
Z
K
Z
e
"}
(44,1,1) = {"
e
g
g
Z
Z
g
g
Z
a
a
Z
Z
Z
Z
Z
Z
Z
Z
y
Z
y
y
Z
Z
Z
Z
y
y
a
Z
Z
Z
Z
Z
g
g
g
w
Z
Z
Z
g
g
Z
Z
Z
Z
K
Z
e
"}
(45,1,1) = {"
e
g
g
g
Z
Z
Z
Z
y
Z
Z
Z
a
a
Z
Z
Z
Z
y
y
y
y
y
Z
Z
Z
y
Z
Z
g
g
g
g
g
g
g
g
w
Z
Z
Z
Z
Z
Z
Z
Z
y
y
Z
e
"}
(46,1,1) = {"
e
g
Z
g
g
g
Z
Z
y
y
h
y
Z
Z
y
y
y
y
y
h
y
a
a
y
y
y
Z
Z
Z
Z
g
g
g
g
g
g
g
Z
Z
Z
Z
Z
Z
Z
Z
Z
L
y
a
e
"}
(47,1,1) = {"
e
g
Z
Z
Z
g
g
Z
a
Z
Z
y
y
y
y
y
y
y
y
y
y
y
y
Z
Z
Z
B
Z
Z
Z
Z
b
Z
Z
Z
Z
Z
Z
Z
Z
y
K
K
K
y
y
y
Z
Z
e
"}
(48,1,1) = {"
e
g
s
g
g
E
Z
Z
Z
Z
Z
d
Z
Z
Z
Z
Z
u
Z
Z
Z
Z
Z
d
Z
Z
v
Z
Z
d
Z
Z
Z
Z
B
d
Z
Z
Z
Z
Z
d
Z
y
y
Z
Z
d
Z
e
"}
(49,1,1) = {"
e
g
g
Z
Z
Z
Z
Z
Z
Z
Z
B
Z
Z
Z
Z
Z
Z
Z
Z
Z
Z
Z
Z
Z
Z
Z
Z
Z
Z
Z
Z
Z
Z
Z
Z
Z
Z
Z
Z
Z
Z
Z
Z
Z
Z
Z
Z
Z
e
"}
(50,1,1) = {"
e
e
e
e
e
e
e
e
e
e
e
e
e
e
e
e
e
e
e
e
e
e
e
e
e
e
e
e
e
e
e
e
e
e
e
e
e
e
e
e
e
e
e
e
e
e
e
e
e
e
"}
