//MAP CONVERTED BY dmm2tgm.py THIS HEADER COMMENT PREVENTS RECONVERSION, DO NOT REMOVE
"ac" = (
/obj/structure/halflife/pipes/vent,
/turf/open/floor/plating/indoor/concrete/sewer,
/area/halflife/indoors/sewer/hidden)
"bD" = (
/obj/machinery/combine_distressterminal,
/turf/open/floor/plating/indoor/concrete/sewer,
/area/halflife/indoors/sewer/hidden)
"bF" = (
/obj/structure/halflife/trash/wood{
	dir = 1
	},
/turf/open/floor/plating/indoor/concrete/sewer,
/area/halflife/indoors/sewer/hidden)
"bS" = (
/obj/effect/landmark/deployments_refugee,
/obj/structure/chair/halflife/metal/folding,
/obj/structure/halflife/pipes/piped,
/turf/open/floor/plating/indoor/concrete/sewer,
/area/halflife/indoors/sewer/hidden)
"cU" = (
/obj/structure/closet/halflife{
	anchored = 1
	},
/turf/open/floor/plating/indoor/concrete/sewer,
/area/halflife/indoors/sewer/hidden)
"eW" = (
/obj/structure/lattice/catwalk/hl13,
/obj/structure/railing/halflife/sewer{
	dir = 8
	},
/turf/open/halflife/water/sewer/shallow{
	slowdown = 0.5
	},
/area/halflife/indoors/sewer/hidden)
"hF" = (
/obj/structure/halflife/pipes/horizontal/random,
/turf/open/floor/plating/indoor/metal/pipe,
/area/halflife/indoors/sewer/hidden)
"hI" = (
/obj/machinery/telecomms/broadcaster/preset_left/birdstation,
/turf/open/floor/plating/ground/sidewalk,
/area/halflife/indoors/sewer/hidden)
"iI" = (
/obj/structure/halflife/pipes/horizontal/down,
/turf/open/floor/plating/indoor/concrete/sewer,
/area/halflife/indoors/sewer/hidden)
"jg" = (
/obj/structure/halflife/trash/garbage,
/turf/open/floor/plating/indoor/concrete/sewer,
/area/halflife/indoors/sewer/hidden)
"lb" = (
/obj/structure/halflife/barrel/single/red,
/turf/open/floor/plating/indoor/concrete/sewer,
/area/halflife/indoors/sewer/hidden)
"mk" = (
/obj/structure/halflife/trash/cardboard,
/turf/open/floor/plating/indoor/concrete/sewer,
/area/halflife/indoors/sewer/hidden)
"mv" = (
/obj/structure/halflife/pipes/horizontal/random_alt,
/turf/open/floor/plating/indoor/metal/pipe,
/area/halflife/indoors/sewer/hidden)
"mA" = (
/obj/structure/halflife/pipes/horizontal,
/turf/open/floor/plating/indoor/concrete/sewer,
/area/halflife/indoors/sewer/hidden)
"mX" = (
/obj/effect/landmark/deployments_metrocop,
/obj/structure/chair/halflife/metal/folding{
	dir = 4
	},
/turf/open/floor/plating/indoor/concrete/sewer,
/area/halflife/indoors/sewer/hidden)
"na" = (
/obj/structure/railing/halflife/sewer{
	dir = 8
	},
/turf/open/floor/plating/indoor/metal/pipe,
/area/halflife/indoors/sewer/hidden)
"nF" = (
/obj/structure/halflife/pipes/horizontal/box,
/turf/open/floor/plating/indoor/metal/pipe,
/area/halflife/indoors/sewer/hidden)
"od" = (
/obj/structure/railing/halflife/sewer,
/turf/open/floor/plating/indoor/metal/grate/border/warning{
	dir = 1
	},
/area/halflife/indoors/sewer/hidden)
"oe" = (
/obj/structure/halflife/trash/garbage,
/obj/effect/spawner/random/halflife/loot/trash,
/turf/open/floor/plating/indoor/concrete/sewer,
/area/halflife/indoors/sewer/hidden)
"oy" = (
/obj/structure/halflife/pipes/horizontal/random,
/turf/open/floor/plating/indoor/concrete/sewer,
/area/halflife/indoors/sewer/hidden)
"oI" = (
/obj/structure/halflife/pallet,
/turf/open/floor/plating/indoor/concrete/sewer,
/area/halflife/indoors/sewer/hidden)
"pN" = (
/obj/machinery/door/unpowered/halflife/seethrough/grate{
	dir = 4
	},
/turf/open/floor/plating/indoor/concrete/sewer,
/area/halflife/indoors/sewer/hidden)
"pT" = (
/turf/closed/indestructible/rock,
/area/halflife/indoors/sewer/hidden)
"qE" = (
/obj/machinery/telecomms/processor/preset_one/birdstation,
/turf/open/floor/plating/ground/sidewalk,
/area/halflife/indoors/sewer/hidden)
"qZ" = (
/obj/structure/lattice/catwalk/hl13,
/turf/open/halflife/water/sewer/shallow{
	slowdown = 0.5
	},
/area/halflife/indoors/sewer/hidden)
"rv" = (
/turf/open/floor/plating/indoor/metal/pipe{
	dir = 1
	},
/area/halflife/indoors/sewer/hidden)
"sE" = (
/obj/structure/table/halflife/metal/grate,
/obj/structure/halflife/trash/cardboard{
	dir = 8;
	pixel_y = 7;
	pixel_x = 5
	},
/turf/open/floor/plating/indoor/concrete/sewer,
/area/halflife/indoors/sewer/hidden)
"sK" = (
/obj/machinery/telecomms/hub/preset,
/turf/open/floor/plating/ground/sidewalk,
/area/halflife/indoors/sewer/hidden)
"sO" = (
/obj/structure/halflife/barrel/triple/grey,
/turf/open/floor/plating/indoor/concrete/sewer,
/area/halflife/indoors/sewer/hidden)
"tj" = (
/obj/structure/halflife/pipes/horizontal/valve,
/turf/open/floor/plating/indoor/concrete/sewer,
/area/halflife/indoors/sewer/hidden)
"tv" = (
/turf/open/floor/plating/indoor/metal/pipe,
/area/halflife/indoors/sewer/hidden)
"tV" = (
/obj/structure/halflife/road_barrier/concrete/alt{
	dir = 8
	},
/turf/open/floor/plating/indoor/concrete/sewer,
/area/halflife/indoors/sewer/hidden)
"vo" = (
/obj/structure/halflife/pipes/horizontal/brown,
/turf/open/floor/plating/indoor/concrete/sewer,
/area/halflife/indoors/sewer/hidden)
"vu" = (
/obj/structure/table/halflife/metal/grate,
/obj/structure/halflife/pipes/horizontal/end{
	dir = 1
	},
/turf/open/floor/plating/indoor/concrete/sewer,
/area/halflife/indoors/sewer/hidden)
"vZ" = (
/obj/structure/halflife/trash/papers/three{
	dir = 8;
	pixel_x = 0;
	pixel_y = 4
	},
/turf/open/floor/plating/indoor/concrete/sewer,
/area/halflife/indoors/sewer/hidden)
"wJ" = (
/obj/structure/halflife/pipes/piped,
/turf/open/floor/plating/indoor/metal/pipe,
/area/halflife/indoors/sewer/hidden)
"yc" = (
/turf/open/floor/plating/indoor/concrete/sewer,
/area/halflife/indoors/sewer/hidden)
"yk" = (
/obj/effect/landmark/deployments_metrocop,
/obj/structure/chair/halflife/metal/folding{
	dir = 1
	},
/turf/open/floor/plating/indoor/concrete/sewer,
/area/halflife/indoors/sewer/hidden)
"zi" = (
/obj/structure/lattice/catwalk/hl13,
/obj/structure/railing/halflife/sewer,
/obj/structure/railing/halflife/sewer{
	dir = 1
	},
/turf/open/halflife/water/sewer/shallow{
	slowdown = 0.5
	},
/area/halflife/indoors/sewer/hidden)
"zV" = (
/obj/structure/table/halflife/metal/grate,
/obj/structure/halflife/trash/cardboard{
	dir = 4;
	pixel_y = 9
	},
/turf/open/floor/plating/indoor/concrete/sewer,
/area/halflife/indoors/sewer/hidden)
"Cr" = (
/obj/structure/halflife/pipes/horizontal/end,
/turf/open/floor/plating/indoor/metal/pipe,
/area/halflife/indoors/sewer/hidden)
"Cz" = (
/obj/structure/halflife/barrel/single/grey{
	pixel_x = 0;
	pixel_y = 5
	},
/turf/open/floor/plating/indoor/concrete/sewer,
/area/halflife/indoors/sewer/hidden)
"Fv" = (
/turf/open/floor/plating/indoor/metal/pipe/corner{
	dir = 1
	},
/area/halflife/indoors/sewer/hidden)
"FV" = (
/obj/machinery/light/small/directional/east,
/turf/open/floor/plating/indoor/concrete/sewer,
/area/halflife/indoors/sewer/hidden)
"Io" = (
/obj/effect/landmark/deployments_refugee,
/obj/structure/chair/halflife/metal/folding,
/turf/open/floor/plating/indoor/concrete/sewer,
/area/halflife/indoors/sewer/hidden)
"IS" = (
/obj/structure/table/halflife/metal/grate,
/turf/open/floor/plating/indoor/concrete/sewer,
/area/halflife/indoors/sewer/hidden)
"Jl" = (
/obj/structure/halflife/pallet/stack,
/turf/open/floor/plating/indoor/concrete/sewer,
/area/halflife/indoors/sewer/hidden)
"KW" = (
/obj/machinery/telecomms/bus/preset_one/birdstation,
/turf/open/floor/plating/ground/sidewalk,
/area/halflife/indoors/sewer/hidden)
"LA" = (
/obj/machinery/door/unpowered/halflife/seethrough/grate{
	dir = 1
	},
/turf/open/floor/plating/indoor/concrete/sewer,
/area/halflife/indoors/sewer/hidden)
"MI" = (
/obj/structure/halflife/pipes/horizontal/turnaround,
/turf/open/floor/plating/indoor/metal/pipe,
/area/halflife/indoors/sewer/hidden)
"MJ" = (
/obj/structure/halflife/pipes/horizontal,
/turf/open/floor/plating/indoor/metal/pipe,
/area/halflife/indoors/sewer/hidden)
"No" = (
/turf/open/floor/plating/indoor/metal/grate/border/warning,
/area/halflife/indoors/sewer/hidden)
"Ns" = (
/obj/structure/lattice/catwalk/hl13,
/obj/structure/railing/halflife/sewer{
	dir = 4
	},
/obj/structure/railing/halflife/sewer{
	dir = 8
	},
/turf/open/halflife/water/sewer/shallow{
	slowdown = 0.5
	},
/area/halflife/indoors/sewer/hidden)
"OP" = (
/obj/machinery/door/unpowered/halflife/seethrough/grate,
/turf/open/floor/plating/indoor/concrete/sewer,
/area/halflife/indoors/sewer/hidden)
"Pc" = (
/obj/effect/landmark/deployments_refugee,
/obj/structure/chair/halflife/metal/folding{
	dir = 4
	},
/turf/open/floor/plating/indoor/concrete/sewer,
/area/halflife/indoors/sewer/hidden)
"PK" = (
/obj/machinery/telecomms/receiver/preset_left/birdstation,
/turf/open/floor/plating/ground/sidewalk,
/area/halflife/indoors/sewer/hidden)
"PO" = (
/obj/structure/halflife/trash/papers/three,
/turf/open/floor/plating/indoor/concrete/sewer,
/area/halflife/indoors/sewer/hidden)
"Qd" = (
/obj/structure/halflife/barrel/double/grey,
/turf/open/floor/plating/indoor/concrete/sewer,
/area/halflife/indoors/sewer/hidden)
"Qn" = (
/obj/structure/halflife/pipes/horizontal/end,
/turf/open/floor/plating/indoor/concrete/sewer,
/area/halflife/indoors/sewer/hidden)
"QP" = (
/obj/structure/railing/halflife/sewer{
	dir = 4
	},
/obj/structure/railing/halflife/sewer{
	dir = 8
	},
/obj/structure/lattice/catwalk/hl13,
/turf/open/halflife/water/sewer/shallow{
	slowdown = 0.5
	},
/area/halflife/indoors/sewer/hidden)
"RI" = (
/obj/machinery/telecomms/server/presets/common/birdstation,
/turf/open/floor/plating/ground/sidewalk,
/area/halflife/indoors/sewer/hidden)
"RO" = (
/obj/structure/halflife/pipes/piped,
/turf/open/floor/plating/indoor/concrete/sewer,
/area/halflife/indoors/sewer/hidden)
"RR" = (
/obj/structure/railing/halflife/sewer{
	dir = 1
	},
/turf/open/floor/plating/indoor/metal/grate/border/warning{
	dir = 1
	},
/area/halflife/indoors/sewer/hidden)
"So" = (
/obj/machinery/combine_distressterminal,
/obj/structure/halflife/pipes/horizontal,
/turf/open/floor/plating/indoor/concrete/sewer,
/area/halflife/indoors/sewer/hidden)
"SH" = (
/obj/structure/halflife/pipes/horizontal/end{
	dir = 1
	},
/turf/open/floor/plating/indoor/metal/pipe,
/area/halflife/indoors/sewer/hidden)
"Td" = (
/turf/open/floor/plating/ground/sidewalk,
/area/halflife/indoors/sewer/hidden)
"Tt" = (
/obj/machinery/light/small/directional/south,
/turf/open/floor/plating/indoor/concrete/sewer,
/area/halflife/indoors/sewer/hidden)
"Us" = (
/obj/structure/railing/halflife/sewer{
	dir = 4
	},
/turf/open/floor/plating/indoor/metal/pipe,
/area/halflife/indoors/sewer/hidden)
"UK" = (
/turf/open/halflife/water/sewer/shallow{
	slowdown = 0.5
	},
/area/halflife/indoors/sewer/hidden)
"UX" = (
/turf/open/floor/plating/indoor/metal/grate/border/warning{
	dir = 1
	},
/area/halflife/indoors/sewer/hidden)
"Ve" = (
/obj/effect/landmark/deployments_refugee,
/obj/structure/chair/halflife/metal/folding,
/obj/machinery/light/small/directional/north,
/turf/open/floor/plating/indoor/concrete/sewer,
/area/halflife/indoors/sewer/hidden)
"Wh" = (
/obj/structure/lattice/catwalk/hl13,
/obj/structure/railing/halflife/sewer{
	dir = 4
	},
/turf/open/halflife/water/sewer/shallow{
	slowdown = 0.5
	},
/area/halflife/indoors/sewer/hidden)
"XA" = (
/turf/closed/wall/halflife/sewer,
/area/halflife/indoors/sewer/hidden)
"XE" = (
/obj/structure/halflife/pipes/vent,
/turf/open/floor/plating/indoor/metal/pipe,
/area/halflife/indoors/sewer/hidden)
"Yt" = (
/obj/structure/halflife/trash/garbage,
/obj/structure/halflife/pipes/horizontal,
/turf/open/floor/plating/indoor/concrete/sewer,
/area/halflife/indoors/sewer/hidden)
"ZU" = (
/obj/structure/halflife/trash/cardboard,
/obj/structure/halflife/pipes/horizontal/end,
/turf/open/floor/plating/indoor/concrete/sewer,
/area/halflife/indoors/sewer/hidden)

(1,1,1) = {"
pT
pT
pT
pT
pT
pT
pT
pT
pT
pT
pT
pT
pT
pT
pT
pT
pT
pT
pT
pT
pT
pT
pT
pT
pT
pT
pT
pT
pT
pT
pT
pT
pT
pT
pT
pT
pT
pT
pT
pT
pT
pT
pT
pT
pT
pT
pT
pT
pT
pT
pT
pT
pT
pT
pT
pT
pT
pT
pT
pT
pT
pT
pT
pT
pT
pT
pT
pT
pT
pT
pT
pT
pT
pT
pT
"}
(2,1,1) = {"
pT
pT
pT
pT
pT
pT
pT
pT
pT
pT
pT
pT
pT
pT
pT
pT
pT
pT
pT
pT
pT
pT
pT
pT
pT
pT
pT
pT
pT
pT
pT
pT
pT
pT
pT
pT
pT
pT
pT
pT
pT
pT
pT
pT
pT
pT
pT
pT
pT
pT
pT
pT
pT
pT
pT
pT
pT
pT
pT
pT
pT
pT
pT
pT
pT
pT
pT
pT
pT
pT
pT
pT
pT
pT
pT
"}
(3,1,1) = {"
pT
pT
pT
pT
pT
pT
pT
pT
pT
pT
pT
pT
pT
pT
pT
pT
pT
pT
pT
pT
pT
pT
pT
pT
pT
pT
pT
pT
pT
pT
pT
pT
pT
pT
pT
pT
pT
pT
pT
pT
pT
pT
pT
pT
pT
pT
pT
pT
pT
pT
pT
pT
pT
pT
pT
pT
pT
pT
pT
pT
pT
pT
pT
pT
pT
pT
pT
pT
pT
pT
pT
pT
pT
pT
pT
"}
(4,1,1) = {"
pT
pT
pT
pT
pT
pT
pT
pT
pT
pT
pT
pT
pT
pT
pT
pT
pT
pT
pT
pT
pT
pT
pT
pT
pT
pT
pT
pT
pT
pT
pT
pT
pT
pT
pT
pT
pT
pT
pT
pT
pT
pT
pT
pT
pT
pT
pT
pT
pT
pT
pT
pT
pT
pT
pT
pT
pT
pT
pT
pT
pT
pT
pT
pT
pT
pT
pT
pT
pT
pT
pT
pT
pT
pT
pT
"}
(5,1,1) = {"
pT
pT
pT
pT
pT
pT
pT
pT
pT
pT
pT
pT
pT
pT
pT
pT
pT
pT
pT
pT
pT
pT
pT
pT
pT
pT
pT
pT
pT
pT
pT
pT
pT
pT
pT
pT
pT
pT
pT
pT
pT
pT
pT
pT
pT
pT
pT
pT
pT
pT
pT
pT
pT
pT
pT
pT
pT
pT
pT
pT
pT
pT
pT
pT
pT
pT
pT
pT
pT
pT
pT
pT
pT
pT
pT
"}
(6,1,1) = {"
pT
pT
pT
pT
pT
pT
pT
pT
pT
pT
pT
pT
pT
pT
pT
pT
pT
pT
pT
pT
pT
pT
pT
pT
pT
pT
pT
pT
pT
pT
pT
pT
pT
pT
pT
pT
pT
pT
pT
pT
pT
pT
pT
pT
pT
pT
pT
pT
pT
pT
pT
pT
pT
pT
pT
pT
pT
pT
pT
pT
pT
pT
pT
XA
XA
XA
XA
XA
XA
XA
pT
pT
pT
pT
pT
"}
(7,1,1) = {"
pT
pT
pT
pT
pT
pT
pT
pT
pT
pT
pT
pT
pT
pT
pT
pT
pT
pT
pT
pT
pT
pT
pT
pT
pT
pT
pT
pT
pT
pT
pT
pT
pT
pT
pT
pT
pT
pT
pT
pT
pT
pT
pT
pT
pT
pT
pT
pT
pT
XA
XA
XA
XA
XA
XA
XA
XA
XA
XA
XA
XA
XA
XA
XA
Pc
Pc
yc
mX
mX
XA
pT
pT
pT
pT
pT
"}
(8,1,1) = {"
pT
pT
pT
pT
pT
pT
pT
pT
pT
pT
pT
pT
pT
pT
pT
pT
pT
pT
pT
pT
pT
pT
pT
pT
pT
pT
pT
pT
pT
pT
pT
pT
pT
pT
pT
pT
pT
pT
pT
pT
pT
pT
pT
pT
pT
pT
pT
pT
pT
XA
yc
yc
yc
yc
yc
yc
yc
yc
yc
yc
yc
yc
yc
OP
yc
yc
yc
yc
Tt
XA
pT
pT
pT
pT
pT
"}
(9,1,1) = {"
pT
pT
pT
pT
pT
pT
pT
pT
pT
pT
pT
pT
pT
pT
pT
pT
pT
pT
pT
pT
pT
pT
pT
pT
pT
pT
pT
pT
pT
pT
pT
pT
pT
pT
pT
pT
pT
pT
pT
pT
pT
pT
pT
pT
pT
pT
pT
pT
pT
XA
yc
UK
UK
zi
UK
UK
UK
UK
UK
zi
UK
UK
yc
LA
yc
yc
yc
yc
yc
XA
pT
pT
pT
pT
pT
"}
(10,1,1) = {"
pT
pT
pT
pT
pT
pT
pT
pT
pT
pT
pT
pT
pT
pT
pT
pT
pT
pT
pT
pT
pT
pT
pT
pT
pT
pT
pT
pT
pT
pT
pT
pT
pT
pT
pT
pT
pT
pT
pT
pT
pT
pT
pT
pT
pT
pT
pT
pT
pT
XA
yc
UK
UK
zi
UK
UK
UK
UK
UK
zi
UK
UK
yc
XA
bS
yc
yc
yc
yk
XA
pT
pT
pT
pT
pT
"}
(11,1,1) = {"
pT
pT
pT
pT
pT
pT
pT
pT
pT
pT
pT
pT
pT
pT
pT
pT
pT
pT
pT
pT
pT
pT
pT
pT
pT
pT
pT
pT
pT
pT
pT
pT
pT
pT
pT
pT
pT
pT
pT
pT
pT
pT
pT
pT
pT
pT
pT
pT
pT
XA
yc
QP
Ns
yc
yc
yc
yc
yc
yc
yc
QP
Ns
yc
XA
Ve
yc
yc
yc
yk
XA
pT
pT
pT
pT
pT
"}
(12,1,1) = {"
pT
pT
pT
pT
pT
pT
pT
pT
pT
pT
pT
pT
pT
pT
pT
pT
pT
pT
pT
pT
pT
pT
pT
pT
pT
pT
pT
pT
pT
pT
pT
pT
pT
pT
pT
pT
pT
pT
pT
pT
pT
pT
pT
pT
pT
pT
pT
pT
pT
XA
ac
UK
UK
yc
XA
XA
XA
XA
XA
yc
UK
UK
yc
XA
Io
yc
yc
yc
yk
XA
pT
pT
pT
pT
pT
"}
(13,1,1) = {"
pT
pT
pT
pT
pT
pT
pT
pT
pT
pT
pT
pT
pT
pT
pT
pT
pT
pT
pT
pT
pT
pT
pT
pT
pT
pT
pT
pT
pT
pT
pT
pT
pT
XA
XA
XA
XA
XA
XA
XA
XA
XA
XA
XA
XA
XA
XA
XA
XA
XA
yc
UK
UK
yc
XA
pT
pT
pT
XA
yc
UK
UK
yc
XA
Io
yc
yc
yc
yk
XA
pT
pT
pT
pT
pT
"}
(14,1,1) = {"
pT
pT
pT
pT
pT
pT
pT
pT
pT
pT
pT
pT
pT
pT
pT
pT
pT
pT
pT
pT
pT
pT
pT
pT
pT
pT
pT
pT
pT
pT
pT
pT
pT
XA
yc
yc
yc
yc
yc
yc
yc
yc
yc
yc
yc
yc
yc
yc
yc
yc
yc
QP
Ns
yc
XA
pT
pT
pT
XA
yc
UK
UK
yc
XA
Io
yc
yc
FV
yk
XA
pT
pT
pT
pT
pT
"}
(15,1,1) = {"
pT
pT
pT
pT
pT
pT
pT
pT
pT
pT
pT
pT
pT
pT
pT
pT
pT
pT
pT
pT
pT
pT
pT
pT
pT
pT
pT
pT
pT
pT
pT
pT
pT
XA
yc
UK
UK
zi
UK
UK
UK
UK
UK
UK
UK
UK
UK
UK
UK
UK
zi
UK
UK
yc
XA
pT
pT
pT
XA
yc
UK
UK
yc
XA
XA
XA
pN
XA
XA
XA
pT
pT
pT
pT
pT
"}
(16,1,1) = {"
pT
pT
pT
pT
pT
pT
pT
pT
pT
pT
pT
pT
pT
pT
pT
pT
pT
pT
pT
pT
pT
pT
pT
pT
XA
XA
XA
XA
XA
XA
XA
XA
XA
XA
yc
UK
UK
zi
UK
UK
UK
UK
UK
UK
UK
UK
UK
UK
UK
UK
zi
UK
UK
yc
XA
pT
pT
pT
XA
yc
UK
UK
yc
XA
tv
yc
yc
yc
tv
XA
pT
pT
pT
pT
pT
"}
(17,1,1) = {"
pT
pT
pT
pT
pT
pT
pT
pT
pT
pT
pT
pT
pT
pT
pT
pT
pT
pT
pT
pT
pT
pT
pT
pT
XA
zV
IS
bD
yc
yc
IS
IS
cU
XA
yc
QP
Ns
yc
yc
yc
yc
yc
yc
yc
yc
yc
yc
yc
yc
yc
yc
yc
yc
yc
XA
pT
pT
pT
XA
yc
UK
UK
yc
XA
wJ
yc
yc
yc
tv
XA
pT
pT
pT
pT
pT
"}
(18,1,1) = {"
pT
pT
pT
pT
pT
pT
pT
pT
pT
pT
pT
pT
pT
pT
pT
pT
pT
pT
pT
pT
pT
pT
pT
pT
XA
yc
yc
yc
yc
yc
yc
yc
yc
XA
yc
UK
UK
yc
XA
XA
XA
XA
XA
XA
XA
XA
XA
XA
XA
XA
XA
XA
XA
XA
XA
pT
pT
pT
XA
yc
UK
UK
yc
XA
tv
yc
yc
yc
tv
XA
pT
pT
pT
pT
pT
"}
(19,1,1) = {"
pT
pT
pT
pT
pT
pT
pT
pT
pT
pT
pT
pT
pT
pT
pT
pT
pT
pT
pT
pT
pT
pT
pT
pT
XA
RO
yc
yc
yc
yc
yc
yc
yc
OP
yc
UK
UK
yc
XA
pT
pT
pT
pT
pT
pT
pT
pT
pT
pT
pT
pT
pT
pT
pT
pT
pT
pT
pT
XA
yc
UK
UK
yc
XA
tv
yc
yc
yc
tv
XA
pT
pT
pT
pT
pT
"}
(20,1,1) = {"
pT
pT
pT
pT
pT
pT
pT
pT
pT
pT
pT
pT
pT
pT
pT
pT
pT
pT
pT
pT
pT
pT
pT
pT
XA
lb
yc
yc
yc
yc
yc
yc
yc
XA
yc
UK
UK
yc
XA
pT
pT
pT
pT
pT
pT
pT
pT
pT
pT
pT
pT
pT
pT
pT
pT
pT
pT
pT
XA
yc
UK
UK
yc
XA
tv
yc
yc
yc
tv
XA
pT
pT
pT
pT
pT
"}
(21,1,1) = {"
pT
pT
pT
pT
pT
pT
pT
pT
pT
pT
pT
pT
pT
pT
pT
pT
pT
pT
pT
pT
pT
pT
pT
pT
XA
ac
yc
yc
yc
yc
yc
yc
jg
XA
yc
yc
yc
yc
XA
pT
pT
pT
pT
pT
pT
pT
pT
pT
pT
pT
pT
pT
pT
pT
pT
pT
pT
pT
XA
yc
UK
UK
yc
XA
Us
yc
yc
yc
tv
XA
pT
pT
pT
pT
pT
"}
(22,1,1) = {"
pT
pT
pT
pT
pT
pT
pT
pT
pT
pT
pT
pT
pT
pT
pT
pT
pT
pT
pT
pT
pT
pT
pT
pT
XA
yc
yc
yc
yc
yc
XA
XA
XA
XA
XA
yc
yc
XA
XA
XA
XA
XA
XA
XA
XA
XA
XA
XA
XA
XA
XA
XA
XA
XA
pT
pT
pT
pT
XA
yc
UK
UK
yc
OP
No
yc
yc
yc
tv
XA
pT
pT
pT
pT
pT
"}
(23,1,1) = {"
pT
pT
pT
pT
pT
pT
pT
pT
pT
pT
pT
pT
pT
pT
pT
pT
pT
XA
XA
XA
XA
XA
XA
XA
XA
XA
yc
yc
yc
XA
XA
rv
rv
rv
rv
RR
od
rv
rv
rv
rv
rv
rv
rv
rv
rv
rv
rv
rv
rv
rv
rv
rv
XA
XA
XA
XA
XA
XA
ac
UK
UK
yc
XA
na
yc
yc
yc
tv
XA
pT
pT
pT
pT
pT
"}
(24,1,1) = {"
pT
pT
pT
pT
pT
pT
pT
pT
pT
pT
pT
pT
pT
pT
pT
pT
pT
XA
yc
yc
yc
yc
yc
yc
yc
yc
yc
yc
yc
yc
yc
yc
yc
yc
yc
yc
yc
yc
yc
yc
yc
yc
yc
yc
yc
yc
yc
yc
yc
yc
yc
yc
yc
yc
yc
yc
yc
yc
yc
yc
QP
Ns
yc
XA
tv
yc
yc
yc
tv
XA
pT
pT
pT
pT
pT
"}
(25,1,1) = {"
pT
pT
pT
pT
pT
pT
pT
pT
pT
pT
pT
pT
pT
pT
pT
pT
pT
XA
mA
yc
UK
UK
UK
UK
UK
UK
zi
UK
UK
zi
UK
UK
UK
UK
UK
UK
UK
UK
UK
UK
UK
UK
UK
UK
UK
UK
UK
UK
UK
UK
UK
UK
UK
UK
UK
UK
UK
UK
UK
zi
UK
UK
yc
XA
XE
yc
yc
yc
tv
XA
pT
pT
pT
pT
pT
"}
(26,1,1) = {"
pT
pT
pT
pT
pT
pT
pT
pT
pT
pT
pT
pT
pT
pT
pT
pT
pT
XA
oy
yc
UK
UK
UK
UK
UK
UK
zi
UK
UK
zi
UK
UK
UK
UK
UK
UK
UK
UK
UK
UK
UK
UK
UK
UK
UK
UK
UK
UK
UK
UK
UK
UK
UK
UK
UK
UK
UK
UK
UK
zi
UK
UK
yc
XA
tv
yc
yc
yc
tv
XA
pT
pT
pT
pT
pT
"}
(27,1,1) = {"
pT
pT
pT
pT
pT
pT
pT
pT
pT
pT
pT
pT
pT
pT
pT
pT
pT
XA
mA
yc
QP
Ns
yc
yc
yc
yc
yc
QP
Ns
yc
yc
yc
yc
yc
yc
yc
yc
yc
yc
yc
yc
yc
yc
yc
yc
yc
yc
yc
yc
yc
yc
yc
yc
yc
yc
UK
UK
yc
yc
yc
yc
yc
yc
XA
SH
yc
yc
yc
tv
XA
pT
pT
pT
pT
pT
"}
(28,1,1) = {"
pT
pT
pT
pT
pT
pT
pT
pT
pT
pT
pT
pT
pT
pT
pT
pT
pT
XA
mA
yc
UK
UK
yc
XA
XA
XA
yc
UK
UK
yc
XA
rv
rv
rv
rv
rv
rv
rv
rv
RR
UX
od
rv
rv
rv
rv
rv
rv
rv
rv
rv
rv
rv
XA
yc
UK
UK
yc
XA
XA
XA
XA
XA
XA
MJ
yc
yc
yc
tv
XA
pT
pT
pT
pT
pT
"}
(29,1,1) = {"
pT
pT
pT
pT
pT
pT
pT
pT
pT
pT
pT
pT
pT
pT
pT
pT
pT
XA
vo
yc
UK
UK
yc
tv
XA
tv
yc
UK
UK
yc
XA
XA
XA
XA
XA
XA
XA
XA
XA
yc
yc
yc
XA
XA
XA
XA
XA
XA
XA
XA
XA
XA
XA
XA
bF
UK
UK
yc
XA
pT
pT
pT
pT
XA
hF
yc
yc
yc
tv
XA
pT
pT
pT
pT
pT
"}
(30,1,1) = {"
pT
pT
pT
pT
pT
pT
pT
pT
pT
pT
pT
pT
pT
pT
pT
pT
pT
XA
mA
yc
UK
UK
yc
tv
XA
tv
yc
UK
UK
yc
XA
pT
pT
pT
pT
pT
pT
pT
XA
yc
yc
yc
XA
pT
pT
pT
pT
pT
pT
pT
pT
pT
pT
XA
yc
UK
UK
yc
XA
pT
pT
pT
pT
XA
MJ
tV
yc
tV
tv
XA
pT
pT
pT
pT
pT
"}
(31,1,1) = {"
pT
pT
pT
pT
pT
pT
pT
pT
pT
pT
pT
pT
pT
pT
pT
pT
pT
XA
iI
yc
UK
UK
yc
tv
XA
XE
yc
UK
UK
yc
XA
pT
pT
pT
pT
pT
pT
pT
XA
ac
yc
yc
XA
pT
pT
pT
pT
pT
pT
pT
pT
pT
pT
XA
yc
UK
UK
yc
XA
pT
pT
pT
pT
XA
mv
yc
yc
yc
tv
XA
pT
pT
pT
pT
pT
"}
(32,1,1) = {"
pT
pT
pT
pT
pT
pT
pT
pT
pT
pT
pT
pT
pT
pT
pT
pT
pT
XA
mA
yc
UK
UK
yc
tv
XA
tv
yc
UK
UK
yc
XA
pT
pT
pT
pT
pT
pT
pT
XA
yc
yc
yc
XA
pT
pT
pT
pT
pT
pT
pT
pT
pT
pT
XA
yc
UK
UK
yc
XA
pT
pT
pT
pT
XA
nF
yc
yc
yc
tv
XA
pT
pT
pT
pT
pT
"}
(33,1,1) = {"
pT
pT
pT
pT
pT
pT
pT
pT
pT
pT
pT
pT
pT
pT
pT
pT
pT
XA
Yt
yc
UK
UK
yc
tv
XA
tv
yc
UK
UK
yc
XA
pT
pT
pT
pT
pT
pT
pT
XA
yc
yc
yc
XA
pT
pT
pT
pT
pT
pT
pT
pT
pT
pT
XA
yc
UK
UK
yc
XA
pT
pT
pT
pT
XA
MJ
yc
yc
yc
tv
XA
pT
pT
pT
pT
pT
"}
(34,1,1) = {"
pT
pT
pT
pT
pT
pT
pT
pT
pT
pT
pT
pT
pT
pT
pT
pT
pT
XA
tj
yc
UK
UK
yc
tv
XA
tv
yc
UK
UK
yc
XA
pT
pT
pT
pT
XA
XA
XA
XA
yc
yc
yc
XA
XA
XA
XA
pT
pT
pT
pT
pT
pT
pT
XA
yc
UK
UK
yc
XA
pT
pT
pT
pT
XA
MJ
yc
yc
yc
tv
XA
pT
pT
pT
pT
pT
"}
(35,1,1) = {"
pT
pT
pT
pT
pT
pT
pT
pT
pT
pT
pT
pT
pT
pT
XA
XA
XA
XA
mA
yc
UK
UK
yc
tv
XA
tv
yc
UK
UK
yc
XA
pT
pT
pT
pT
XA
oe
yc
yc
yc
yc
yc
yc
yc
yc
XA
pT
pT
pT
pT
pT
pT
pT
XA
yc
UK
UK
yc
XA
pT
pT
pT
pT
XA
MI
yc
yc
yc
tv
XA
pT
pT
pT
pT
pT
"}
(36,1,1) = {"
pT
pT
pT
pT
pT
pT
pT
pT
pT
pT
pT
pT
pT
pT
XA
tv
yc
XA
Qn
yc
UK
UK
yc
tv
XA
tv
yc
UK
UK
yc
XA
pT
pT
pT
pT
XA
yc
yc
yc
yc
yc
yc
yc
yc
Qd
XA
pT
pT
pT
pT
pT
pT
pT
XA
yc
UK
UK
yc
XA
pT
pT
pT
pT
XA
MJ
yc
yc
yc
tv
XA
pT
pT
pT
pT
pT
"}
(37,1,1) = {"
pT
pT
pT
pT
pT
pT
pT
pT
pT
pT
pT
pT
pT
pT
XA
tv
yc
yc
yc
yc
eW
eW
yc
No
yc
No
yc
UK
UK
yc
XA
pT
pT
pT
pT
XA
yc
yc
yc
yc
yc
yc
yc
yc
yc
XA
pT
pT
pT
pT
pT
pT
pT
XA
yc
UK
UK
yc
XA
XA
XA
XA
XA
XA
Cr
yc
yc
yc
tv
XA
pT
pT
pT
pT
pT
"}
(38,1,1) = {"
pT
pT
pT
pT
pT
pT
pT
pT
pT
pT
pT
pT
pT
pT
XA
wJ
yc
yc
yc
yc
qZ
qZ
yc
No
yc
No
yc
UK
UK
yc
XA
pT
pT
pT
XA
XA
yc
yc
yc
XA
XA
XA
PO
yc
yc
XA
XA
pT
pT
pT
pT
pT
pT
XA
yc
UK
UK
yc
XA
rv
rv
rv
rv
rv
Fv
yc
yc
yc
tv
XA
pT
pT
pT
pT
pT
"}
(39,1,1) = {"
pT
pT
pT
pT
pT
pT
pT
pT
pT
pT
pT
pT
pT
pT
XA
tv
yc
yc
yc
yc
Wh
Wh
yc
No
yc
No
yc
UK
UK
yc
XA
pT
pT
pT
XA
yc
yc
yc
yc
IS
XA
bD
yc
yc
yc
yc
XA
pT
pT
pT
pT
pT
pT
XA
yc
UK
UK
yc
yc
yc
yc
yc
yc
yc
yc
yc
yc
yc
tv
XA
pT
pT
pT
pT
pT
"}
(40,1,1) = {"
pT
pT
pT
pT
pT
pT
pT
pT
pT
pT
pT
pT
pT
pT
XA
tv
mk
XA
yc
yc
UK
UK
yc
tv
XA
tv
yc
UK
UK
yc
XA
pT
pT
pT
XA
yc
yc
yc
vZ
bD
XA
IS
yc
yc
yc
yc
XA
pT
pT
pT
pT
pT
pT
XA
yc
UK
UK
yc
yc
yc
yc
yc
yc
yc
yc
yc
yc
yc
tv
XA
pT
pT
pT
pT
pT
"}
(41,1,1) = {"
pT
pT
pT
pT
pT
pT
pT
pT
pT
pT
pT
pT
pT
pT
XA
XA
XA
XA
yc
yc
UK
UK
yc
tv
XA
tv
yc
UK
UK
yc
XA
pT
pT
pT
XA
XA
yc
yc
yc
XA
XA
XA
yc
yc
yc
XA
XA
pT
pT
pT
pT
pT
pT
XA
yc
UK
UK
yc
yc
yc
yc
yc
yc
yc
yc
yc
yc
yc
tv
XA
pT
pT
pT
pT
pT
"}
(42,1,1) = {"
pT
pT
pT
pT
pT
pT
pT
pT
pT
pT
pT
pT
pT
pT
pT
pT
pT
XA
yc
yc
UK
UK
yc
tv
XA
tv
yc
UK
UK
yc
XA
pT
pT
pT
pT
XA
yc
yc
yc
yc
yc
yc
yc
yc
yc
XA
pT
pT
pT
pT
pT
pT
pT
XA
yc
UK
UK
yc
XA
rv
rv
rv
rv
rv
rv
UX
UX
UX
Fv
XA
pT
pT
pT
pT
pT
"}
(43,1,1) = {"
pT
pT
pT
pT
pT
pT
pT
pT
pT
pT
pT
pT
pT
pT
pT
pT
pT
XA
yc
Cz
UK
UK
yc
tv
XA
tv
yc
UK
UK
yc
XA
pT
pT
pT
pT
XA
Jl
yc
yc
yc
yc
yc
yc
yc
yc
XA
pT
pT
pT
pT
pT
pT
pT
XA
ac
UK
UK
yc
XA
XA
XA
XA
XA
XA
XA
yc
yc
yc
XA
XA
pT
pT
pT
pT
pT
"}
(44,1,1) = {"
pT
pT
pT
pT
pT
pT
pT
pT
pT
pT
pT
pT
pT
pT
pT
pT
pT
XA
yc
yc
UK
UK
yc
tv
XA
XE
yc
UK
UK
yc
XA
pT
pT
pT
pT
XA
yc
yc
yc
yc
yc
yc
yc
yc
yc
XA
pT
pT
pT
pT
pT
pT
pT
XA
yc
UK
UK
yc
XA
pT
pT
XA
vu
yc
yc
yc
yc
yc
XA
pT
pT
pT
pT
pT
pT
"}
(45,1,1) = {"
pT
pT
pT
pT
pT
pT
pT
pT
pT
pT
pT
pT
pT
pT
pT
pT
pT
XA
yc
yc
UK
UK
yc
tv
XA
tv
yc
UK
UK
yc
XA
pT
pT
pT
pT
XA
XA
XA
XA
yc
yc
yc
XA
XA
XA
XA
pT
pT
pT
pT
pT
pT
pT
XA
yc
UK
UK
yc
XA
pT
pT
XA
So
yc
yc
yc
yc
yc
XA
pT
pT
pT
pT
pT
pT
"}
(46,1,1) = {"
pT
pT
pT
pT
pT
pT
pT
pT
pT
pT
pT
pT
pT
pT
pT
pT
pT
XA
yc
yc
UK
UK
yc
tv
XA
tv
yc
UK
UK
yc
XA
pT
pT
pT
pT
pT
pT
pT
XA
yc
yc
yc
XA
pT
pT
pT
pT
pT
pT
pT
pT
pT
pT
XA
yc
UK
UK
yc
XA
pT
pT
XA
mA
yc
yc
yc
yc
sO
XA
pT
pT
pT
pT
pT
pT
"}
(47,1,1) = {"
pT
pT
pT
pT
pT
pT
pT
pT
pT
pT
pT
pT
pT
pT
pT
pT
pT
XA
yc
yc
UK
UK
yc
tv
XA
tv
yc
UK
UK
yc
XA
pT
pT
pT
pT
pT
pT
pT
XA
yc
yc
yc
XA
pT
pT
XA
XA
XA
XA
XA
XA
XA
XA
XA
yc
UK
UK
yc
XA
pT
pT
XA
ZU
yc
yc
yc
yc
yc
XA
pT
pT
pT
pT
pT
pT
"}
(48,1,1) = {"
pT
pT
pT
pT
pT
pT
pT
pT
pT
pT
pT
pT
pT
pT
pT
pT
pT
XA
yc
yc
UK
UK
yc
XA
XA
XA
yc
UK
UK
yc
XA
XA
XA
XA
XA
XA
pT
pT
XA
yc
yc
yc
XA
pT
pT
XA
yc
yc
yc
yc
yc
yc
yc
yc
yc
QP
Ns
yc
XA
XA
XA
XA
XA
ac
yc
yc
yc
oI
XA
pT
pT
pT
pT
pT
pT
"}
(49,1,1) = {"
pT
pT
pT
pT
pT
pT
pT
pT
pT
pT
pT
pT
pT
pT
pT
pT
pT
XA
yc
yc
QP
Ns
yc
yc
yc
yc
yc
QP
Ns
yc
yc
yc
yc
yc
yc
XA
pT
pT
XA
ac
yc
yc
XA
pT
pT
XA
yc
UK
UK
zi
UK
UK
UK
UK
zi
UK
UK
yc
XA
yc
yc
yc
yc
yc
yc
yc
yc
cU
XA
pT
pT
pT
pT
pT
pT
"}
(50,1,1) = {"
pT
pT
pT
pT
pT
pT
pT
pT
pT
pT
pT
pT
pT
pT
pT
pT
pT
XA
yc
yc
UK
UK
UK
UK
UK
UK
zi
UK
UK
zi
UK
UK
UK
UK
yc
XA
pT
pT
XA
yc
yc
yc
XA
pT
pT
XA
yc
UK
UK
zi
UK
UK
UK
UK
zi
UK
UK
yc
OP
yc
yc
yc
yc
yc
yc
yc
yc
yc
XA
pT
pT
pT
pT
pT
pT
"}
(51,1,1) = {"
pT
pT
pT
pT
pT
pT
pT
pT
pT
pT
pT
pT
pT
pT
pT
pT
pT
XA
yc
yc
UK
UK
UK
UK
UK
UK
zi
UK
UK
zi
UK
UK
UK
UK
yc
XA
pT
pT
XA
yc
yc
yc
XA
pT
pT
XA
yc
QP
Ns
yc
yc
yc
yc
yc
yc
yc
yc
yc
XA
yc
yc
yc
yc
yc
yc
yc
yc
oe
XA
pT
pT
pT
pT
pT
pT
"}
(52,1,1) = {"
pT
pT
pT
pT
pT
pT
pT
pT
pT
pT
pT
pT
pT
pT
pT
pT
pT
XA
yc
yc
yc
yc
yc
yc
yc
yc
yc
yc
yc
yc
yc
yc
UK
UK
yc
XA
pT
pT
XA
yc
yc
yc
XA
pT
pT
XA
yc
UK
UK
yc
XA
XA
XA
XA
XA
XA
XA
XA
XA
XA
XA
XA
XA
XA
XA
XA
XA
XA
XA
pT
pT
pT
pT
pT
pT
"}
(53,1,1) = {"
pT
pT
pT
pT
pT
pT
pT
pT
pT
pT
pT
pT
pT
pT
pT
pT
pT
XA
XA
XA
XA
XA
XA
XA
XA
XA
XA
pN
XA
XA
XA
yc
UK
UK
yc
XA
XA
XA
XA
yc
yc
yc
XA
XA
XA
XA
yc
UK
UK
yc
XA
pT
pT
pT
pT
pT
pT
pT
pT
pT
pT
pT
pT
pT
pT
pT
pT
pT
pT
pT
pT
pT
pT
pT
pT
"}
(54,1,1) = {"
pT
pT
pT
pT
pT
pT
pT
pT
pT
pT
pT
pT
pT
pT
pT
pT
pT
pT
pT
pT
pT
pT
pT
pT
XA
sE
yc
yc
yc
cU
XA
yc
UK
UK
yc
XA
rv
rv
rv
RR
UX
od
rv
rv
rv
XA
yc
UK
UK
yc
XA
pT
pT
pT
pT
pT
pT
pT
pT
pT
pT
pT
pT
pT
pT
pT
pT
pT
pT
pT
pT
pT
pT
pT
pT
"}
(55,1,1) = {"
pT
pT
pT
pT
pT
pT
pT
pT
pT
pT
pT
pT
pT
pT
pT
pT
pT
pT
pT
pT
pT
pT
pT
pT
XA
IS
yc
yc
yc
yc
XA
yc
QP
Ns
yc
yc
yc
yc
yc
yc
yc
yc
yc
yc
yc
yc
yc
QP
Ns
yc
XA
pT
pT
pT
pT
pT
pT
pT
pT
pT
pT
pT
pT
pT
pT
pT
pT
pT
pT
pT
pT
pT
pT
pT
pT
"}
(56,1,1) = {"
pT
pT
pT
pT
pT
pT
pT
pT
pT
pT
pT
pT
pT
pT
pT
pT
pT
pT
pT
pT
pT
pT
pT
pT
XA
IS
yc
yc
yc
yc
XA
yc
UK
UK
zi
UK
UK
UK
UK
UK
UK
UK
UK
UK
UK
UK
zi
UK
UK
yc
XA
pT
pT
pT
pT
pT
pT
pT
pT
pT
pT
pT
pT
pT
pT
pT
pT
pT
pT
pT
pT
pT
pT
pT
pT
"}
(57,1,1) = {"
pT
pT
pT
pT
pT
pT
pT
pT
pT
pT
pT
pT
pT
pT
pT
pT
pT
pT
pT
pT
pT
pT
pT
pT
XA
bD
yc
yc
yc
yc
OP
yc
UK
UK
zi
UK
UK
UK
UK
UK
UK
UK
UK
UK
UK
UK
zi
UK
UK
yc
XA
pT
pT
pT
pT
pT
pT
pT
pT
pT
pT
pT
pT
pT
pT
pT
pT
pT
pT
pT
pT
pT
pT
pT
pT
"}
(58,1,1) = {"
pT
pT
pT
pT
pT
pT
pT
pT
pT
pT
pT
pT
pT
pT
pT
pT
pT
pT
pT
pT
pT
pT
pT
pT
XA
ac
yc
yc
yc
yc
XA
yc
yc
yc
yc
yc
yc
yc
yc
yc
yc
yc
yc
yc
yc
yc
yc
yc
yc
yc
XA
pT
pT
pT
pT
pT
pT
pT
pT
pT
pT
pT
pT
pT
pT
pT
pT
pT
pT
pT
pT
pT
pT
pT
pT
"}
(59,1,1) = {"
pT
pT
pT
pT
pT
pT
pT
pT
pT
pT
pT
pT
pT
pT
pT
pT
pT
pT
pT
pT
pT
pT
pT
pT
XA
yc
yc
yc
IS
IS
XA
XA
XA
XA
XA
XA
XA
XA
XA
XA
XA
XA
XA
XA
XA
XA
XA
XA
XA
XA
XA
pT
pT
pT
pT
pT
pT
pT
pT
pT
pT
pT
pT
pT
pT
pT
pT
pT
pT
pT
pT
pT
pT
pT
pT
"}
(60,1,1) = {"
pT
pT
pT
pT
pT
pT
pT
pT
pT
pT
pT
pT
pT
pT
pT
pT
pT
pT
pT
pT
pT
pT
pT
pT
XA
XA
XA
XA
XA
XA
XA
pT
pT
pT
pT
pT
pT
pT
pT
pT
pT
pT
pT
pT
pT
pT
pT
pT
pT
pT
pT
pT
pT
pT
pT
pT
pT
pT
pT
pT
pT
pT
pT
pT
pT
pT
pT
pT
pT
pT
pT
pT
pT
pT
pT
"}
(61,1,1) = {"
pT
pT
pT
pT
pT
pT
pT
pT
pT
pT
pT
pT
pT
pT
pT
pT
pT
pT
pT
pT
pT
pT
pT
pT
pT
pT
pT
pT
pT
pT
pT
pT
pT
pT
pT
pT
pT
pT
pT
pT
pT
pT
pT
pT
pT
pT
pT
pT
pT
pT
pT
pT
pT
pT
pT
pT
pT
pT
pT
pT
pT
pT
pT
pT
pT
pT
pT
pT
pT
pT
pT
pT
pT
pT
pT
"}
(62,1,1) = {"
pT
pT
pT
pT
pT
pT
pT
pT
pT
pT
pT
pT
pT
pT
pT
pT
pT
pT
pT
pT
pT
pT
pT
pT
pT
pT
pT
pT
pT
pT
pT
pT
pT
pT
pT
pT
pT
pT
pT
pT
pT
pT
pT
pT
pT
pT
pT
pT
pT
pT
pT
pT
pT
pT
pT
pT
pT
pT
pT
pT
pT
pT
pT
pT
pT
pT
pT
pT
pT
pT
pT
pT
pT
pT
pT
"}
(63,1,1) = {"
pT
pT
pT
pT
pT
pT
pT
pT
pT
pT
pT
pT
pT
pT
pT
pT
pT
pT
pT
pT
pT
pT
pT
pT
pT
pT
pT
pT
pT
pT
pT
pT
pT
pT
pT
pT
pT
pT
pT
pT
pT
pT
pT
pT
pT
pT
pT
pT
pT
pT
pT
pT
pT
pT
pT
pT
pT
pT
pT
pT
pT
pT
pT
pT
pT
pT
pT
pT
pT
pT
pT
pT
pT
pT
pT
"}
(64,1,1) = {"
pT
pT
pT
pT
pT
pT
pT
pT
pT
pT
pT
pT
pT
pT
pT
pT
pT
pT
pT
pT
pT
pT
pT
pT
pT
pT
pT
pT
pT
pT
pT
pT
pT
pT
pT
pT
pT
pT
pT
pT
pT
pT
pT
pT
pT
pT
pT
pT
pT
pT
pT
pT
pT
pT
pT
pT
pT
pT
pT
pT
pT
pT
pT
pT
pT
pT
pT
pT
pT
pT
pT
pT
pT
pT
pT
"}
(65,1,1) = {"
pT
pT
pT
pT
pT
pT
pT
pT
pT
pT
pT
pT
pT
pT
pT
pT
pT
pT
pT
pT
pT
pT
pT
pT
pT
pT
pT
pT
pT
pT
pT
pT
pT
pT
pT
pT
pT
pT
pT
pT
pT
pT
pT
pT
pT
pT
pT
pT
pT
pT
pT
pT
pT
pT
pT
pT
pT
pT
pT
pT
pT
pT
pT
pT
pT
pT
pT
pT
pT
pT
pT
pT
pT
pT
pT
"}
(66,1,1) = {"
pT
pT
pT
pT
pT
pT
pT
pT
pT
pT
pT
pT
pT
pT
pT
pT
pT
pT
pT
pT
pT
pT
pT
pT
pT
pT
pT
pT
pT
pT
pT
pT
pT
pT
pT
pT
pT
pT
pT
pT
pT
pT
pT
pT
pT
pT
pT
pT
pT
pT
pT
pT
pT
pT
pT
pT
pT
pT
pT
pT
pT
pT
pT
pT
pT
pT
pT
pT
pT
pT
pT
pT
pT
pT
pT
"}
(67,1,1) = {"
pT
pT
pT
pT
pT
pT
pT
pT
pT
pT
pT
pT
pT
pT
pT
pT
pT
pT
pT
pT
pT
pT
pT
pT
pT
pT
pT
pT
pT
pT
pT
pT
pT
pT
pT
pT
pT
pT
pT
pT
pT
pT
pT
pT
pT
pT
pT
pT
pT
pT
pT
pT
pT
pT
pT
pT
pT
pT
pT
pT
pT
pT
pT
pT
pT
pT
pT
pT
pT
pT
pT
pT
pT
pT
pT
"}
(68,1,1) = {"
pT
pT
pT
pT
pT
pT
pT
pT
pT
pT
pT
pT
pT
pT
pT
pT
pT
pT
pT
pT
pT
pT
pT
pT
pT
pT
pT
pT
pT
pT
pT
pT
pT
pT
pT
pT
pT
pT
pT
pT
pT
pT
pT
pT
pT
pT
pT
pT
pT
pT
pT
pT
pT
pT
pT
pT
pT
pT
pT
pT
pT
pT
pT
pT
pT
pT
pT
pT
pT
pT
pT
pT
pT
pT
pT
"}
(69,1,1) = {"
pT
pT
pT
pT
pT
pT
pT
pT
pT
pT
pT
pT
pT
pT
pT
pT
pT
pT
pT
pT
pT
pT
pT
pT
pT
pT
pT
pT
pT
pT
pT
pT
pT
pT
pT
pT
pT
pT
pT
pT
pT
pT
pT
pT
pT
pT
pT
pT
pT
pT
pT
pT
pT
pT
pT
pT
pT
pT
pT
pT
pT
pT
pT
pT
pT
pT
pT
pT
pT
pT
pT
pT
pT
pT
pT
"}
(70,1,1) = {"
pT
pT
pT
pT
pT
pT
pT
pT
pT
pT
pT
pT
pT
pT
pT
pT
pT
pT
pT
pT
pT
pT
pT
pT
pT
pT
pT
pT
pT
pT
pT
pT
pT
pT
pT
pT
pT
pT
pT
pT
pT
pT
pT
pT
pT
pT
pT
pT
pT
pT
pT
pT
pT
pT
pT
pT
pT
pT
pT
pT
pT
pT
pT
pT
pT
pT
pT
pT
pT
pT
pT
pT
pT
pT
pT
"}
(71,1,1) = {"
pT
pT
pT
pT
pT
pT
pT
pT
pT
pT
pT
pT
pT
pT
pT
pT
pT
pT
pT
pT
pT
pT
pT
pT
pT
pT
pT
pT
pT
pT
pT
pT
pT
pT
pT
pT
pT
pT
pT
pT
pT
pT
pT
pT
pT
pT
pT
pT
pT
pT
pT
pT
pT
pT
pT
pT
pT
pT
pT
pT
pT
pT
pT
pT
pT
pT
pT
pT
pT
pT
pT
pT
pT
pT
pT
"}
(72,1,1) = {"
pT
sK
KW
qE
pT
pT
pT
pT
pT
pT
pT
pT
pT
pT
pT
pT
pT
pT
pT
pT
pT
pT
pT
pT
pT
pT
pT
pT
pT
pT
pT
pT
pT
pT
pT
pT
pT
pT
pT
pT
pT
pT
pT
pT
pT
pT
pT
pT
pT
pT
pT
pT
pT
pT
pT
pT
pT
pT
pT
pT
pT
pT
pT
pT
pT
pT
pT
pT
pT
pT
pT
pT
pT
pT
pT
"}
(73,1,1) = {"
pT
Td
Td
Td
pT
pT
pT
pT
pT
pT
pT
pT
pT
pT
pT
pT
pT
pT
pT
pT
pT
pT
pT
pT
pT
pT
pT
pT
pT
pT
pT
pT
pT
pT
pT
pT
pT
pT
pT
pT
pT
pT
pT
pT
pT
pT
pT
pT
pT
pT
pT
pT
pT
pT
pT
pT
pT
pT
pT
pT
pT
pT
pT
pT
pT
pT
pT
pT
pT
pT
pT
pT
pT
pT
pT
"}
(74,1,1) = {"
pT
PK
RI
hI
pT
pT
pT
pT
pT
pT
pT
pT
pT
pT
pT
pT
pT
pT
pT
pT
pT
pT
pT
pT
pT
pT
pT
pT
pT
pT
pT
pT
pT
pT
pT
pT
pT
pT
pT
pT
pT
pT
pT
pT
pT
pT
pT
pT
pT
pT
pT
pT
pT
pT
pT
pT
pT
pT
pT
pT
pT
pT
pT
pT
pT
pT
pT
pT
pT
pT
pT
pT
pT
pT
pT
"}
(75,1,1) = {"
pT
pT
pT
pT
pT
pT
pT
pT
pT
pT
pT
pT
pT
pT
pT
pT
pT
pT
pT
pT
pT
pT
pT
pT
pT
pT
pT
pT
pT
pT
pT
pT
pT
pT
pT
pT
pT
pT
pT
pT
pT
pT
pT
pT
pT
pT
pT
pT
pT
pT
pT
pT
pT
pT
pT
pT
pT
pT
pT
pT
pT
pT
pT
pT
pT
pT
pT
pT
pT
pT
pT
pT
pT
pT
pT
"}
