//MAP CONVERTED BY dmm2tgm.py THIS HEADER COMMENT PREVENTS RECONVERSION, DO NOT REMOVE
"al" = (
/obj/structure/halflife/pipes/horizontal,
/turf/open/floor/plating/indoor/concrete/sewer,
/area/halflife/indoors/sewer/hidden)
"bg" = (
/obj/machinery/telecomms/broadcaster/preset_left/birdstation,
/turf/open/floor/plating/ground/sidewalk,
/area/halflife/indoors/sewer/hidden)
"cR" = (
/obj/structure/halflife/road_barrier/concrete/alt{
	dir = 8
	},
/turf/open/floor/plating/indoor/concrete/sewer,
/area/halflife/indoors/sewer/hidden)
"cZ" = (
/obj/effect/landmark/deployments_refugee,
/obj/structure/chair/halflife/metal/folding{
	dir = 4
	},
/turf/open/floor/plating/indoor/concrete/sewer,
/area/halflife/indoors/sewer/hidden)
"dZ" = (
/obj/structure/halflife/pipes/piped,
/turf/open/floor/plating/indoor/metal/pipe,
/area/halflife/indoors/sewer/hidden)
"fO" = (
/obj/structure/railing/halflife/sewer{
	dir = 4
	},
/obj/structure/railing/halflife/sewer{
	dir = 8
	},
/obj/structure/lattice/catwalk/hl13,
/turf/open/halflife/water/sewer/shallow{
	slowdown = 0.5
	},
/area/halflife/indoors/sewer/hidden)
"gt" = (
/obj/machinery/combine_distressterminal,
/turf/open/floor/plating/indoor/concrete/sewer,
/area/halflife/indoors/sewer/hidden)
"hc" = (
/obj/effect/landmark/deployments_refugee,
/obj/structure/chair/halflife/metal/folding,
/obj/machinery/light/small/directional/north,
/turf/open/floor/plating/indoor/concrete/sewer,
/area/halflife/indoors/sewer/hidden)
"he" = (
/obj/structure/halflife/trash/cardboard,
/turf/open/floor/plating/indoor/concrete/sewer,
/area/halflife/indoors/sewer/hidden)
"kq" = (
/obj/structure/table/halflife/metal/grate,
/obj/structure/halflife/pipes/horizontal/end{
	dir = 1
	},
/turf/open/floor/plating/indoor/concrete/sewer,
/area/halflife/indoors/sewer/hidden)
"lz" = (
/obj/structure/halflife/pipes/horizontal/end,
/turf/open/floor/plating/indoor/concrete/sewer,
/area/halflife/indoors/sewer/hidden)
"lL" = (
/obj/machinery/light/small/directional/south,
/turf/open/floor/plating/indoor/concrete/sewer,
/area/halflife/indoors/sewer/hidden)
"lT" = (
/obj/effect/landmark/deployments_metrocop,
/obj/structure/chair/halflife/metal/folding{
	dir = 1
	},
/turf/open/floor/plating/indoor/concrete/sewer,
/area/halflife/indoors/sewer/hidden)
"mg" = (
/obj/structure/halflife/trash/papers/three,
/turf/open/floor/plating/indoor/concrete/sewer,
/area/halflife/indoors/sewer/hidden)
"mD" = (
/turf/open/floor/plating/indoor/metal/pipe/corner{
	dir = 1
	},
/area/halflife/indoors/sewer/hidden)
"mE" = (
/turf/open/floor/plating/indoor/metal/pipe{
	dir = 1
	},
/area/halflife/indoors/sewer/hidden)
"nc" = (
/obj/structure/lattice/catwalk/hl13,
/turf/open/halflife/water/sewer/shallow{
	slowdown = 0.5
	},
/area/halflife/indoors/sewer/hidden)
"np" = (
/obj/structure/halflife/pipes/piped,
/turf/open/floor/plating/indoor/concrete/sewer,
/area/halflife/indoors/sewer/hidden)
"nQ" = (
/obj/structure/railing/halflife/sewer{
	dir = 4
	},
/turf/open/floor/plating/indoor/metal/pipe,
/area/halflife/indoors/sewer/hidden)
"oA" = (
/obj/effect/landmark/deployments_refugee,
/obj/structure/chair/halflife/metal/folding,
/turf/open/floor/plating/indoor/concrete/sewer,
/area/halflife/indoors/sewer/hidden)
"oQ" = (
/obj/structure/lattice/catwalk/hl13,
/obj/structure/railing/halflife/sewer{
	dir = 8
	},
/turf/open/halflife/water/sewer/shallow{
	slowdown = 0.5
	},
/area/halflife/indoors/sewer/hidden)
"qW" = (
/obj/machinery/telecomms/server/presets/common/birdstation,
/turf/open/floor/plating/ground/sidewalk,
/area/halflife/indoors/sewer/hidden)
"ra" = (
/obj/machinery/door/unpowered/halflife/seethrough/grate{
	dir = 4
	},
/turf/open/floor/plating/indoor/concrete/sewer,
/area/halflife/indoors/sewer/hidden)
"sB" = (
/obj/structure/table/halflife/metal/grate,
/turf/open/floor/plating/indoor/concrete/sewer,
/area/halflife/indoors/sewer/hidden)
"sQ" = (
/obj/structure/railing/halflife/sewer,
/turf/open/floor/plating/indoor/metal/grate/border/warning{
	dir = 1
	},
/area/halflife/indoors/sewer/hidden)
"tG" = (
/obj/machinery/light/small/directional/east,
/turf/open/floor/plating/indoor/concrete/sewer,
/area/halflife/indoors/sewer/hidden)
"uI" = (
/turf/closed/indestructible/rock,
/area/halflife/indoors/sewer/hidden)
"wb" = (
/obj/machinery/telecomms/receiver/preset_left/birdstation,
/turf/open/floor/plating/ground/sidewalk,
/area/halflife/indoors/sewer/hidden)
"wt" = (
/turf/open/floor/plating/indoor/metal/pipe,
/area/halflife/indoors/sewer/hidden)
"ww" = (
/obj/machinery/telecomms/hub/preset,
/turf/open/floor/plating/ground/sidewalk,
/area/halflife/indoors/sewer/hidden)
"wV" = (
/obj/structure/railing/halflife/sewer{
	dir = 1
	},
/turf/open/floor/plating/indoor/metal/grate/border/warning{
	dir = 1
	},
/area/halflife/indoors/sewer/hidden)
"xJ" = (
/obj/effect/landmark/deployments_refugee,
/obj/structure/chair/halflife/metal/folding,
/obj/structure/halflife/pipes/piped,
/turf/open/floor/plating/indoor/concrete/sewer,
/area/halflife/indoors/sewer/hidden)
"yH" = (
/turf/open/floor/plating/ground/sidewalk,
/area/halflife/indoors/sewer/hidden)
"zn" = (
/turf/open/floor/plating/indoor/metal/grate/border/warning{
	dir = 1
	},
/area/halflife/indoors/sewer/hidden)
"Aw" = (
/obj/structure/halflife/pipes/horizontal/valve,
/turf/open/floor/plating/indoor/concrete/sewer,
/area/halflife/indoors/sewer/hidden)
"AX" = (
/obj/structure/halflife/pallet,
/turf/open/floor/plating/indoor/concrete/sewer,
/area/halflife/indoors/sewer/hidden)
"Bz" = (
/obj/structure/halflife/pipes/vent,
/turf/open/floor/plating/indoor/metal/pipe,
/area/halflife/indoors/sewer/hidden)
"Cn" = (
/obj/structure/halflife/pipes/horizontal/random,
/turf/open/floor/plating/indoor/concrete/sewer,
/area/halflife/indoors/sewer/hidden)
"Ct" = (
/turf/open/floor/plating/indoor/metal/grate/border/warning,
/area/halflife/indoors/sewer/hidden)
"EQ" = (
/turf/open/floor/plating/indoor/concrete/sewer,
/area/halflife/indoors/sewer/hidden)
"FG" = (
/obj/machinery/telecomms/bus/preset_one/birdstation,
/turf/open/floor/plating/ground/sidewalk,
/area/halflife/indoors/sewer/hidden)
"FO" = (
/obj/machinery/door/unpowered/halflife/seethrough/grate{
	dir = 1
	},
/turf/open/floor/plating/indoor/concrete/sewer,
/area/halflife/indoors/sewer/hidden)
"FU" = (
/obj/structure/halflife/trash/cardboard,
/obj/structure/halflife/pipes/horizontal/end,
/turf/open/floor/plating/indoor/concrete/sewer,
/area/halflife/indoors/sewer/hidden)
"GE" = (
/obj/structure/halflife/trash/garbage,
/obj/structure/halflife/pipes/horizontal,
/turf/open/floor/plating/indoor/concrete/sewer,
/area/halflife/indoors/sewer/hidden)
"GH" = (
/obj/structure/table/halflife/metal/grate,
/obj/structure/halflife/trash/cardboard{
	dir = 4;
	pixel_y = 9
	},
/turf/open/floor/plating/indoor/concrete/sewer,
/area/halflife/indoors/sewer/hidden)
"Jc" = (
/obj/machinery/door/unpowered/halflife/seethrough/grate,
/turf/open/floor/plating/indoor/concrete/sewer,
/area/halflife/indoors/sewer/hidden)
"Jg" = (
/obj/structure/halflife/pipes/horizontal/down,
/turf/open/floor/plating/indoor/concrete/sewer,
/area/halflife/indoors/sewer/hidden)
"Ke" = (
/obj/structure/halflife/pipes/horizontal/brown,
/turf/open/floor/plating/indoor/concrete/sewer,
/area/halflife/indoors/sewer/hidden)
"KC" = (
/obj/structure/table/halflife/metal/grate,
/obj/structure/halflife/trash/cardboard{
	dir = 8;
	pixel_y = 7;
	pixel_x = 5
	},
/turf/open/floor/plating/indoor/concrete/sewer,
/area/halflife/indoors/sewer/hidden)
"Mx" = (
/obj/structure/halflife/trash/papers/three{
	dir = 8;
	pixel_x = 0;
	pixel_y = 4
	},
/turf/open/floor/plating/indoor/concrete/sewer,
/area/halflife/indoors/sewer/hidden)
"MJ" = (
/obj/machinery/combine_distressterminal,
/obj/structure/halflife/pipes/horizontal,
/turf/open/floor/plating/indoor/concrete/sewer,
/area/halflife/indoors/sewer/hidden)
"Nb" = (
/obj/structure/lattice/catwalk/hl13,
/obj/structure/railing/halflife/sewer{
	dir = 4
	},
/obj/structure/railing/halflife/sewer{
	dir = 8
	},
/turf/open/halflife/water/sewer/shallow{
	slowdown = 0.5
	},
/area/halflife/indoors/sewer/hidden)
"Qm" = (
/obj/structure/lattice/catwalk/hl13,
/obj/structure/railing/halflife/sewer{
	dir = 4
	},
/turf/open/halflife/water/sewer/shallow{
	slowdown = 0.5
	},
/area/halflife/indoors/sewer/hidden)
"Rc" = (
/obj/structure/halflife/trash/garbage,
/turf/open/floor/plating/indoor/concrete/sewer,
/area/halflife/indoors/sewer/hidden)
"RR" = (
/turf/closed/wall/halflife/sewer,
/area/halflife/indoors/sewer/hidden)
"Sd" = (
/obj/structure/railing/halflife/sewer{
	dir = 8
	},
/turf/open/floor/plating/indoor/metal/pipe,
/area/halflife/indoors/sewer/hidden)
"Un" = (
/turf/open/halflife/water/sewer/shallow{
	slowdown = 0.5
	},
/area/halflife/indoors/sewer/hidden)
"UE" = (
/obj/effect/landmark/deployments_metrocop,
/obj/structure/chair/halflife/metal/folding{
	dir = 4
	},
/turf/open/floor/plating/indoor/concrete/sewer,
/area/halflife/indoors/sewer/hidden)
"VM" = (
/obj/structure/halflife/trash/wood{
	dir = 1
	},
/turf/open/floor/plating/indoor/concrete/sewer,
/area/halflife/indoors/sewer/hidden)
"XH" = (
/obj/structure/halflife/pipes/vent,
/turf/open/floor/plating/indoor/concrete/sewer,
/area/halflife/indoors/sewer/hidden)
"Zb" = (
/obj/structure/lattice/catwalk/hl13,
/obj/structure/railing/halflife/sewer,
/obj/structure/railing/halflife/sewer{
	dir = 1
	},
/turf/open/halflife/water/sewer/shallow{
	slowdown = 0.5
	},
/area/halflife/indoors/sewer/hidden)
"ZO" = (
/obj/machinery/telecomms/processor/preset_one/birdstation,
/turf/open/floor/plating/ground/sidewalk,
/area/halflife/indoors/sewer/hidden)

(1,1,1) = {"
uI
uI
uI
uI
uI
uI
uI
uI
uI
uI
uI
uI
uI
uI
uI
uI
uI
uI
uI
uI
uI
uI
uI
uI
uI
uI
uI
uI
uI
uI
uI
uI
uI
uI
uI
uI
uI
uI
uI
uI
uI
uI
uI
uI
uI
uI
uI
uI
uI
uI
uI
uI
uI
uI
uI
uI
uI
uI
uI
uI
uI
uI
uI
uI
uI
uI
uI
uI
uI
uI
uI
uI
uI
uI
uI
"}
(2,1,1) = {"
uI
uI
uI
uI
uI
uI
uI
uI
uI
uI
uI
uI
uI
uI
uI
uI
uI
uI
uI
uI
uI
uI
uI
uI
uI
uI
uI
uI
uI
uI
uI
uI
uI
uI
uI
uI
uI
uI
uI
uI
uI
uI
uI
uI
uI
uI
uI
uI
uI
uI
uI
uI
uI
uI
uI
uI
uI
uI
uI
uI
uI
uI
uI
uI
uI
uI
uI
uI
uI
uI
uI
uI
uI
uI
uI
"}
(3,1,1) = {"
uI
uI
uI
uI
uI
uI
uI
uI
uI
uI
uI
uI
uI
uI
uI
uI
uI
uI
uI
uI
uI
uI
uI
uI
uI
uI
uI
uI
uI
uI
uI
uI
uI
uI
uI
uI
uI
uI
uI
uI
uI
uI
uI
uI
uI
uI
uI
uI
uI
uI
uI
uI
uI
uI
uI
uI
uI
uI
uI
uI
uI
uI
uI
uI
uI
uI
uI
uI
uI
uI
uI
uI
uI
uI
uI
"}
(4,1,1) = {"
uI
uI
uI
uI
uI
uI
uI
uI
uI
uI
uI
uI
uI
uI
uI
uI
uI
uI
uI
uI
uI
uI
uI
uI
uI
uI
uI
uI
uI
uI
uI
uI
uI
uI
uI
uI
uI
uI
uI
uI
uI
uI
uI
uI
uI
uI
uI
uI
uI
uI
uI
uI
uI
uI
uI
uI
uI
uI
uI
uI
uI
uI
uI
uI
uI
uI
uI
uI
uI
uI
uI
uI
uI
uI
uI
"}
(5,1,1) = {"
uI
uI
uI
uI
uI
uI
uI
uI
uI
uI
uI
uI
uI
uI
uI
uI
uI
uI
uI
uI
uI
uI
uI
uI
uI
uI
uI
uI
uI
uI
uI
uI
uI
uI
uI
uI
uI
uI
uI
uI
uI
uI
uI
uI
uI
uI
uI
uI
uI
uI
uI
uI
uI
uI
uI
uI
uI
uI
uI
uI
uI
uI
uI
uI
uI
uI
uI
uI
uI
uI
uI
uI
uI
uI
uI
"}
(6,1,1) = {"
uI
uI
uI
uI
uI
uI
uI
uI
uI
uI
uI
uI
uI
uI
uI
uI
uI
uI
uI
uI
uI
uI
uI
uI
uI
uI
uI
uI
uI
uI
uI
uI
uI
uI
uI
uI
uI
uI
uI
uI
uI
uI
uI
uI
uI
uI
uI
uI
uI
uI
uI
uI
uI
uI
uI
uI
uI
uI
uI
uI
uI
uI
uI
RR
RR
RR
RR
RR
RR
RR
uI
uI
uI
uI
uI
"}
(7,1,1) = {"
uI
uI
uI
uI
uI
uI
uI
uI
uI
uI
uI
uI
uI
uI
uI
uI
uI
uI
uI
uI
uI
uI
uI
uI
uI
uI
uI
uI
uI
uI
uI
uI
uI
uI
uI
uI
uI
uI
uI
uI
uI
uI
uI
uI
uI
uI
uI
uI
uI
RR
RR
RR
RR
RR
RR
RR
RR
RR
RR
RR
RR
RR
RR
RR
cZ
cZ
EQ
UE
UE
RR
uI
uI
uI
uI
uI
"}
(8,1,1) = {"
uI
uI
uI
uI
uI
uI
uI
uI
uI
uI
uI
uI
uI
uI
uI
uI
uI
uI
uI
uI
uI
uI
uI
uI
uI
uI
uI
uI
uI
uI
uI
uI
uI
uI
uI
uI
uI
uI
uI
uI
uI
uI
uI
uI
uI
uI
uI
uI
uI
RR
EQ
EQ
EQ
EQ
EQ
EQ
EQ
EQ
EQ
EQ
EQ
EQ
EQ
Jc
EQ
EQ
EQ
EQ
lL
RR
uI
uI
uI
uI
uI
"}
(9,1,1) = {"
uI
uI
uI
uI
uI
uI
uI
uI
uI
uI
uI
uI
uI
uI
uI
uI
uI
uI
uI
uI
uI
uI
uI
uI
uI
uI
uI
uI
uI
uI
uI
uI
uI
uI
uI
uI
uI
uI
uI
uI
uI
uI
uI
uI
uI
uI
uI
uI
uI
RR
EQ
Un
Un
Zb
Un
Un
Un
Un
Un
Zb
Un
Un
EQ
FO
EQ
EQ
EQ
EQ
EQ
RR
uI
uI
uI
uI
uI
"}
(10,1,1) = {"
uI
uI
uI
uI
uI
uI
uI
uI
uI
uI
uI
uI
uI
uI
uI
uI
uI
uI
uI
uI
uI
uI
uI
uI
uI
uI
uI
uI
uI
uI
uI
uI
uI
uI
uI
uI
uI
uI
uI
uI
uI
uI
uI
uI
uI
uI
uI
uI
uI
RR
EQ
Un
Un
Zb
Un
Un
Un
Un
Un
Zb
Un
Un
EQ
RR
xJ
EQ
EQ
EQ
lT
RR
uI
uI
uI
uI
uI
"}
(11,1,1) = {"
uI
uI
uI
uI
uI
uI
uI
uI
uI
uI
uI
uI
uI
uI
uI
uI
uI
uI
uI
uI
uI
uI
uI
uI
uI
uI
uI
uI
uI
uI
uI
uI
uI
uI
uI
uI
uI
uI
uI
uI
uI
uI
uI
uI
uI
uI
uI
uI
uI
RR
EQ
fO
Nb
EQ
EQ
EQ
EQ
EQ
EQ
EQ
fO
Nb
EQ
RR
hc
EQ
EQ
EQ
lT
RR
uI
uI
uI
uI
uI
"}
(12,1,1) = {"
uI
uI
uI
uI
uI
uI
uI
uI
uI
uI
uI
uI
uI
uI
uI
uI
uI
uI
uI
uI
uI
uI
uI
uI
uI
uI
uI
uI
uI
uI
uI
uI
uI
uI
uI
uI
uI
uI
uI
uI
uI
uI
uI
uI
uI
uI
uI
uI
uI
RR
XH
Un
Un
EQ
RR
RR
RR
RR
RR
EQ
Un
Un
EQ
RR
oA
EQ
EQ
EQ
lT
RR
uI
uI
uI
uI
uI
"}
(13,1,1) = {"
uI
uI
uI
uI
uI
uI
uI
uI
uI
uI
uI
uI
uI
uI
uI
uI
uI
uI
uI
uI
uI
uI
uI
uI
uI
uI
uI
uI
uI
uI
uI
uI
uI
RR
RR
RR
RR
RR
RR
RR
RR
RR
RR
RR
RR
RR
RR
RR
RR
RR
EQ
Un
Un
EQ
RR
uI
uI
uI
RR
EQ
Un
Un
EQ
RR
oA
EQ
EQ
EQ
lT
RR
uI
uI
uI
uI
uI
"}
(14,1,1) = {"
uI
uI
uI
uI
uI
uI
uI
uI
uI
uI
uI
uI
uI
uI
uI
uI
uI
uI
uI
uI
uI
uI
uI
uI
uI
uI
uI
uI
uI
uI
uI
uI
uI
RR
EQ
EQ
EQ
EQ
EQ
EQ
EQ
EQ
EQ
EQ
EQ
EQ
EQ
EQ
EQ
EQ
EQ
fO
Nb
EQ
RR
uI
uI
uI
RR
EQ
Un
Un
EQ
RR
oA
EQ
EQ
tG
lT
RR
uI
uI
uI
uI
uI
"}
(15,1,1) = {"
uI
uI
uI
uI
uI
uI
uI
uI
uI
uI
uI
uI
uI
uI
uI
uI
uI
uI
uI
uI
uI
uI
uI
uI
uI
uI
uI
uI
uI
uI
uI
uI
uI
RR
EQ
Un
Un
Zb
Un
Un
Un
Un
Un
Un
Un
Un
Un
Un
Un
Un
Zb
Un
Un
EQ
RR
uI
uI
uI
RR
EQ
Un
Un
EQ
RR
RR
RR
ra
RR
RR
RR
uI
uI
uI
uI
uI
"}
(16,1,1) = {"
uI
uI
uI
uI
uI
uI
uI
uI
uI
uI
uI
uI
uI
uI
uI
uI
uI
uI
uI
uI
uI
uI
uI
uI
RR
RR
RR
RR
RR
RR
RR
RR
RR
RR
EQ
Un
Un
Zb
Un
Un
Un
Un
Un
Un
Un
Un
Un
Un
Un
Un
Zb
Un
Un
EQ
RR
uI
uI
uI
RR
EQ
Un
Un
EQ
RR
wt
EQ
EQ
EQ
wt
RR
uI
uI
uI
uI
uI
"}
(17,1,1) = {"
uI
uI
uI
uI
uI
uI
uI
uI
uI
uI
uI
uI
uI
uI
uI
uI
uI
uI
uI
uI
uI
uI
uI
uI
RR
GH
sB
gt
EQ
EQ
sB
sB
EQ
RR
EQ
fO
Nb
EQ
EQ
EQ
EQ
EQ
EQ
EQ
EQ
EQ
EQ
EQ
EQ
EQ
EQ
EQ
EQ
EQ
RR
uI
uI
uI
RR
EQ
Un
Un
EQ
RR
wt
EQ
EQ
EQ
wt
RR
uI
uI
uI
uI
uI
"}
(18,1,1) = {"
uI
uI
uI
uI
uI
uI
uI
uI
uI
uI
uI
uI
uI
uI
uI
uI
uI
uI
uI
uI
uI
uI
uI
uI
RR
EQ
EQ
EQ
EQ
EQ
EQ
EQ
EQ
RR
EQ
Un
Un
EQ
RR
RR
RR
RR
RR
RR
RR
RR
RR
RR
RR
RR
RR
RR
RR
RR
RR
uI
uI
uI
RR
EQ
Un
Un
EQ
RR
wt
EQ
EQ
EQ
wt
RR
uI
uI
uI
uI
uI
"}
(19,1,1) = {"
uI
uI
uI
uI
uI
uI
uI
uI
uI
uI
uI
uI
uI
uI
uI
uI
uI
uI
uI
uI
uI
uI
uI
uI
RR
np
EQ
EQ
EQ
EQ
EQ
EQ
EQ
Jc
EQ
Un
Un
EQ
RR
uI
uI
uI
uI
uI
uI
uI
uI
uI
uI
uI
uI
uI
uI
uI
uI
uI
uI
uI
RR
EQ
Un
Un
EQ
RR
wt
EQ
EQ
EQ
wt
RR
uI
uI
uI
uI
uI
"}
(20,1,1) = {"
uI
uI
uI
uI
uI
uI
uI
uI
uI
uI
uI
uI
uI
uI
uI
uI
uI
uI
uI
uI
uI
uI
uI
uI
RR
EQ
EQ
EQ
EQ
EQ
EQ
EQ
EQ
RR
EQ
Un
Un
EQ
RR
uI
uI
uI
uI
uI
uI
uI
uI
uI
uI
uI
uI
uI
uI
uI
uI
uI
uI
uI
RR
EQ
Un
Un
EQ
RR
wt
EQ
EQ
EQ
wt
RR
uI
uI
uI
uI
uI
"}
(21,1,1) = {"
uI
uI
uI
uI
uI
uI
uI
uI
uI
uI
uI
uI
uI
uI
uI
uI
uI
uI
uI
uI
uI
uI
uI
uI
RR
XH
EQ
EQ
EQ
EQ
EQ
EQ
Rc
RR
EQ
EQ
EQ
EQ
RR
uI
uI
uI
uI
uI
uI
uI
uI
uI
uI
uI
uI
uI
uI
uI
uI
uI
uI
uI
RR
EQ
Un
Un
EQ
RR
nQ
EQ
EQ
EQ
wt
RR
uI
uI
uI
uI
uI
"}
(22,1,1) = {"
uI
uI
uI
uI
uI
uI
uI
uI
uI
uI
uI
uI
uI
uI
uI
uI
uI
uI
uI
uI
uI
uI
uI
uI
RR
EQ
EQ
EQ
EQ
EQ
RR
RR
RR
RR
RR
EQ
EQ
RR
RR
RR
RR
RR
RR
RR
RR
RR
RR
RR
RR
RR
RR
RR
RR
RR
uI
uI
uI
uI
RR
EQ
Un
Un
EQ
Jc
Ct
EQ
EQ
EQ
wt
RR
uI
uI
uI
uI
uI
"}
(23,1,1) = {"
uI
uI
uI
uI
uI
uI
uI
uI
uI
uI
uI
uI
uI
uI
uI
uI
uI
RR
RR
RR
RR
RR
RR
RR
RR
RR
EQ
EQ
EQ
RR
RR
mE
mE
mE
mE
wV
sQ
mE
mE
mE
mE
mE
mE
mE
mE
mE
mE
mE
mE
mE
mE
mE
mE
RR
RR
RR
RR
RR
RR
XH
Un
Un
EQ
RR
Sd
EQ
EQ
EQ
wt
RR
uI
uI
uI
uI
uI
"}
(24,1,1) = {"
uI
uI
uI
uI
uI
uI
uI
uI
uI
uI
uI
uI
uI
uI
uI
uI
uI
RR
EQ
EQ
EQ
EQ
EQ
EQ
EQ
EQ
EQ
EQ
EQ
EQ
EQ
EQ
EQ
EQ
EQ
EQ
EQ
EQ
EQ
EQ
EQ
EQ
EQ
EQ
EQ
EQ
EQ
EQ
EQ
EQ
EQ
EQ
EQ
EQ
EQ
EQ
EQ
EQ
EQ
EQ
fO
Nb
EQ
RR
wt
EQ
EQ
EQ
wt
RR
uI
uI
uI
uI
uI
"}
(25,1,1) = {"
uI
uI
uI
uI
uI
uI
uI
uI
uI
uI
uI
uI
uI
uI
uI
uI
uI
RR
al
EQ
Un
Un
Un
Un
Un
Un
Zb
Un
Un
Zb
Un
Un
Un
Un
Un
Un
Un
Un
Un
Un
Un
Un
Un
Un
Un
Un
Un
Un
Un
Un
Un
Un
Un
Un
Un
Un
Un
Un
Un
Zb
Un
Un
EQ
RR
wt
EQ
EQ
EQ
wt
RR
uI
uI
uI
uI
uI
"}
(26,1,1) = {"
uI
uI
uI
uI
uI
uI
uI
uI
uI
uI
uI
uI
uI
uI
uI
uI
uI
RR
Cn
EQ
Un
Un
Un
Un
Un
Un
Zb
Un
Un
Zb
Un
Un
Un
Un
Un
Un
Un
Un
Un
Un
Un
Un
Un
Un
Un
Un
Un
Un
Un
Un
Un
Un
Un
Un
Un
Un
Un
Un
Un
Zb
Un
Un
EQ
RR
wt
EQ
EQ
EQ
wt
RR
uI
uI
uI
uI
uI
"}
(27,1,1) = {"
uI
uI
uI
uI
uI
uI
uI
uI
uI
uI
uI
uI
uI
uI
uI
uI
uI
RR
al
EQ
fO
Nb
EQ
EQ
EQ
EQ
EQ
fO
Nb
EQ
EQ
EQ
EQ
EQ
EQ
EQ
EQ
EQ
EQ
EQ
EQ
EQ
EQ
EQ
EQ
EQ
EQ
EQ
EQ
EQ
EQ
EQ
EQ
EQ
EQ
Un
Un
EQ
EQ
EQ
EQ
EQ
EQ
RR
Bz
EQ
EQ
EQ
wt
RR
uI
uI
uI
uI
uI
"}
(28,1,1) = {"
uI
uI
uI
uI
uI
uI
uI
uI
uI
uI
uI
uI
uI
uI
uI
uI
uI
RR
al
EQ
Un
Un
EQ
RR
RR
RR
EQ
Un
Un
EQ
RR
mE
mE
mE
mE
mE
mE
mE
mE
wV
zn
sQ
mE
mE
mE
mE
mE
mE
mE
mE
mE
mE
mE
RR
EQ
Un
Un
EQ
RR
RR
RR
RR
RR
RR
wt
EQ
EQ
EQ
wt
RR
uI
uI
uI
uI
uI
"}
(29,1,1) = {"
uI
uI
uI
uI
uI
uI
uI
uI
uI
uI
uI
uI
uI
uI
uI
uI
uI
RR
Ke
EQ
Un
Un
EQ
wt
RR
wt
EQ
Un
Un
EQ
RR
RR
RR
RR
RR
RR
RR
RR
RR
EQ
EQ
EQ
RR
RR
RR
RR
RR
RR
RR
RR
RR
RR
RR
RR
VM
Un
Un
EQ
RR
uI
uI
uI
uI
RR
wt
EQ
EQ
EQ
wt
RR
uI
uI
uI
uI
uI
"}
(30,1,1) = {"
uI
uI
uI
uI
uI
uI
uI
uI
uI
uI
uI
uI
uI
uI
uI
uI
uI
RR
al
EQ
Un
Un
EQ
wt
RR
wt
EQ
Un
Un
EQ
RR
uI
uI
uI
uI
uI
uI
uI
RR
EQ
EQ
EQ
RR
uI
uI
uI
uI
uI
uI
uI
uI
uI
uI
RR
EQ
Un
Un
EQ
RR
uI
uI
uI
uI
RR
wt
cR
EQ
cR
wt
RR
uI
uI
uI
uI
uI
"}
(31,1,1) = {"
uI
uI
uI
uI
uI
uI
uI
uI
uI
uI
uI
uI
uI
uI
uI
uI
uI
RR
Jg
EQ
Un
Un
EQ
wt
RR
Bz
EQ
Un
Un
EQ
RR
uI
uI
uI
uI
uI
uI
uI
RR
XH
EQ
EQ
RR
uI
uI
uI
uI
uI
uI
uI
uI
uI
uI
RR
EQ
Un
Un
EQ
RR
uI
uI
uI
uI
RR
wt
EQ
EQ
EQ
wt
RR
uI
uI
uI
uI
uI
"}
(32,1,1) = {"
uI
uI
uI
uI
uI
uI
uI
uI
uI
uI
uI
uI
uI
uI
uI
uI
uI
RR
al
EQ
Un
Un
EQ
wt
RR
wt
EQ
Un
Un
EQ
RR
uI
uI
uI
uI
uI
uI
uI
RR
EQ
EQ
EQ
RR
uI
uI
uI
uI
uI
uI
uI
uI
uI
uI
RR
EQ
Un
Un
EQ
RR
uI
uI
uI
uI
RR
wt
EQ
EQ
EQ
wt
RR
uI
uI
uI
uI
uI
"}
(33,1,1) = {"
uI
uI
uI
uI
uI
uI
uI
uI
uI
uI
uI
uI
uI
uI
uI
uI
uI
RR
GE
EQ
Un
Un
EQ
wt
RR
wt
EQ
Un
Un
EQ
RR
uI
uI
uI
uI
uI
uI
uI
RR
EQ
EQ
EQ
RR
uI
uI
uI
uI
uI
uI
uI
uI
uI
uI
RR
EQ
Un
Un
EQ
RR
uI
uI
uI
uI
RR
wt
EQ
EQ
EQ
wt
RR
uI
uI
uI
uI
uI
"}
(34,1,1) = {"
uI
uI
uI
uI
uI
uI
uI
uI
uI
uI
uI
uI
uI
uI
uI
uI
uI
RR
Aw
EQ
Un
Un
EQ
wt
RR
wt
EQ
Un
Un
EQ
RR
uI
uI
uI
uI
RR
RR
RR
RR
EQ
EQ
EQ
RR
RR
RR
RR
uI
uI
uI
uI
uI
uI
uI
RR
EQ
Un
Un
EQ
RR
uI
uI
uI
uI
RR
wt
EQ
EQ
EQ
wt
RR
uI
uI
uI
uI
uI
"}
(35,1,1) = {"
uI
uI
uI
uI
uI
uI
uI
uI
uI
uI
uI
uI
uI
uI
RR
RR
RR
RR
al
EQ
Un
Un
EQ
wt
RR
wt
EQ
Un
Un
EQ
RR
uI
uI
uI
uI
RR
Rc
EQ
EQ
EQ
EQ
EQ
EQ
EQ
EQ
RR
uI
uI
uI
uI
uI
uI
uI
RR
EQ
Un
Un
EQ
RR
uI
uI
uI
uI
RR
wt
EQ
EQ
EQ
wt
RR
uI
uI
uI
uI
uI
"}
(36,1,1) = {"
uI
uI
uI
uI
uI
uI
uI
uI
uI
uI
uI
uI
uI
uI
RR
wt
EQ
RR
lz
EQ
Un
Un
EQ
wt
RR
wt
EQ
Un
Un
EQ
RR
uI
uI
uI
uI
RR
EQ
EQ
EQ
EQ
EQ
EQ
EQ
EQ
EQ
RR
uI
uI
uI
uI
uI
uI
uI
RR
EQ
Un
Un
EQ
RR
uI
uI
uI
uI
RR
wt
EQ
EQ
EQ
wt
RR
uI
uI
uI
uI
uI
"}
(37,1,1) = {"
uI
uI
uI
uI
uI
uI
uI
uI
uI
uI
uI
uI
uI
uI
RR
wt
EQ
EQ
EQ
EQ
oQ
oQ
EQ
Ct
EQ
Ct
EQ
Un
Un
EQ
RR
uI
uI
uI
uI
RR
EQ
EQ
EQ
EQ
EQ
EQ
EQ
EQ
EQ
RR
uI
uI
uI
uI
uI
uI
uI
RR
EQ
Un
Un
EQ
RR
RR
RR
RR
RR
RR
wt
EQ
EQ
EQ
wt
RR
uI
uI
uI
uI
uI
"}
(38,1,1) = {"
uI
uI
uI
uI
uI
uI
uI
uI
uI
uI
uI
uI
uI
uI
RR
dZ
EQ
EQ
EQ
EQ
nc
nc
EQ
Ct
EQ
Ct
EQ
Un
Un
EQ
RR
uI
uI
uI
RR
RR
EQ
EQ
EQ
RR
RR
RR
mg
EQ
EQ
RR
RR
uI
uI
uI
uI
uI
uI
RR
EQ
Un
Un
EQ
RR
mE
mE
mE
mE
mE
mD
EQ
EQ
EQ
wt
RR
uI
uI
uI
uI
uI
"}
(39,1,1) = {"
uI
uI
uI
uI
uI
uI
uI
uI
uI
uI
uI
uI
uI
uI
RR
wt
EQ
EQ
EQ
EQ
Qm
Qm
EQ
Ct
EQ
Ct
EQ
Un
Un
EQ
RR
uI
uI
uI
RR
EQ
EQ
EQ
EQ
sB
RR
gt
EQ
EQ
EQ
EQ
RR
uI
uI
uI
uI
uI
uI
RR
EQ
Un
Un
EQ
EQ
EQ
EQ
EQ
EQ
EQ
EQ
EQ
EQ
EQ
wt
RR
uI
uI
uI
uI
uI
"}
(40,1,1) = {"
uI
uI
uI
uI
uI
uI
uI
uI
uI
uI
uI
uI
uI
uI
RR
wt
he
RR
EQ
EQ
Un
Un
EQ
wt
RR
wt
EQ
Un
Un
EQ
RR
uI
uI
uI
RR
EQ
EQ
EQ
Mx
gt
RR
sB
EQ
EQ
EQ
EQ
RR
uI
uI
uI
uI
uI
uI
RR
EQ
Un
Un
EQ
EQ
EQ
EQ
EQ
EQ
EQ
EQ
EQ
EQ
EQ
wt
RR
uI
uI
uI
uI
uI
"}
(41,1,1) = {"
uI
uI
uI
uI
uI
uI
uI
uI
uI
uI
uI
uI
uI
uI
RR
RR
RR
RR
EQ
EQ
Un
Un
EQ
wt
RR
wt
EQ
Un
Un
EQ
RR
uI
uI
uI
RR
RR
EQ
EQ
EQ
RR
RR
RR
EQ
EQ
EQ
RR
RR
uI
uI
uI
uI
uI
uI
RR
EQ
Un
Un
EQ
EQ
EQ
EQ
EQ
EQ
EQ
EQ
EQ
EQ
EQ
wt
RR
uI
uI
uI
uI
uI
"}
(42,1,1) = {"
uI
uI
uI
uI
uI
uI
uI
uI
uI
uI
uI
uI
uI
uI
uI
uI
uI
RR
EQ
EQ
Un
Un
EQ
wt
RR
wt
EQ
Un
Un
EQ
RR
uI
uI
uI
uI
RR
EQ
EQ
EQ
EQ
EQ
EQ
EQ
EQ
EQ
RR
uI
uI
uI
uI
uI
uI
uI
RR
EQ
Un
Un
EQ
RR
mE
mE
mE
mE
mE
mE
zn
zn
zn
mD
RR
uI
uI
uI
uI
uI
"}
(43,1,1) = {"
uI
uI
uI
uI
uI
uI
uI
uI
uI
uI
uI
uI
uI
uI
uI
uI
uI
RR
EQ
EQ
Un
Un
EQ
wt
RR
wt
EQ
Un
Un
EQ
RR
uI
uI
uI
uI
RR
EQ
EQ
EQ
EQ
EQ
EQ
EQ
EQ
EQ
RR
uI
uI
uI
uI
uI
uI
uI
RR
XH
Un
Un
EQ
RR
RR
RR
RR
RR
RR
RR
EQ
EQ
EQ
RR
RR
uI
uI
uI
uI
uI
"}
(44,1,1) = {"
uI
uI
uI
uI
uI
uI
uI
uI
uI
uI
uI
uI
uI
uI
uI
uI
uI
RR
EQ
EQ
Un
Un
EQ
wt
RR
Bz
EQ
Un
Un
EQ
RR
uI
uI
uI
uI
RR
EQ
EQ
EQ
EQ
EQ
EQ
EQ
EQ
EQ
RR
uI
uI
uI
uI
uI
uI
uI
RR
EQ
Un
Un
EQ
RR
uI
uI
RR
kq
EQ
EQ
EQ
EQ
EQ
RR
uI
uI
uI
uI
uI
uI
"}
(45,1,1) = {"
uI
uI
uI
uI
uI
uI
uI
uI
uI
uI
uI
uI
uI
uI
uI
uI
uI
RR
EQ
EQ
Un
Un
EQ
wt
RR
wt
EQ
Un
Un
EQ
RR
uI
uI
uI
uI
RR
RR
RR
RR
EQ
EQ
EQ
RR
RR
RR
RR
uI
uI
uI
uI
uI
uI
uI
RR
EQ
Un
Un
EQ
RR
uI
uI
RR
MJ
EQ
EQ
EQ
EQ
EQ
RR
uI
uI
uI
uI
uI
uI
"}
(46,1,1) = {"
uI
uI
uI
uI
uI
uI
uI
uI
uI
uI
uI
uI
uI
uI
uI
uI
uI
RR
EQ
EQ
Un
Un
EQ
wt
RR
wt
EQ
Un
Un
EQ
RR
uI
uI
uI
uI
uI
uI
uI
RR
EQ
EQ
EQ
RR
uI
uI
uI
uI
uI
uI
uI
uI
uI
uI
RR
EQ
Un
Un
EQ
RR
uI
uI
RR
al
EQ
EQ
EQ
EQ
EQ
RR
uI
uI
uI
uI
uI
uI
"}
(47,1,1) = {"
uI
uI
uI
uI
uI
uI
uI
uI
uI
uI
uI
uI
uI
uI
uI
uI
uI
RR
EQ
EQ
Un
Un
EQ
wt
RR
wt
EQ
Un
Un
EQ
RR
uI
uI
uI
uI
uI
uI
uI
RR
EQ
EQ
EQ
RR
uI
uI
RR
RR
RR
RR
RR
RR
RR
RR
RR
EQ
Un
Un
EQ
RR
uI
uI
RR
FU
EQ
EQ
EQ
EQ
EQ
RR
uI
uI
uI
uI
uI
uI
"}
(48,1,1) = {"
uI
uI
uI
uI
uI
uI
uI
uI
uI
uI
uI
uI
uI
uI
uI
uI
uI
RR
EQ
EQ
Un
Un
EQ
RR
RR
RR
EQ
Un
Un
EQ
RR
RR
RR
RR
RR
RR
uI
uI
RR
EQ
EQ
EQ
RR
uI
uI
RR
EQ
EQ
EQ
EQ
EQ
EQ
EQ
EQ
EQ
fO
Nb
EQ
RR
RR
RR
RR
RR
XH
EQ
EQ
EQ
AX
RR
uI
uI
uI
uI
uI
uI
"}
(49,1,1) = {"
uI
uI
uI
uI
uI
uI
uI
uI
uI
uI
uI
uI
uI
uI
uI
uI
uI
RR
EQ
EQ
fO
Nb
EQ
EQ
EQ
EQ
EQ
fO
Nb
EQ
EQ
EQ
EQ
EQ
EQ
RR
uI
uI
RR
XH
EQ
EQ
RR
uI
uI
RR
EQ
Un
Un
Zb
Un
Un
Un
Un
Zb
Un
Un
EQ
RR
EQ
EQ
EQ
EQ
EQ
EQ
EQ
EQ
EQ
RR
uI
uI
uI
uI
uI
uI
"}
(50,1,1) = {"
uI
uI
uI
uI
uI
uI
uI
uI
uI
uI
uI
uI
uI
uI
uI
uI
uI
RR
EQ
EQ
Un
Un
Un
Un
Un
Un
Zb
Un
Un
Zb
Un
Un
Un
Un
EQ
RR
uI
uI
RR
EQ
EQ
EQ
RR
uI
uI
RR
EQ
Un
Un
Zb
Un
Un
Un
Un
Zb
Un
Un
EQ
Jc
EQ
EQ
EQ
EQ
EQ
EQ
EQ
EQ
EQ
RR
uI
uI
uI
uI
uI
uI
"}
(51,1,1) = {"
uI
uI
uI
uI
uI
uI
uI
uI
uI
uI
uI
uI
uI
uI
uI
uI
uI
RR
EQ
EQ
Un
Un
Un
Un
Un
Un
Zb
Un
Un
Zb
Un
Un
Un
Un
EQ
RR
uI
uI
RR
EQ
EQ
EQ
RR
uI
uI
RR
EQ
fO
Nb
EQ
EQ
EQ
EQ
EQ
EQ
EQ
EQ
EQ
RR
EQ
EQ
EQ
EQ
EQ
EQ
EQ
EQ
Rc
RR
uI
uI
uI
uI
uI
uI
"}
(52,1,1) = {"
uI
uI
uI
uI
uI
uI
uI
uI
uI
uI
uI
uI
uI
uI
uI
uI
uI
RR
EQ
EQ
EQ
EQ
EQ
EQ
EQ
EQ
EQ
EQ
EQ
EQ
EQ
EQ
Un
Un
EQ
RR
uI
uI
RR
EQ
EQ
EQ
RR
uI
uI
RR
EQ
Un
Un
EQ
RR
RR
RR
RR
RR
RR
RR
RR
RR
RR
RR
RR
RR
RR
RR
RR
RR
RR
RR
uI
uI
uI
uI
uI
uI
"}
(53,1,1) = {"
uI
uI
uI
uI
uI
uI
uI
uI
uI
uI
uI
uI
uI
uI
uI
uI
uI
RR
RR
RR
RR
RR
RR
RR
RR
RR
RR
ra
RR
RR
RR
EQ
Un
Un
EQ
RR
RR
RR
RR
EQ
EQ
EQ
RR
RR
RR
RR
EQ
Un
Un
EQ
RR
uI
uI
uI
uI
uI
uI
uI
uI
uI
uI
uI
uI
uI
uI
uI
uI
uI
uI
uI
uI
uI
uI
uI
uI
"}
(54,1,1) = {"
uI
uI
uI
uI
uI
uI
uI
uI
uI
uI
uI
uI
uI
uI
uI
uI
uI
uI
uI
uI
uI
uI
uI
uI
RR
KC
EQ
EQ
EQ
EQ
RR
EQ
Un
Un
EQ
RR
mE
mE
mE
wV
zn
sQ
mE
mE
mE
RR
EQ
Un
Un
EQ
RR
uI
uI
uI
uI
uI
uI
uI
uI
uI
uI
uI
uI
uI
uI
uI
uI
uI
uI
uI
uI
uI
uI
uI
uI
"}
(55,1,1) = {"
uI
uI
uI
uI
uI
uI
uI
uI
uI
uI
uI
uI
uI
uI
uI
uI
uI
uI
uI
uI
uI
uI
uI
uI
RR
sB
EQ
EQ
EQ
EQ
RR
EQ
fO
Nb
EQ
EQ
EQ
EQ
EQ
EQ
EQ
EQ
EQ
EQ
EQ
EQ
EQ
fO
Nb
EQ
RR
uI
uI
uI
uI
uI
uI
uI
uI
uI
uI
uI
uI
uI
uI
uI
uI
uI
uI
uI
uI
uI
uI
uI
uI
"}
(56,1,1) = {"
uI
uI
uI
uI
uI
uI
uI
uI
uI
uI
uI
uI
uI
uI
uI
uI
uI
uI
uI
uI
uI
uI
uI
uI
RR
sB
EQ
EQ
EQ
EQ
RR
EQ
Un
Un
Zb
Un
Un
Un
Un
Un
Un
Un
Un
Un
Un
Un
Zb
Un
Un
EQ
RR
uI
uI
uI
uI
uI
uI
uI
uI
uI
uI
uI
uI
uI
uI
uI
uI
uI
uI
uI
uI
uI
uI
uI
uI
"}
(57,1,1) = {"
uI
uI
uI
uI
uI
uI
uI
uI
uI
uI
uI
uI
uI
uI
uI
uI
uI
uI
uI
uI
uI
uI
uI
uI
RR
gt
EQ
EQ
EQ
EQ
Jc
EQ
Un
Un
Zb
Un
Un
Un
Un
Un
Un
Un
Un
Un
Un
Un
Zb
Un
Un
EQ
RR
uI
uI
uI
uI
uI
uI
uI
uI
uI
uI
uI
uI
uI
uI
uI
uI
uI
uI
uI
uI
uI
uI
uI
uI
"}
(58,1,1) = {"
uI
uI
uI
uI
uI
uI
uI
uI
uI
uI
uI
uI
uI
uI
uI
uI
uI
uI
uI
uI
uI
uI
uI
uI
RR
XH
EQ
EQ
EQ
EQ
RR
EQ
EQ
EQ
EQ
EQ
EQ
EQ
EQ
EQ
EQ
EQ
EQ
EQ
EQ
EQ
EQ
EQ
EQ
EQ
RR
uI
uI
uI
uI
uI
uI
uI
uI
uI
uI
uI
uI
uI
uI
uI
uI
uI
uI
uI
uI
uI
uI
uI
uI
"}
(59,1,1) = {"
uI
uI
uI
uI
uI
uI
uI
uI
uI
uI
uI
uI
uI
uI
uI
uI
uI
uI
uI
uI
uI
uI
uI
uI
RR
EQ
EQ
EQ
sB
sB
RR
RR
RR
RR
RR
RR
RR
RR
RR
RR
RR
RR
RR
RR
RR
RR
RR
RR
RR
RR
RR
uI
uI
uI
uI
uI
uI
uI
uI
uI
uI
uI
uI
uI
uI
uI
uI
uI
uI
uI
uI
uI
uI
uI
uI
"}
(60,1,1) = {"
uI
uI
uI
uI
uI
uI
uI
uI
uI
uI
uI
uI
uI
uI
uI
uI
uI
uI
uI
uI
uI
uI
uI
uI
RR
RR
RR
RR
RR
RR
RR
uI
uI
uI
uI
uI
uI
uI
uI
uI
uI
uI
uI
uI
uI
uI
uI
uI
uI
uI
uI
uI
uI
uI
uI
uI
uI
uI
uI
uI
uI
uI
uI
uI
uI
uI
uI
uI
uI
uI
uI
uI
uI
uI
uI
"}
(61,1,1) = {"
uI
uI
uI
uI
uI
uI
uI
uI
uI
uI
uI
uI
uI
uI
uI
uI
uI
uI
uI
uI
uI
uI
uI
uI
uI
uI
uI
uI
uI
uI
uI
uI
uI
uI
uI
uI
uI
uI
uI
uI
uI
uI
uI
uI
uI
uI
uI
uI
uI
uI
uI
uI
uI
uI
uI
uI
uI
uI
uI
uI
uI
uI
uI
uI
uI
uI
uI
uI
uI
uI
uI
uI
uI
uI
uI
"}
(62,1,1) = {"
uI
uI
uI
uI
uI
uI
uI
uI
uI
uI
uI
uI
uI
uI
uI
uI
uI
uI
uI
uI
uI
uI
uI
uI
uI
uI
uI
uI
uI
uI
uI
uI
uI
uI
uI
uI
uI
uI
uI
uI
uI
uI
uI
uI
uI
uI
uI
uI
uI
uI
uI
uI
uI
uI
uI
uI
uI
uI
uI
uI
uI
uI
uI
uI
uI
uI
uI
uI
uI
uI
uI
uI
uI
uI
uI
"}
(63,1,1) = {"
uI
uI
uI
uI
uI
uI
uI
uI
uI
uI
uI
uI
uI
uI
uI
uI
uI
uI
uI
uI
uI
uI
uI
uI
uI
uI
uI
uI
uI
uI
uI
uI
uI
uI
uI
uI
uI
uI
uI
uI
uI
uI
uI
uI
uI
uI
uI
uI
uI
uI
uI
uI
uI
uI
uI
uI
uI
uI
uI
uI
uI
uI
uI
uI
uI
uI
uI
uI
uI
uI
uI
uI
uI
uI
uI
"}
(64,1,1) = {"
uI
uI
uI
uI
uI
uI
uI
uI
uI
uI
uI
uI
uI
uI
uI
uI
uI
uI
uI
uI
uI
uI
uI
uI
uI
uI
uI
uI
uI
uI
uI
uI
uI
uI
uI
uI
uI
uI
uI
uI
uI
uI
uI
uI
uI
uI
uI
uI
uI
uI
uI
uI
uI
uI
uI
uI
uI
uI
uI
uI
uI
uI
uI
uI
uI
uI
uI
uI
uI
uI
uI
uI
uI
uI
uI
"}
(65,1,1) = {"
uI
uI
uI
uI
uI
uI
uI
uI
uI
uI
uI
uI
uI
uI
uI
uI
uI
uI
uI
uI
uI
uI
uI
uI
uI
uI
uI
uI
uI
uI
uI
uI
uI
uI
uI
uI
uI
uI
uI
uI
uI
uI
uI
uI
uI
uI
uI
uI
uI
uI
uI
uI
uI
uI
uI
uI
uI
uI
uI
uI
uI
uI
uI
uI
uI
uI
uI
uI
uI
uI
uI
uI
uI
uI
uI
"}
(66,1,1) = {"
uI
uI
uI
uI
uI
uI
uI
uI
uI
uI
uI
uI
uI
uI
uI
uI
uI
uI
uI
uI
uI
uI
uI
uI
uI
uI
uI
uI
uI
uI
uI
uI
uI
uI
uI
uI
uI
uI
uI
uI
uI
uI
uI
uI
uI
uI
uI
uI
uI
uI
uI
uI
uI
uI
uI
uI
uI
uI
uI
uI
uI
uI
uI
uI
uI
uI
uI
uI
uI
uI
uI
uI
uI
uI
uI
"}
(67,1,1) = {"
uI
uI
uI
uI
uI
uI
uI
uI
uI
uI
uI
uI
uI
uI
uI
uI
uI
uI
uI
uI
uI
uI
uI
uI
uI
uI
uI
uI
uI
uI
uI
uI
uI
uI
uI
uI
uI
uI
uI
uI
uI
uI
uI
uI
uI
uI
uI
uI
uI
uI
uI
uI
uI
uI
uI
uI
uI
uI
uI
uI
uI
uI
uI
uI
uI
uI
uI
uI
uI
uI
uI
uI
uI
uI
uI
"}
(68,1,1) = {"
uI
uI
uI
uI
uI
uI
uI
uI
uI
uI
uI
uI
uI
uI
uI
uI
uI
uI
uI
uI
uI
uI
uI
uI
uI
uI
uI
uI
uI
uI
uI
uI
uI
uI
uI
uI
uI
uI
uI
uI
uI
uI
uI
uI
uI
uI
uI
uI
uI
uI
uI
uI
uI
uI
uI
uI
uI
uI
uI
uI
uI
uI
uI
uI
uI
uI
uI
uI
uI
uI
uI
uI
uI
uI
uI
"}
(69,1,1) = {"
uI
uI
uI
uI
uI
uI
uI
uI
uI
uI
uI
uI
uI
uI
uI
uI
uI
uI
uI
uI
uI
uI
uI
uI
uI
uI
uI
uI
uI
uI
uI
uI
uI
uI
uI
uI
uI
uI
uI
uI
uI
uI
uI
uI
uI
uI
uI
uI
uI
uI
uI
uI
uI
uI
uI
uI
uI
uI
uI
uI
uI
uI
uI
uI
uI
uI
uI
uI
uI
uI
uI
uI
uI
uI
uI
"}
(70,1,1) = {"
uI
uI
uI
uI
uI
uI
uI
uI
uI
uI
uI
uI
uI
uI
uI
uI
uI
uI
uI
uI
uI
uI
uI
uI
uI
uI
uI
uI
uI
uI
uI
uI
uI
uI
uI
uI
uI
uI
uI
uI
uI
uI
uI
uI
uI
uI
uI
uI
uI
uI
uI
uI
uI
uI
uI
uI
uI
uI
uI
uI
uI
uI
uI
uI
uI
uI
uI
uI
uI
uI
uI
uI
uI
uI
uI
"}
(71,1,1) = {"
uI
uI
uI
uI
uI
uI
uI
uI
uI
uI
uI
uI
uI
uI
uI
uI
uI
uI
uI
uI
uI
uI
uI
uI
uI
uI
uI
uI
uI
uI
uI
uI
uI
uI
uI
uI
uI
uI
uI
uI
uI
uI
uI
uI
uI
uI
uI
uI
uI
uI
uI
uI
uI
uI
uI
uI
uI
uI
uI
uI
uI
uI
uI
uI
uI
uI
uI
uI
uI
uI
uI
uI
uI
uI
uI
"}
(72,1,1) = {"
uI
ww
FG
ZO
uI
uI
uI
uI
uI
uI
uI
uI
uI
uI
uI
uI
uI
uI
uI
uI
uI
uI
uI
uI
uI
uI
uI
uI
uI
uI
uI
uI
uI
uI
uI
uI
uI
uI
uI
uI
uI
uI
uI
uI
uI
uI
uI
uI
uI
uI
uI
uI
uI
uI
uI
uI
uI
uI
uI
uI
uI
uI
uI
uI
uI
uI
uI
uI
uI
uI
uI
uI
uI
uI
uI
"}
(73,1,1) = {"
uI
yH
yH
yH
uI
uI
uI
uI
uI
uI
uI
uI
uI
uI
uI
uI
uI
uI
uI
uI
uI
uI
uI
uI
uI
uI
uI
uI
uI
uI
uI
uI
uI
uI
uI
uI
uI
uI
uI
uI
uI
uI
uI
uI
uI
uI
uI
uI
uI
uI
uI
uI
uI
uI
uI
uI
uI
uI
uI
uI
uI
uI
uI
uI
uI
uI
uI
uI
uI
uI
uI
uI
uI
uI
uI
"}
(74,1,1) = {"
uI
wb
qW
bg
uI
uI
uI
uI
uI
uI
uI
uI
uI
uI
uI
uI
uI
uI
uI
uI
uI
uI
uI
uI
uI
uI
uI
uI
uI
uI
uI
uI
uI
uI
uI
uI
uI
uI
uI
uI
uI
uI
uI
uI
uI
uI
uI
uI
uI
uI
uI
uI
uI
uI
uI
uI
uI
uI
uI
uI
uI
uI
uI
uI
uI
uI
uI
uI
uI
uI
uI
uI
uI
uI
uI
"}
(75,1,1) = {"
uI
uI
uI
uI
uI
uI
uI
uI
uI
uI
uI
uI
uI
uI
uI
uI
uI
uI
uI
uI
uI
uI
uI
uI
uI
uI
uI
uI
uI
uI
uI
uI
uI
uI
uI
uI
uI
uI
uI
uI
uI
uI
uI
uI
uI
uI
uI
uI
uI
uI
uI
uI
uI
uI
uI
uI
uI
uI
uI
uI
uI
uI
uI
uI
uI
uI
uI
uI
uI
uI
uI
uI
uI
uI
uI
"}
