"a" = (/turf/open/floor/plating/ground/sidewalk,/area/misc/testroom)
"e" = (/turf/open/floor/plating/indoor/carpet/shaggy,/area/misc/testroom)
"g" = (/obj/machinery/example_objective{spawnid = 1; name = "the first objective"},/turf/open/floor/plating/indoor/carpet/shaggy/blue,/area/misc/testroom)
"h" = (/turf/open/floor/plating/indoor/carpet/shaggy/blue,/area/misc/testroom)
"t" = (/obj/machinery/example_objective{spawnid = 2; name = "the second objective"},/turf/open/floor/plating/indoor/carpet/shaggy/blue,/area/misc/testroom)
"u" = (/obj/effect/new_spawn/combine{spawnid = 2},/turf/open/floor/plating/indoor/carpet/shaggy,/area/misc/testroom)
"w" = (/obj/effect/new_spawn/combine{spawnid = 1},/turf/open/floor/plating/indoor/carpet/shaggy/blue,/area/misc/testroom)
"y" = (/obj/effect/landmark/deployments_refugee,/turf/open/floor/plating/indoor/carpet/shaggy,/area/misc/testroom)
"B" = (/obj/effect/new_spawn/rebel{spawnid = 2},/turf/open/floor/plating/indoor/carpet/shaggy,/area/misc/testroom)
"C" = (/turf/cordon,/area/misc/testroom)
"S" = (/obj/effect/new_spawn/rebel{spawnid = 1},/turf/open/floor/plating/indoor/carpet/shaggy/blue,/area/misc/testroom)
"U" = (/obj/effect/landmark/deployments_metrocop,/turf/open/floor/plating/indoor/carpet/shaggy,/area/misc/testroom)

(1,1,1) = {"
CCCCCCCCCC
ChwaaaaeUC
CShaaaaBeC
CaaaaaaaaC
CaaaaaaaaC
CaaaaaaaaC
CaaaaaaaaC
CeuaaaahhC
CyeaaaatgC
CCCCCCCCCC
"}
