//MAP CONVERTED BY dmm2tgm.py THIS HEADER COMMENT PREVENTS RECONVERSION, DO NOT REMOVE
"c" = (
/turf/open/floor/plating/indoor/metal/train/inner,
/area/shuttle/arrival)
"d" = (
/obj/structure/chair/comfy/halflife/diner{
	dir = 4
	},
/obj/machinery/light/small/directional/west,
/turf/open/floor/plating/indoor/metal/train,
/area/shuttle/arrival)
"l" = (
/obj/structure/chair/comfy/halflife/diner{
	dir = 4
	},
/turf/open/floor/plating/indoor/metal/train,
/area/shuttle/arrival)
"s" = (
/obj/structure/fans/tiny/invisible,
/obj/machinery/door/airlock/highsecurity/combine,
/turf/open/floor/plating/indoor/metal/train,
/area/shuttle/arrival)
"v" = (
/obj/structure/table/halflife/no_smooth/metal,
/obj/machinery/light/small/directional/west,
/turf/open/floor/plating/indoor/metal/train,
/area/shuttle/arrival)
"x" = (
/obj/docking_port/mobile/arrivals{
	dir = 2;
	name = "box arrivals shuttle"
	},
/turf/closed/wall/halflife/metal/strong/train,
/area/shuttle/arrival)
"z" = (
/obj/structure/table/halflife/no_smooth/metal,
/turf/open/floor/plating/indoor/metal/train,
/area/shuttle/arrival)
"B" = (
/turf/closed/wall/halflife/metal/strong/train,
/area/shuttle/arrival)
"H" = (
/turf/template_noop,
/area/template_noop)
"J" = (
/obj/structure/chair/comfy/halflife/diner{
	dir = 8
	},
/obj/machinery/light/small/directional/east,
/turf/open/floor/plating/indoor/metal/train,
/area/shuttle/arrival)
"L" = (
/obj/machinery/light/small/directional/south,
/turf/open/floor/plating/indoor/metal/train/inner,
/area/shuttle/arrival)
"M" = (
/obj/structure/chair/comfy/halflife/diner{
	dir = 8
	},
/turf/open/floor/plating/indoor/metal/train,
/area/shuttle/arrival)
"U" = (
/obj/structure/table/halflife/no_smooth/metal,
/obj/machinery/light/small/directional/east,
/turf/open/floor/plating/indoor/metal/train,
/area/shuttle/arrival)
"W" = (
/turf/open/floor/plating/indoor/metal/train,
/area/shuttle/arrival)

(1,1,1) = {"
H
B
B
B
B
B
s
B
B
B
B
B
B
H
"}
(2,1,1) = {"
B
B
v
l
z
d
W
l
v
z
l
B
B
H
"}
(3,1,1) = {"
x
c
c
c
c
c
c
c
c
c
c
L
B
H
"}
(4,1,1) = {"
B
B
U
M
z
J
W
M
U
z
M
B
B
H
"}
(5,1,1) = {"
H
B
B
B
B
B
s
B
B
B
B
B
B
H
"}
