//MAP CONVERTED BY dmm2tgm.py THIS HEADER COMMENT PREVENTS RECONVERSION, DO NOT REMOVE
"a" = (
/turf/template_noop,
/area/template_noop)
"c" = (
/turf/open/floor/plating/indoor/metal/train/inner,
/area/shuttle/arrival)
"l" = (
/obj/structure/chair/comfy/halflife/diner{
	dir = 4
	},
/turf/open/floor/plating/indoor/metal/train,
/area/shuttle/arrival)
"m" = (
/obj/structure/chair/comfy/halflife/diner{
	dir = 8
	},
/turf/open/floor/plating/indoor/metal/train,
/area/shuttle/arrival)
"s" = (
/obj/machinery/door/unpowered/halflife/seethrough/metal{
	dir = 8
	},
/obj/structure/fans/tiny/invisible,
/turf/open/floor/plating/indoor/metal/train,
/area/shuttle/arrival)
"v" = (
/obj/structure/table/halflife/no_smooth/metal,
/obj/machinery/light/small/red/directional/west,
/turf/open/floor/plating/indoor/metal/train,
/area/shuttle/arrival)
"x" = (
/obj/docking_port/mobile/arrivals{
	dir = 2;
	name = "box arrivals shuttle"
	},
/turf/closed/wall/halflife/metal/strong/train,
/area/shuttle/arrival)
"z" = (
/obj/structure/table/halflife/no_smooth/metal,
/turf/open/floor/plating/indoor/metal/train,
/area/shuttle/arrival)
"B" = (
/turf/closed/wall/halflife/metal/strong/train,
/area/shuttle/arrival)
"J" = (
/obj/structure/chair/comfy/halflife/diner{
	dir = 4
	},
/obj/machinery/light/small/red/directional/west,
/turf/open/floor/plating/indoor/metal/train,
/area/shuttle/arrival)
"L" = (
/obj/machinery/light/small,
/turf/open/floor/plating/indoor/metal/train/inner,
/area/shuttle/arrival)
"M" = (
/obj/structure/chair/comfy/halflife/diner{
	dir = 8
	},
/obj/machinery/light/small/red/directional/east,
/turf/open/floor/plating/indoor/metal/train,
/area/shuttle/arrival)
"U" = (
/obj/structure/table/halflife/no_smooth/metal,
/obj/machinery/light/small/red/directional/east,
/turf/open/floor/plating/indoor/metal/train,
/area/shuttle/arrival)
"W" = (
/turf/open/floor/plating/indoor/metal/train,
/area/shuttle/arrival)

(1,1,1) = {"
a
B
B
B
B
B
s
B
B
B
B
B
B
a
"}
(2,1,1) = {"
B
B
v
l
z
J
W
l
v
z
l
B
B
a
"}
(3,1,1) = {"
x
c
c
c
c
c
c
c
c
c
c
L
B
a
"}
(4,1,1) = {"
B
B
U
m
z
M
W
m
U
z
m
B
B
a
"}
(5,1,1) = {"
a
B
B
B
B
B
s
B
B
B
B
B
B
a
"}
