//MAP CONVERTED BY dmm2tgm.py THIS HEADER COMMENT PREVENTS RECONVERSION, DO NOT REMOVE
"b" = (
/turf/closed/wall/halflife/metal,
/area/shuttle/supply)
"d" = (
/obj/machinery/door/poddoor/shutters{
	id = "cargo_train";
	dir = 1
	},
/turf/open/floor/plating/indoor/metal/walkway{
	dir = 1
	},
/area/shuttle/supply)
"e" = (
/obj/machinery/combine_walllight/directional/east,
/turf/open/floor/plating/indoor/metal/combine/alt2,
/area/shuttle/supply)
"i" = (
/obj/structure/railing/halflife/full{
	dir = 1
	},
/obj/machinery/door/poddoor/shutters{
	id = "cargo_train";
	dir = 1
	},
/turf/open/floor/plating/indoor/metal/walkway{
	dir = 1
	},
/area/shuttle/supply)
"l" = (
/obj/machinery/combine_walllight/directional/west,
/turf/open/floor/plating/indoor/metal/combine/alt2,
/area/shuttle/supply)
"s" = (
/turf/template_noop,
/area/template_noop)
"t" = (
/obj/docking_port/mobile/supply{
	train = 1
	},
/turf/closed/wall/halflife/metal,
/area/shuttle/supply)
"u" = (
/obj/machinery/door/poddoor/shutters{
	id = "cargo_train"
	},
/turf/open/floor/plating/indoor/metal/walkway{
	dir = 1
	},
/area/shuttle/supply)
"y" = (
/obj/machinery/button/door{
	id = "cargo_train"
	},
/turf/closed/wall/halflife/metal,
/area/shuttle/supply)
"B" = (
/obj/structure/railing/halflife/full,
/obj/machinery/door/poddoor/shutters{
	id = "cargo_train"
	},
/turf/open/floor/plating/indoor/metal/walkway{
	dir = 1
	},
/area/shuttle/supply)
"O" = (
/turf/open/floor/plating/indoor/metal/combine/alt2,
/area/shuttle/supply)

(1,1,1) = {"
s
b
b
b
s
"}
(2,1,1) = {"
y
b
b
b
y
"}
(3,1,1) = {"
i
O
e
O
B
"}
(4,1,1) = {"
d
O
O
O
u
"}
(5,1,1) = {"
i
O
O
O
B
"}
(6,1,1) = {"
i
O
O
O
B
"}
(7,1,1) = {"
i
O
O
O
B
"}
(8,1,1) = {"
i
O
O
O
B
"}
(9,1,1) = {"
i
O
O
O
B
"}
(10,1,1) = {"
i
O
O
O
B
"}
(11,1,1) = {"
d
O
O
O
u
"}
(12,1,1) = {"
i
O
l
O
B
"}
(13,1,1) = {"
y
b
b
b
y
"}
(14,1,1) = {"
s
b
t
b
s
"}
