//MAP CONVERTED BY dmm2tgm.py THIS HEADER COMMENT PREVENTS RECONVERSION, DO NOT REMOVE
"b" = (
/turf/closed/wall/halflife/metal,
/area/shuttle/supply)
"e" = (
/turf/open/floor/plating/indoor/metal/smooth,
/area/shuttle/supply)
"i" = (
/obj/machinery/combine_walllight/directional/south,
/turf/open/floor/plating/indoor/metal/smooth,
/area/shuttle/supply)
"s" = (
/turf/template_noop,
/area/template_noop)
"t" = (
/obj/docking_port/mobile/supply{
	train = 1
	},
/turf/closed/wall/halflife/metal,
/area/shuttle/supply)
"u" = (
/obj/machinery/door/unpowered/halflife/metal,
/obj/structure/fans/tiny/invisible,
/turf/open/floor/plating/indoor/metal/smooth,
/area/shuttle/supply)

(1,1,1) = {"
b
b
b
b
b
"}
(2,1,1) = {"
b
e
e
e
b
"}
(3,1,1) = {"
u
e
e
e
u
"}
(4,1,1) = {"
b
i
e
e
b
"}
(5,1,1) = {"
b
e
e
e
b
"}
(6,1,1) = {"
b
e
e
e
b
"}
(7,1,1) = {"
b
e
e
e
b
"}
(8,1,1) = {"
b
e
e
e
b
"}
(9,1,1) = {"
b
e
e
e
b
"}
(10,1,1) = {"
b
e
e
e
b
"}
(11,1,1) = {"
b
i
e
e
b
"}
(12,1,1) = {"
u
e
e
e
u
"}
(13,1,1) = {"
b
e
e
e
b
"}
(14,1,1) = {"
b
b
e
b
b
"}
(15,1,1) = {"
s
b
t
b
s
"}
