//MAP CONVERTED BY dmm2tgm.py THIS HEADER COMMENT PREVENTS RECONVERSION, DO NOT REMOVE
"aa" = (
/turf/template_noop,
/area/template_noop)
"ao" = (
/obj/structure/chair/halflife/overlaypickup/plastic{
	dir = 8
	},
/turf/open/floor/plating/indoor/grooved,
/area/shuttle/escape)
"ar" = (
/obj/structure/table/halflife/metal,
/obj/item/storage/toolbox/mechanical,
/turf/open/floor/plating/indoor/metal/plate,
/area/shuttle/escape)
"aD" = (
/obj/structure/railing/halflife/wood{
	dir = 8
	},
/turf/open/floor/plating/indoor/woodc/fancy,
/area/shuttle/escape)
"aH" = (
/obj/machinery/light/small{
	dir = 4
	},
/turf/open/halflife/water/shallow,
/area/shuttle/escape)
"bi" = (
/obj/structure/window/reinforced{
	dir = 1
	},
/obj/machinery/power/shuttle_engine/heater,
/turf/open/floor/plating/indoor/metal/plate,
/area/shuttle/escape)
"bk" = (
/obj/machinery/power/shuttle_engine/propulsion,
/turf/open/floor/plating/indoor/metal/plate,
/area/shuttle/escape)
"bX" = (
/obj/structure/table/halflife/no_smooth/cable_reel,
/obj/structure/broken_flooring/plating/directional/east,
/obj/machinery/light/small{
	dir = 8
	},
/turf/open/floor/plating/indoor/grooved,
/area/shuttle/escape)
"cg" = (
/obj/structure/window/fulltile,
/obj/structure/grille,
/turf/open/floor/plating/indoor/grooved,
/area/shuttle/escape)
"cU" = (
/obj/docking_port/mobile/emergency{
	dir = 2;
	name = "Transfer Train";
	preferred_direction = 2;
	port_direction = 2
	},
/turf/closed/wall/halflife/metal/strong,
/area/shuttle/escape)
"cY" = (
/obj/machinery/turnstile/brig/halflife/forcefield/armory{
	dir = 1
	},
/turf/open/floor/plating/indoor/metal/plate,
/area/shuttle/escape)
"dn" = (
/obj/machinery/light/small{
	dir = 8
	},
/turf/open/halflife/water/shallow,
/area/shuttle/escape)
"du" = (
/obj/structure/railing/halflife/wood{
	dir = 4
	},
/turf/open/floor/plating/indoor/woodc/fancy,
/area/shuttle/escape)
"ec" = (
/obj/structure/chair/halflife/metal/folding{
	dir = 8
	},
/obj/machinery/light/small/directional/east,
/turf/open/indestructible/plating,
/area/shuttle/escape)
"fK" = (
/obj/machinery/scanner_gate/luxury_shuttle{
	name = "Loyalist Cabin Processor"
	},
/turf/open/floor/plating/indoor/grooved,
/area/shuttle/escape)
"gh" = (
/obj/structure/chair/sofa/corp/right{
	dir = 1
	},
/obj/item/storage/box/party_poppers,
/turf/open/floor/plating/indoor/carpet/green,
/area/shuttle/escape)
"gn" = (
/obj/machinery/light/small{
	dir = 4
	},
/obj/machinery/vending/breenwater,
/turf/open/floor/plating/indoor/grooved,
/area/shuttle/escape)
"gD" = (
/obj/structure/chair/halflife/metal/folding{
	dir = 8
	},
/obj/item/trash/chips,
/turf/open/floor/plating/indoor/grooved,
/area/shuttle/escape)
"hq" = (
/obj/structure/broken_flooring/plating/directional/north,
/turf/open/floor/plating/indoor/metal/plate,
/area/shuttle/escape)
"hN" = (
/obj/structure/railing/halflife/wood{
	dir = 8
	},
/obj/structure/halflife/storage/shelf/wood,
/obj/item/storage/box/halflife/loyaltyration,
/obj/item/storage/box/halflife/loyaltyration,
/obj/item/storage/box/halflife/loyaltyration,
/turf/open/floor/plating/indoor/woodc/fancy,
/area/shuttle/escape)
"iU" = (
/obj/item/trash/raisins,
/turf/open/indestructible/plating,
/area/shuttle/escape)
"ja" = (
/obj/machinery/light/small{
	dir = 4
	},
/turf/open/floor/plating/indoor/woodc/fancy,
/area/shuttle/escape)
"kO" = (
/obj/structure/closet/crate/freezer,
/turf/open/floor/plating/indoor/metal/plate,
/area/shuttle/escape)
"lo" = (
/obj/structure/chair/comfy/halflife/captain{
	dir = 4
	},
/turf/open/floor/plating/indoor/metal/plate,
/area/shuttle/escape)
"lJ" = (
/turf/closed/wall/halflife/metal/strong,
/area/shuttle/escape)
"lM" = (
/obj/structure/aquarium/crab,
/turf/open/halflife/water/shallow,
/area/shuttle/escape)
"mb" = (
/obj/structure/aquarium,
/turf/open/halflife/water/shallow,
/area/shuttle/escape)
"mF" = (
/obj/machinery/light/small{
	dir = 8
	},
/obj/structure/chair/halflife/metal/folding{
	dir = 4
	},
/turf/open/indestructible/plating,
/area/shuttle/escape)
"mT" = (
/obj/machinery/door/unpowered/halflife/seethrough/metal{
	dir = 8
	},
/obj/structure/fans/tiny/invisible,
/turf/open/indestructible/plating,
/area/shuttle/escape)
"mW" = (
/obj/structure/halflife/barrel/quadruple/yellow,
/turf/open/floor/plating/indoor/metal/plate,
/area/shuttle/escape)
"os" = (
/obj/structure/table/halflife/metal,
/turf/open/floor/plating/indoor/grooved,
/area/shuttle/escape)
"oz" = (
/obj/structure/halflife/pallet,
/turf/open/indestructible/plating,
/area/shuttle/escape)
"qr" = (
/obj/structure/table/halflife/no_smooth/wood,
/obj/item/reagent_containers/cup/glass/bottle/wine{
	pixel_x = 10;
	pixel_y = 15
	},
/obj/item/reagent_containers/cup/glass/drinkingglass/shotglass{
	pixel_y = 2;
	pixel_x = -1
	},
/obj/item/reagent_containers/cup/glass/drinkingglass/shotglass{
	pixel_y = 2;
	pixel_x = 7
	},
/obj/item/reagent_containers/cup/glass/drinkingglass/shotglass{
	pixel_y = 2;
	pixel_x = -8
	},
/obj/item/reagent_containers/cup/glass/drinkingglass/shotglass{
	pixel_y = 10;
	pixel_x = -8
	},
/turf/open/floor/plating/indoor/carpet/green,
/area/shuttle/escape)
"sd" = (
/turf/open/floor/plating/indoor/metal/industrial,
/area/shuttle/escape)
"sG" = (
/obj/machinery/light/small{
	dir = 8
	},
/obj/machinery/stasis,
/turf/open/floor/plating/indoor/grooved,
/area/shuttle/escape)
"tj" = (
/obj/structure/window/fulltile,
/obj/structure/grille,
/turf/open/floor/plating/indoor/metal/plate,
/area/shuttle/escape)
"tA" = (
/obj/structure/chair/halflife/metal/folding{
	dir = 4
	},
/turf/open/floor/plating/indoor/grooved,
/area/shuttle/escape)
"ui" = (
/obj/machinery/light/small,
/obj/structure/broken_flooring/plating/directional/west,
/turf/open/floor/plating/indoor/metal/plate,
/area/shuttle/escape)
"uV" = (
/obj/structure/chair/sofa/corp/left{
	dir = 4
	},
/turf/open/floor/plating/indoor/carpet/green,
/area/shuttle/escape)
"uZ" = (
/obj/machinery/camera/autoname{
	dir = 8
	},
/obj/structure/table_frame/halflife/wood,
/turf/open/indestructible/plating,
/area/shuttle/escape)
"vx" = (
/turf/open/floor/plating/indoor/woodc/fancy,
/area/shuttle/escape)
"vT" = (
/obj/structure/bed/halflife/mattress/stale,
/obj/effect/decal/cleanable/blood/old,
/obj/item/trash/fleet_ration,
/turf/open/floor/plating/indoor/metal/pipe,
/area/shuttle/escape)
"xo" = (
/obj/machinery/iv_drip,
/turf/open/floor/plating/indoor/metal/plate,
/area/shuttle/escape)
"yB" = (
/obj/structure/chair/comfy/halflife/captain{
	dir = 8
	},
/obj/effect/decal/cleanable/blood/tracks,
/turf/open/floor/plating/indoor/metal/plate,
/area/shuttle/escape)
"zZ" = (
/obj/structure/chair/halflife/overlaypickup/plastic{
	dir = 4
	},
/turf/open/floor/plating/indoor/grooved,
/area/shuttle/escape)
"BB" = (
/obj/item/food/deadmouse/moldy,
/obj/structure/broken_flooring/plating/always_floorplane/directional/west,
/turf/open/floor/plating/indoor/metal/plate,
/area/shuttle/escape)
"Df" = (
/obj/structure/chair/sofa/corp/corner{
	dir = 1
	},
/obj/item/clothing/head/costume/party,
/turf/open/floor/plating/indoor/carpet/green,
/area/shuttle/escape)
"DU" = (
/obj/machinery/light/small,
/turf/open/floor/plating/indoor/metal/plate,
/area/shuttle/escape)
"Ek" = (
/obj/machinery/camera/autoname{
	dir = 8
	},
/turf/open/floor/plating/indoor/woodc/fancy,
/area/shuttle/escape)
"Ev" = (
/obj/structure/halflife/pallet/stack,
/turf/open/indestructible/plating,
/area/shuttle/escape)
"Fx" = (
/obj/machinery/light/small{
	dir = 8
	},
/turf/open/floor/plating/indoor/grooved,
/area/shuttle/escape)
"FH" = (
/obj/structure/railing/halflife/wood{
	dir = 1
	},
/obj/machinery/computer/slot_machine,
/turf/open/floor/plating/indoor/woodc/fancy,
/area/shuttle/escape)
"GN" = (
/obj/structure/sign/plaques/kiddie{
	desc = "Loyalist Cabin - 500 credits"
	},
/turf/closed/wall/halflife/metal/strong,
/area/shuttle/escape)
"GQ" = (
/obj/structure/table/halflife/metal,
/obj/item/organ/liver,
/turf/open/floor/plating/indoor/metal/plate,
/area/shuttle/escape)
"Hd" = (
/obj/structure/halflife/barrel/quadruple/red,
/turf/open/floor/plating/indoor/metal/plate,
/area/shuttle/escape)
"Hg" = (
/turf/open/indestructible/plating,
/area/shuttle/escape)
"Hq" = (
/obj/machinery/computer/emergency_shuttle{
	dir = 4
	},
/turf/open/floor/plating/indoor/metal/plate,
/area/shuttle/escape)
"HH" = (
/turf/open/floor/plating/indoor/metal/plate,
/area/shuttle/escape)
"HR" = (
/obj/structure/chair/comfy/halflife/captain{
	dir = 1
	},
/turf/open/floor/plating/indoor/metal/plate,
/area/shuttle/escape)
"JH" = (
/obj/machinery/camera/autoname{
	dir = 4
	},
/obj/structure/table/halflife/metal,
/obj/machinery/vending/combine_wallmed/directional/north,
/turf/open/floor/plating/indoor/grooved,
/area/shuttle/escape)
"Lp" = (
/obj/structure/halflife/combine/powergen,
/turf/open/floor/plating/indoor/metal/pipe,
/area/shuttle/escape)
"Mv" = (
/obj/item/food/deadmouse/moldy,
/turf/open/floor/plating/indoor/metal/plate,
/area/shuttle/escape)
"Nw" = (
/turf/open/floor/plating/indoor/metal/pipe,
/area/shuttle/escape)
"Ox" = (
/obj/structure/table_frame/halflife/wood,
/turf/open/indestructible/plating,
/area/shuttle/escape)
"Px" = (
/obj/machinery/light/small{
	dir = 8
	},
/turf/open/floor/plating/indoor/woodc/fancy,
/area/shuttle/escape)
"QN" = (
/obj/structure/chair/halflife/metal/folding{
	dir = 4
	},
/turf/open/floor/plating/indoor/metal/pipe,
/area/shuttle/escape)
"Rn" = (
/obj/machinery/door/unpowered/halflife/seethrough/metal{
	dir = 8
	},
/obj/structure/fans/tiny/invisible,
/turf/open/floor/plating/indoor/grooved,
/area/shuttle/escape)
"TC" = (
/obj/machinery/turnstile/brig/halflife/forcefield{
	dir = 1
	},
/turf/open/floor/plating/indoor/grooved,
/area/shuttle/escape)
"Ue" = (
/obj/machinery/light/small{
	dir = 4
	},
/obj/machinery/stalker_chamber,
/obj/effect/decal/cleanable/blood/old,
/turf/open/floor/plating/indoor/grooved,
/area/shuttle/escape)
"Vv" = (
/turf/open/floor/plating/indoor/grooved,
/area/shuttle/escape)
"VW" = (
/obj/machinery/light/small,
/turf/open/floor/plating/indoor/woodc/fancy,
/area/shuttle/escape)
"Yj" = (
/obj/machinery/atm,
/obj/structure/broken_flooring/plating/always_floorplane/directional/east,
/turf/open/floor/plating/indoor/metal/plate,
/area/shuttle/escape)
"YE" = (
/obj/structure/railing/halflife/wood{
	dir = 4
	},
/obj/structure/halflife/storage/shelf/wood,
/obj/structure/halflife/trash/books,
/turf/open/floor/plating/indoor/woodc/fancy,
/area/shuttle/escape)
"ZK" = (
/obj/structure/railing/halflife/wood{
	dir = 1
	},
/obj/item/fishing_rod/unslotted,
/turf/open/floor/plating/indoor/woodc/fancy,
/area/shuttle/escape)

(1,1,1) = {"
aa
lJ
lJ
lJ
lJ
lJ
lJ
lJ
lJ
lJ
lJ
lJ
lJ
mT
lJ
lJ
lJ
lJ
lJ
lJ
lJ
lJ
lJ
lJ
lJ
lJ
aa
"}
(2,1,1) = {"
lJ
lJ
sG
lo
lJ
lM
dn
FH
Px
vx
TC
Fx
TC
Hg
mF
tA
tA
bX
zZ
zZ
lJ
mW
Lp
mW
lJ
bi
bk
"}
(3,1,1) = {"
lJ
JH
HH
HH
lJ
hN
aD
vx
vx
VW
lJ
tj
lJ
Yj
BB
HH
iU
HH
HH
ui
lJ
HH
Nw
Mv
lJ
bi
bk
"}
(4,1,1) = {"
cU
Hq
HR
HH
cY
vx
vx
vx
vx
vx
uV
Df
cg
HH
Ox
Ev
Ev
Hd
oz
HH
HH
sd
Nw
sd
lJ
bi
bk
"}
(5,1,1) = {"
lJ
os
HH
HH
lJ
YE
du
vx
vx
vx
qr
gh
GN
Hg
Hg
HH
hq
Hg
Hg
DU
lJ
kO
QN
ar
lJ
bi
bk
"}
(6,1,1) = {"
lJ
lJ
Ue
yB
lJ
mb
aH
ZK
ja
Ek
vx
ja
fK
Vv
gn
gD
uZ
ec
Vv
ao
lJ
xo
vT
GQ
lJ
bi
bk
"}
(7,1,1) = {"
aa
lJ
lJ
lJ
lJ
lJ
lJ
lJ
lJ
lJ
lJ
lJ
lJ
Rn
lJ
lJ
lJ
lJ
lJ
lJ
lJ
lJ
lJ
lJ
lJ
lJ
aa
"}
