//MAP CONVERTED BY dmm2tgm.py THIS HEADER COMMENT PREVENTS RECONVERSION, DO NOT REMOVE
"aB" = (
/obj/structure/fans/tiny/invisible,
/turf/open/floor/plating/indoor/metal/grate,
/area/shuttle/escape)
"bj" = (
/turf/template_noop,
/area/template_noop)
"bU" = (
/obj/structure/halflife/trash_decal,
/turf/open/floor/plating/indoor/metal,
/area/shuttle/escape)
"bX" = (
/obj/structure/halflife/trash_decal,
/obj/structure/fans/tiny/invisible,
/obj/machinery/light/small/directional/west,
/turf/open/floor/plating/indoor/metal,
/area/shuttle/escape)
"dO" = (
/obj/structure/fans/tiny/invisible,
/obj/structure/railing/halflife/solo{
	dir = 1
	},
/obj/structure/railing/halflife/solo{
	dir = 8
	},
/obj/item/weaponcrafting/frame/usp,
/turf/open/floor/plating/indoor/tile/navy,
/area/shuttle/escape)
"dR" = (
/obj/machinery/door/unpowered/halflife/seethrough/metal,
/obj/structure/barricade/wooden/crude,
/turf/open/floor/plating/indoor/concrete/small,
/area/shuttle/escape)
"dY" = (
/obj/structure/table/halflife/metal,
/obj/item/reagent_containers/cup/bowl,
/obj/item/reagent_containers/cup/bowl,
/obj/item/reagent_containers/cup/bowl,
/turf/open/floor/plating/indoor/metal,
/area/shuttle/escape)
"eW" = (
/turf/open/floor/plating/indoor/metal/grate/border,
/area/shuttle/escape)
"fc" = (
/turf/open/floor/plating/indoor/metal/plate,
/area/shuttle/escape)
"fO" = (
/turf/open/floor/plating/indoor/concrete/bricks,
/area/shuttle/escape)
"fQ" = (
/obj/structure/fans/tiny/invisible,
/obj/machinery/light/small/directional/west,
/turf/open/floor/plating/indoor/metal/industrial,
/area/shuttle/escape)
"gl" = (
/obj/structure/halflife/storage/shelf,
/obj/item/ammo_box/magazine/ak47,
/obj/machinery/light/small/directional/east,
/turf/open/floor/plating/indoor/metal,
/area/shuttle/escape)
"gN" = (
/obj/structure/broken_flooring/plating/directional/west,
/turf/template_noop,
/area/template_noop)
"gQ" = (
/obj/structure/halflife/trash/papers/two,
/obj/structure/fans/tiny/invisible,
/obj/item/ammo_casing/shotgun/buckshot/halflife,
/turf/open/floor/plating/indoor/metal/plate,
/area/shuttle/escape)
"gS" = (
/obj/structure/fans/tiny/invisible,
/obj/item/ammo_box/magazine/usp9mm,
/turf/open/floor/plating/indoor/metal/grate/border,
/area/shuttle/escape)
"hz" = (
/obj/structure/fans/tiny/invisible,
/obj/structure/chair/sofa/hl13bench{
	dir = 8
	},
/obj/machinery/light/small/directional/east,
/turf/open/floor/plating/indoor/metal/plate,
/area/shuttle/escape)
"hD" = (
/obj/structure/halflife/trash/papers/two,
/turf/open/floor/plating/indoor/metal,
/area/shuttle/escape)
"hE" = (
/obj/structure/halflife/trash_decal,
/turf/open/floor/plating/indoor/metal/plate,
/area/shuttle/escape)
"ic" = (
/obj/structure/lattice/catwalk/hl13,
/obj/structure/fans/tiny/invisible,
/obj/effect/decal/cleanable/glass,
/obj/item/ammo_casing/shotgun/buckshot/halflife,
/turf/open/floor/plating/indoor/metal/plate,
/area/shuttle/escape)
"la" = (
/obj/machinery/door/unpowered/halflife/wood/red{
	name = "surplus storage door"
	},
/turf/open/floor/plating/indoor/metal/plate,
/area/shuttle/escape)
"le" = (
/obj/docking_port/mobile/emergency,
/turf/closed/wall/halflife/metal/weak/old,
/area/shuttle/escape)
"lK" = (
/obj/structure/lattice/catwalk/hl13,
/turf/open/floor/plating/indoor/metal/plate,
/area/shuttle/escape)
"lP" = (
/turf/open/floor/plating/indoor/metal,
/area/shuttle/escape)
"lZ" = (
/obj/structure/closet/crate/freezer/halflife,
/obj/item/gun/ballistic/automatic/servicerifle/wood/no_mag,
/obj/machinery/light/small/directional/west,
/turf/open/floor/plating/indoor/metal/plate,
/area/shuttle/escape)
"mv" = (
/obj/structure/lattice/catwalk/hl13,
/obj/item/clothing/head/helmet/halflife/military/weak,
/turf/open/floor/plating/indoor/metal/plate,
/area/shuttle/escape)
"nb" = (
/obj/structure/broken_flooring/plating/directional/north,
/turf/template_noop,
/area/template_noop)
"nE" = (
/obj/structure/fans/tiny/invisible,
/obj/machinery/light/small/directional/west,
/turf/open/floor/plating/indoor/metal,
/area/shuttle/escape)
"nN" = (
/obj/item/food/badrecipe/moldy,
/turf/open/floor/plating/indoor/metal/plate,
/area/shuttle/escape)
"oo" = (
/obj/effect/mob_spawn/corpse/human/skeleton,
/turf/open/floor/plating/indoor/metal/plate,
/area/shuttle/escape)
"oW" = (
/obj/item/ammo_casing/c45,
/turf/open/floor/plating/indoor/concrete/small,
/area/shuttle/escape)
"pa" = (
/obj/structure/fans/tiny/invisible,
/turf/open/floor/plating/indoor/metal/plate,
/area/shuttle/escape)
"pn" = (
/obj/structure/lattice/catwalk/hl13,
/obj/structure/fans/tiny/invisible,
/obj/structure/halflife/trash/bricks,
/turf/open/floor/plating/indoor/metal/plate,
/area/shuttle/escape)
"pZ" = (
/obj/structure/halflife/trash/bricks,
/obj/machinery/light/small/directional/west,
/turf/open/floor/plating/indoor/metal/grate,
/area/shuttle/escape)
"qs" = (
/obj/structure/fans/tiny/invisible,
/obj/structure/barricade/wooden/solid,
/turf/open/floor/plating/indoor/metal/grate,
/area/shuttle/escape)
"qX" = (
/obj/machinery/computer/emergency_shuttle{
	dir = 4
	},
/turf/open/floor/plating/indoor/concrete/bricks,
/area/shuttle/escape)
"rM" = (
/obj/structure/chair/halflife/metal/stool,
/turf/open/floor/plating/indoor/concrete/bricks,
/area/shuttle/escape)
"sl" = (
/obj/structure/fans/tiny/invisible,
/obj/structure/table/halflife/metal/small,
/obj/item/clothing/ears/earmuffs,
/obj/item/clothing/glasses/sunglasses,
/turf/open/floor/plating/indoor/metal/grate/border,
/area/shuttle/escape)
"st" = (
/obj/structure/fans/tiny/invisible,
/turf/open/floor/plating/indoor/tile/navy,
/area/shuttle/escape)
"sK" = (
/obj/item/hl13_small_flag/poland,
/turf/open/floor/plating/indoor/metal/plate,
/area/shuttle/escape)
"ts" = (
/obj/item/knife/combat/survival,
/turf/open/floor/plating/indoor/metal/plate,
/area/shuttle/escape)
"tY" = (
/obj/item/chair/halflife/plastic,
/turf/open/floor/plating/indoor/metal/plate,
/area/shuttle/escape)
"un" = (
/obj/structure/fans/tiny/invisible,
/obj/structure/halflife/trash/garbage,
/turf/open/floor/plating/indoor/metal,
/area/shuttle/escape)
"vR" = (
/obj/structure/fans/tiny/invisible,
/obj/item/stack/sheet/scrap_metal,
/turf/open/floor/plating/indoor/metal/plate,
/area/shuttle/escape)
"xb" = (
/obj/structure/railing/halflife/solo{
	dir = 8
	},
/obj/machinery/light/small/directional/east,
/turf/open/floor/plating/indoor/metal/industrial,
/area/shuttle/escape)
"xD" = (
/obj/structure/chair/halflife/metal/stool,
/obj/machinery/light/small/directional/east,
/turf/open/floor/plating/indoor/concrete/small,
/area/shuttle/escape)
"xF" = (
/obj/structure/lattice/catwalk/hl13,
/obj/structure/fans/tiny/invisible,
/obj/effect/decal/cleanable/glass,
/turf/open/floor/plating/indoor/metal/plate,
/area/shuttle/escape)
"xQ" = (
/obj/structure/fans/tiny/invisible,
/obj/structure/chair/sofa/hl13bench{
	dir = 4
	},
/turf/open/floor/plating/indoor/metal/plate,
/area/shuttle/escape)
"yZ" = (
/obj/structure/rack,
/obj/item/clothing/under/syndicate/camo/halflife/armored,
/obj/item/clothing/suit/armor/halflife/milvest,
/obj/machinery/light/small/directional/west,
/turf/open/floor/plating/indoor/concrete/small,
/area/shuttle/escape)
"zJ" = (
/obj/structure/halflife/trash/food/glass,
/turf/open/floor/plating/indoor/metal/plate,
/area/shuttle/escape)
"Am" = (
/obj/structure/fans/tiny/invisible,
/turf/open/floor/plating/indoor/metal/industrial,
/area/shuttle/escape)
"AW" = (
/obj/structure/table/halflife/no_smooth/dice/pristine,
/obj/item/cigarette/halflife,
/obj/item/reagent_containers/cup/soda_cans/beer,
/turf/open/floor/plating/indoor/concrete,
/area/shuttle/escape)
"Be" = (
/obj/structure/fans/tiny/invisible,
/turf/open/floor/plating/indoor/metal,
/area/shuttle/escape)
"Bn" = (
/obj/structure/table/halflife/metal/small,
/obj/item/kitchen/spoon/soup_ladle,
/turf/open/floor/plating/indoor/metal/plate,
/area/shuttle/escape)
"Cd" = (
/obj/structure/fans/tiny/invisible,
/obj/structure/railing/halflife/solo{
	dir = 1
	},
/obj/effect/mob_spawn/corpse/human/skeleton,
/turf/open/floor/plating/indoor/metal/industrial,
/area/shuttle/escape)
"Ce" = (
/obj/structure/fans/tiny/invisible,
/obj/machinery/light/small/directional/east,
/turf/open/floor/plating/indoor/metal,
/area/shuttle/escape)
"Cg" = (
/obj/effect/mob_spawn/corpse/human/skeleton,
/turf/open/floor/plating/indoor/concrete/small,
/area/shuttle/escape)
"CZ" = (
/obj/structure/halflife/storage/shelf,
/obj/item/ammo_box/magazine/m4a1/service,
/obj/machinery/light/small/directional/west,
/turf/open/floor/plating/indoor/metal,
/area/shuttle/escape)
"Dp" = (
/obj/structure/halflife/trash/bricks,
/turf/open/floor/plating/indoor/metal/plate,
/area/shuttle/escape)
"Du" = (
/obj/structure/halflife/trash/papers/two,
/turf/open/floor/plating/indoor/metal/plate,
/area/shuttle/escape)
"EV" = (
/obj/item/clothing/head/helmet/halflife/military/weak,
/turf/open/floor/plating/indoor/metal/plate,
/area/shuttle/escape)
"FA" = (
/obj/structure/lattice/catwalk/hl13,
/obj/structure/fans/tiny/invisible,
/obj/item/stack/sheet/scrap_metal,
/turf/open/floor/plating/indoor/metal/plate,
/area/shuttle/escape)
"FF" = (
/obj/structure/reagent_dispensers/water_cooler,
/turf/open/floor/plating/indoor/metal/plate,
/area/shuttle/escape)
"FK" = (
/obj/structure/lattice/catwalk/hl13,
/obj/item/stack/sheet/scrap_metal,
/turf/open/floor/plating/indoor/metal/plate,
/area/shuttle/escape)
"Gs" = (
/turf/closed/wall/halflife/metal/weak/old,
/area/shuttle/escape)
"GM" = (
/turf/open/floor/plating/indoor/metal/industrial,
/area/shuttle/escape)
"Hd" = (
/obj/structure/fans/tiny/invisible,
/obj/effect/decal/cleanable/glass,
/turf/open/floor/plating/indoor/metal/grate,
/area/shuttle/escape)
"Jz" = (
/obj/structure/rack,
/obj/item/gun/ballistic/automatic/pistol/m1911,
/obj/machinery/light/small/directional/east,
/turf/open/floor/plating/indoor/concrete,
/area/shuttle/escape)
"JJ" = (
/obj/structure/table/halflife/no_smooth/large/metal{
	dir = 4
	},
/obj/item/kitchen/fork,
/obj/item/clothing/under/syndicate/camo/halflife/armored,
/turf/open/floor/plating/indoor/metal/plate,
/area/shuttle/escape)
"Kx" = (
/obj/item/knife/combat/survival,
/turf/open/floor/plating/indoor/metal,
/area/shuttle/escape)
"Ll" = (
/obj/structure/fans/tiny/invisible,
/obj/item/weaponcrafting/frame/spas12,
/turf/open/floor/plating/indoor/metal/grate,
/area/shuttle/escape)
"Mc" = (
/obj/effect/decal/cleanable/wrapping,
/turf/open/floor/plating/indoor/metal,
/area/shuttle/escape)
"Mn" = (
/obj/structure/halflife/storage/shelf,
/obj/item/food/meat_pierogi{
	name = "perfectly preserved pierogi"
	},
/turf/open/floor/plating/indoor/concrete,
/area/shuttle/escape)
"Mu" = (
/obj/effect/decal/cleanable/wrapping,
/obj/machinery/light/small/directional/east,
/turf/open/floor/plating/indoor/metal,
/area/shuttle/escape)
"Nc" = (
/obj/item/hl13_small_flag/poland,
/obj/machinery/light/small/directional/west,
/turf/open/floor/plating/indoor/concrete,
/area/shuttle/escape)
"Ol" = (
/obj/item/target,
/obj/structure/railing/halflife/solo{
	dir = 8
	},
/turf/open/floor/plating/indoor/tile/navy,
/area/shuttle/escape)
"OK" = (
/obj/item/reagent_containers/cup/glass/canteen,
/turf/open/floor/plating/indoor/metal/plate,
/area/shuttle/escape)
"Pd" = (
/obj/structure/table/halflife/metal,
/obj/structure/reagent_dispensers/servingdish,
/turf/open/floor/plating/indoor/metal/plate,
/area/shuttle/escape)
"Pw" = (
/obj/structure/fans/tiny/invisible,
/obj/structure/lattice/catwalk/hl13,
/turf/open/floor/plating/indoor/metal/plate,
/area/shuttle/escape)
"PV" = (
/obj/item/target/clown,
/obj/structure/fans/tiny/invisible,
/turf/open/floor/plating/indoor/metal/plate,
/area/shuttle/escape)
"Qh" = (
/obj/item/ammo_casing/c45,
/turf/open/floor/plating/indoor/concrete/bricks,
/area/shuttle/escape)
"QL" = (
/obj/item/chair/halflife/plastic,
/turf/open/floor/plating/indoor/metal,
/area/shuttle/escape)
"Rv" = (
/obj/structure/broken_flooring/plating/directional/south,
/turf/template_noop,
/area/template_noop)
"RY" = (
/obj/item/ammo_casing/shotgun/buckshot/halflife,
/turf/open/floor/plating/indoor/metal/plate,
/area/shuttle/escape)
"Sj" = (
/obj/structure/halflife/trash/food,
/turf/open/floor/plating/indoor/metal,
/area/shuttle/escape)
"So" = (
/obj/structure/table/halflife/no_smooth/large/metal{
	dir = 4
	},
/obj/item/reagent_containers/cup/glass/canteen,
/turf/open/floor/plating/indoor/metal/plate,
/area/shuttle/escape)
"Ti" = (
/obj/item/hl13_small_flag/poland,
/turf/open/floor/plating/indoor/metal,
/area/shuttle/escape)
"Uh" = (
/obj/structure/fans/tiny/invisible,
/obj/item/ammo_casing/shotgun/buckshot/halflife,
/obj/structure/chair/sofa/hl13bench{
	dir = 8
	},
/turf/open/floor/plating/indoor/metal/plate,
/area/shuttle/escape)
"VQ" = (
/obj/structure/broken_flooring/plating/directional/east,
/turf/template_noop,
/area/template_noop)
"Wr" = (
/obj/structure/lattice/catwalk/hl13,
/obj/effect/mob_spawn/corpse/human/skeleton,
/obj/machinery/light/small/directional/east,
/turf/open/floor/plating/indoor/metal/plate,
/area/shuttle/escape)
"WP" = (
/obj/structure/fans/tiny/invisible,
/obj/item/stack/sheet/scrap_metal,
/obj/structure/barricade/wooden/solid,
/turf/open/floor/plating/indoor/tile/navy,
/area/shuttle/escape)
"XE" = (
/obj/structure/fans/tiny/invisible,
/obj/item/stack/sheet/scrap_metal,
/obj/structure/barricade/wooden/solid,
/turf/open/floor/plating/indoor/grooved,
/area/shuttle/escape)
"YH" = (
/obj/item/weaponcrafting/frame/usp,
/obj/structure/chair/sofa/hl13bench{
	dir = 4
	},
/obj/machinery/light/small/directional/west,
/turf/open/floor/plating/indoor/metal/plate,
/area/shuttle/escape)
"Ze" = (
/obj/structure/fans/tiny/invisible,
/obj/item/stack/sheet/scrap_metal,
/turf/open/floor/plating/indoor/metal/grate,
/area/shuttle/escape)
"Zk" = (
/obj/structure/lattice/catwalk/hl13,
/obj/structure/fans/tiny/invisible,
/obj/item/stack/sheet/scrap_metal,
/obj/effect/decal/cleanable/glass,
/turf/open/floor/plating/indoor/metal/plate,
/area/shuttle/escape)
"ZZ" = (
/obj/structure/fans/tiny/invisible,
/obj/item/target,
/turf/open/floor/plating/indoor/tile/navy,
/area/shuttle/escape)

(1,1,1) = {"
bj
Gs
Gs
Gs
Gs
Gs
Gs
aB
aB
Gs
Gs
Gs
Gs
Ze
Rv
bj
bj
bj
bj
bj
Gs
Gs
Gs
bj
Gs
Gs
Gs
Gs
Gs
Gs
"}
(2,1,1) = {"
Gs
Gs
yZ
Mn
Gs
Gs
CZ
Be
un
nE
Mc
QL
bX
Be
xF
aB
Rv
Gs
Gs
nb
xQ
YH
XE
bj
bj
bj
fQ
Gs
lZ
Gs
"}
(3,1,1) = {"
Gs
Nc
fO
oW
Gs
Ti
hD
EV
Pd
fc
OK
JJ
oo
tY
Dp
FA
Pw
ic
pZ
pa
gQ
fc
pa
sl
WP
bj
ZZ
Gs
sK
Gs
"}
(4,1,1) = {"
le
qX
rM
fO
dR
fc
hE
FF
dY
lP
zJ
QL
Mc
ts
mv
pa
bj
Wr
lK
pa
pa
pa
RY
eW
Am
st
Am
la
fc
Gs
"}
(5,1,1) = {"
Gs
Jz
Qh
Cg
Gs
Ti
lP
fc
Bn
Du
nN
So
pa
vR
aB
Zk
aB
Gs
FK
pa
bj
pa
pa
gS
dO
xb
Ol
Gs
PV
Gs
"}
(6,1,1) = {"
Gs
Gs
xD
AW
Gs
Gs
gl
Kx
bU
Mu
QL
Sj
Ce
gN
bj
VQ
pn
Ll
Hd
Uh
hz
bj
bj
bj
Cd
Gs
GM
pa
bj
Gs
"}
(7,1,1) = {"
bj
Gs
Gs
Gs
Gs
Gs
Gs
qs
Gs
Gs
Gs
Gs
Gs
bj
bj
bj
bj
bj
bj
Gs
Gs
bj
bj
Gs
Gs
Gs
Gs
bj
bj
bj
"}
