//MAP CONVERTED BY dmm2tgm.py THIS HEADER COMMENT PREVENTS RECONVERSION, DO NOT REMOVE
"am" = (
/obj/structure/table/halflife/no_smooth/metal,
/obj/item/reagent_containers/pill/patch/medkit,
/obj/item/reagent_containers/pill/patch/medkit/vial,
/turf/open/floor/plating/indoor/metal/combine,
/area/shuttle/escape)
"bA" = (
/obj/structure/halflife/barrel/quadruple/yellow,
/turf/open/floor/plating/indoor/metal/industrial,
/area/shuttle/escape)
"dF" = (
/obj/structure/table/halflife/no_smooth/metal,
/obj/item/grenade/syndieminibomb/bouncer,
/obj/item/grenade/spawnergrenade/manhacks,
/obj/item/grenade/spawnergrenade/manhacks,
/obj/item/grenade/spawnergrenade/manhacks,
/turf/open/floor/plating/indoor/metal/combine,
/area/shuttle/escape)
"dU" = (
/obj/structure/halflife/trash/cardboard{
	dir = 4
	},
/turf/open/floor/plating/indoor/metal/industrial,
/area/shuttle/escape)
"fp" = (
/obj/structure/window/fulltile,
/turf/open/floor/plating/indoor/metal/combine,
/area/shuttle/escape)
"fq" = (
/obj/machinery/door/airlock/highsecurity/combine,
/obj/structure/fans/tiny/invisible,
/turf/open/floor/plating/indoor/metal/combine,
/area/shuttle/escape)
"gK" = (
/obj/machinery/light/small/directional/east,
/turf/open/floor/plating/indoor/metal/combine,
/area/shuttle/escape)
"gM" = (
/obj/machinery/door/window/brigdoor/security/cell{
	dir = 4
	},
/obj/structure/chair/comfy/halflife/captain,
/turf/open/floor/plating/indoor/metal/combine,
/area/shuttle/escape)
"ha" = (
/obj/structure/table/halflife/no_smooth/metal,
/obj/item/reagent_containers/pill/patch/medkit,
/obj/item/reagent_containers/pill/patch/medkit/vial,
/obj/machinery/vending/combine_wallmed/directional/east,
/turf/open/floor/plating/indoor/metal/combine,
/area/shuttle/escape)
"hn" = (
/obj/structure/window/reinforced{
	dir = 1
	},
/obj/machinery/power/shuttle_engine/heater,
/turf/open/floor/plating/indoor/metal/plate,
/area/shuttle/escape)
"iy" = (
/obj/machinery/door/window/brigdoor/security/cell{
	dir = 8
	},
/obj/structure/chair/comfy/halflife/captain,
/obj/machinery/light/small/directional/east,
/turf/open/floor/plating/indoor/metal/combine,
/area/shuttle/escape)
"jG" = (
/obj/machinery/combine_recharger{
	pixel_x = -32
	},
/turf/open/floor/plating/indoor/metal/combine,
/area/shuttle/escape)
"kh" = (
/obj/structure/halflife/trash/papers/two,
/turf/open/floor/plating/indoor/metal/industrial,
/area/shuttle/escape)
"ln" = (
/obj/machinery/door/window/brigdoor/security/cell{
	dir = 4
	},
/obj/structure/chair/comfy/halflife/captain{
	dir = 1
	},
/obj/machinery/light/small/directional/west,
/turf/open/floor/plating/indoor/metal/combine,
/area/shuttle/escape)
"lR" = (
/obj/structure/fans/tiny/invisible,
/obj/structure/railing/halflife/solo{
	dir = 8
	},
/turf/open/floor/plating/indoor/metal/grate/border{
	dir = 1
	},
/area/shuttle/escape)
"mr" = (
/obj/machinery/turnstile/brig/halflife/forcefield/civilprotection{
	dir = 4
	},
/turf/open/floor/plating/indoor/metal/combine,
/area/shuttle/escape)
"mO" = (
/obj/machinery/blackbox_recorder,
/turf/open/floor/plating/indoor/metal/combine,
/area/shuttle/escape)
"nl" = (
/obj/machinery/computer/emergency_shuttle,
/turf/open/floor/plating/indoor/metal/combine,
/area/shuttle/escape)
"oN" = (
/obj/structure/window/fulltile,
/obj/structure/fans/tiny/invisible,
/turf/open/indestructible/plating,
/area/shuttle/escape)
"pm" = (
/obj/machinery/porta_turret/combine,
/turf/open/floor/plating/indoor/metal/combine,
/area/shuttle/escape)
"pG" = (
/obj/machinery/door/airlock/highsecurity/combine,
/obj/effect/mapping_helpers/airlock/access/all/security/armory,
/turf/open/floor/plating/indoor/metal/combine,
/area/shuttle/escape)
"ri" = (
/obj/structure/chair/comfy/halflife/captain{
	dir = 4
	},
/turf/open/floor/plating/indoor/metal/combine,
/area/shuttle/escape)
"rq" = (
/turf/open/floor/plating/indoor/metal/combine,
/area/shuttle/escape)
"rI" = (
/obj/item/food/deadmouse/moldy,
/turf/open/floor/plating/indoor/metal/industrial,
/area/shuttle/escape)
"sj" = (
/obj/structure/table/halflife/no_smooth/metal,
/obj/item/storage/box/lethalshot/halflife,
/obj/item/ammo_box/magazine/usp9mm,
/obj/item/ammo_box/magazine/usp9mm,
/obj/item/ammo_box/magazine/mp7,
/turf/open/floor/plating/indoor/metal/combine,
/area/shuttle/escape)
"sF" = (
/obj/machinery/vending/combine_wallmed/directional/east,
/obj/machinery/light/small/directional/east,
/turf/open/floor/plating/indoor/metal/combine,
/area/shuttle/escape)
"wm" = (
/obj/structure/chair/comfy/halflife/captain{
	dir = 8
	},
/turf/open/floor/plating/indoor/metal/combine,
/area/shuttle/escape)
"zn" = (
/obj/machinery/turnstile/brig/halflife/forcefield/civilprotection{
	dir = 8
	},
/turf/open/floor/plating/indoor/metal/combine,
/area/shuttle/escape)
"Am" = (
/obj/structure/closet/halflife,
/obj/item/clothing/suit/armor/overwatch,
/obj/item/gun/ballistic/automatic/ar2,
/obj/item/ammo_box/magazine/ar2,
/obj/item/ammo_box/magazine/ar2,
/turf/open/floor/plating/indoor/metal/combine,
/area/shuttle/escape)
"AH" = (
/turf/closed/wall/halflife/metal/strong,
/area/shuttle/escape)
"Bl" = (
/obj/machinery/light/small/directional/east,
/obj/structure/fans/tiny/invisible,
/turf/open/floor/plating/indoor/metal/grate/border{
	dir = 1
	},
/area/shuttle/escape)
"Ek" = (
/obj/structure/chair/comfy/halflife/captain{
	dir = 4
	},
/obj/machinery/light/small/directional/west,
/turf/open/floor/plating/indoor/metal/combine,
/area/shuttle/escape)
"Eo" = (
/obj/structure/fans/tiny/invisible,
/obj/machinery/door/airlock/highsecurity/combine,
/turf/open/floor/plating/indoor/metal/combine,
/area/shuttle/escape)
"ED" = (
/obj/structure/fans/tiny/invisible,
/obj/structure/railing/halflife/solo{
	dir = 4
	},
/turf/open/floor/plating/indoor/metal/grate/border{
	dir = 1
	},
/area/shuttle/escape)
"FB" = (
/turf/open/floor/plating/indoor/metal/industrial,
/area/shuttle/escape)
"Hn" = (
/obj/machinery/light/small/directional/west,
/obj/structure/fans/tiny/invisible,
/turf/open/floor/plating/indoor/metal/grate/border{
	dir = 1
	},
/area/shuttle/escape)
"Id" = (
/obj/structure/halflife/barrel/double/yellow/one,
/turf/open/floor/plating/indoor/metal/industrial,
/area/shuttle/escape)
"Je" = (
/obj/machinery/light/small/directional/east,
/obj/structure/fans/tiny/invisible,
/obj/structure/railing/halflife/solo{
	dir = 8
	},
/turf/open/floor/plating/indoor/metal/grate/border{
	dir = 1
	},
/area/shuttle/escape)
"KJ" = (
/obj/structure/table/halflife/metal,
/obj/item/storage/toolbox/mechanical,
/turf/open/floor/plating/indoor/metal/industrial,
/area/shuttle/escape)
"Ml" = (
/obj/machinery/door/airlock/highsecurity/combine,
/turf/open/floor/plating/indoor/metal/combine,
/area/shuttle/escape)
"NA" = (
/turf/open/floor/plating/indoor/metal,
/area/shuttle/escape)
"NU" = (
/turf/template_noop,
/area/template_noop)
"OV" = (
/obj/machinery/door/window/brigdoor/security/cell{
	dir = 8
	},
/obj/structure/chair/comfy/halflife/captain{
	dir = 1
	},
/turf/open/floor/plating/indoor/metal/combine,
/area/shuttle/escape)
"PS" = (
/obj/machinery/light/small/red/directional/south,
/turf/open/floor/plating/indoor/metal/combine,
/area/shuttle/escape)
"QO" = (
/obj/structure/fans/tiny/invisible,
/obj/machinery/light/small/directional/west,
/turf/open/floor/plating/indoor/metal/grate/border{
	dir = 1
	},
/area/shuttle/escape)
"QY" = (
/obj/structure/fans/tiny/invisible,
/obj/machinery/light/small/directional/east,
/turf/open/floor/plating/indoor/metal/grate/border{
	dir = 1
	},
/area/shuttle/escape)
"Rw" = (
/obj/machinery/combine_recharger{
	pixel_x = -32
	},
/obj/machinery/light/small/directional/west,
/turf/open/floor/plating/indoor/metal/combine,
/area/shuttle/escape)
"RY" = (
/obj/machinery/turnstile/brig/halflife/forcefield/civilprotection/nodirectional,
/turf/open/floor/plating/indoor/metal/combine,
/area/shuttle/escape)
"Se" = (
/obj/structure/chair/comfy/halflife/captain,
/turf/open/floor/plating/indoor/metal/combine,
/area/shuttle/escape)
"Te" = (
/obj/structure/chair/comfy/halflife/captain{
	dir = 8
	},
/obj/machinery/light/small/directional/east,
/turf/open/floor/plating/indoor/metal/combine,
/area/shuttle/escape)
"VF" = (
/obj/structure/fans/tiny/invisible,
/turf/open/floor/plating/indoor/metal/grate/border{
	dir = 1
	},
/area/shuttle/escape)
"WM" = (
/obj/machinery/power/shuttle_engine/propulsion,
/turf/open/floor/plating/indoor/metal/plate,
/area/shuttle/escape)
"Xb" = (
/obj/structure/chair/comfy/halflife/captain{
	dir = 1
	},
/turf/open/floor/plating/indoor/metal/combine,
/area/shuttle/escape)
"Xj" = (
/obj/machinery/light/small/directional/west,
/obj/structure/fans/tiny/invisible,
/obj/structure/railing/halflife/solo{
	dir = 4
	},
/turf/open/floor/plating/indoor/metal/grate/border{
	dir = 1
	},
/area/shuttle/escape)
"Xz" = (
/obj/structure/sign/poster/halflife/combine/three{
	pixel_x = -31
	},
/obj/structure/table/halflife/no_smooth/metal,
/obj/item/restraints/handcuffs{
	pixel_y = 3
	},
/turf/open/floor/plating/indoor/metal/combine,
/area/shuttle/escape)
"Yd" = (
/obj/structure/chair/comfy/halflife/captain,
/obj/machinery/light/small/directional/north,
/turf/open/floor/plating/indoor/metal/combine,
/area/shuttle/escape)
"YR" = (
/obj/structure/lattice/catwalk,
/turf/template_noop,
/area/shuttle/escape)
"Za" = (
/obj/docking_port/mobile/emergency{
	dir = 2;
	name = "Transfer Train";
	preferred_direction = 2;
	port_direction = 2
	},
/turf/closed/wall/halflife/metal/strong,
/area/shuttle/escape)
"ZT" = (
/obj/structure/table/halflife/metal,
/turf/open/floor/plating/indoor/metal/industrial,
/area/shuttle/escape)

(1,1,1) = {"
NU
NU
YR
VF
VF
VF
VF
Bl
VF
VF
VF
VF
VF
lR
lR
Je
VF
lR
lR
Je
VF
lR
lR
QY
lR
lR
QY
AH
fq
AH
AH
AH
NU
NU
"}
(2,1,1) = {"
NU
YR
YR
AH
AH
AH
AH
AH
mr
AH
AH
AH
AH
AH
AH
AH
AH
AH
AH
AH
AH
AH
Ml
AH
fp
AH
AH
AH
rq
Id
bA
AH
hn
WM
"}
(3,1,1) = {"
YR
YR
oN
Xz
Rw
ri
AH
Ek
rq
am
ri
AH
gM
fp
ln
AH
dF
jG
pm
AH
AH
Se
rq
ri
ri
Ek
ri
ri
rq
rI
kh
AH
hn
WM
"}
(4,1,1) = {"
YR
Za
nl
Xb
rq
rq
RY
rq
NA
NA
rq
RY
rq
rq
rq
pG
rq
rq
Am
AH
AH
Yd
rq
rq
rq
rq
rq
rq
rq
rq
PS
AH
hn
WM
"}
(5,1,1) = {"
YR
YR
oN
mO
sF
wm
AH
Te
rq
ha
wm
AH
iy
fp
OV
AH
sj
gK
pm
AH
AH
Se
rq
wm
wm
Te
wm
wm
rq
dU
FB
AH
hn
WM
"}
(6,1,1) = {"
NU
YR
YR
AH
AH
AH
AH
AH
zn
AH
AH
AH
AH
AH
AH
AH
AH
AH
AH
AH
AH
AH
Ml
AH
fp
AH
AH
AH
rq
KJ
ZT
AH
hn
WM
"}
(7,1,1) = {"
NU
NU
YR
VF
VF
VF
VF
Hn
VF
VF
VF
VF
VF
ED
ED
Xj
VF
ED
ED
Xj
VF
ED
ED
QO
ED
ED
QO
AH
Eo
AH
AH
AH
NU
NU
"}
