//MAP CONVERTED BY dmm2tgm.py THIS HEADER COMMENT PREVENTS RECONVERSION, DO NOT REMOVE
"aa" = (
/turf/template_noop,
/area/template_noop)
"ar" = (
/obj/structure/table/halflife/metal,
/obj/item/storage/toolbox/mechanical,
/turf/open/floor/plating/indoor/metal/industrial,
/area/shuttle/escape)
"aH" = (
/turf/open/floor/plating/indoor/metal/combine,
/area/shuttle/escape)
"bi" = (
/obj/structure/window/reinforced{
	dir = 1
	},
/obj/machinery/power/shuttle_engine/heater,
/turf/open/floor/plating/indoor/metal/plate,
/area/shuttle/escape)
"bk" = (
/obj/machinery/power/shuttle_engine/propulsion,
/turf/open/floor/plating/indoor/metal/plate,
/area/shuttle/escape)
"bt" = (
/obj/machinery/light/small/directional/west,
/obj/structure/fans/tiny/invisible,
/turf/open/floor/plating/indoor/metal/grate/border{
	dir = 1
	},
/area/shuttle/escape)
"bu" = (
/obj/structure/halflife/trash/cardboard{
	dir = 4
	},
/turf/open/floor/plating/indoor/metal/industrial,
/area/shuttle/escape)
"cg" = (
/obj/machinery/door/window/brigdoor/security/cell{
	dir = 8
	},
/obj/structure/chair/comfy/halflife/captain{
	dir = 8
	},
/mob/living/carbon/human/species/stalker,
/turf/open/floor/plating/indoor/metal/combine,
/area/shuttle/escape)
"cY" = (
/obj/structure/chair/comfy/halflife/captain{
	dir = 1
	},
/turf/open/floor/plating/indoor/metal/combine,
/area/shuttle/escape)
"ey" = (
/obj/structure/fans/tiny/invisible,
/obj/machinery/light/small/directional/west,
/turf/open/floor/plating/indoor/metal/grate/border{
	dir = 1
	},
/area/shuttle/escape)
"fK" = (
/obj/structure/chair/comfy/halflife/captain{
	dir = 8
	},
/obj/effect/decal/remains/xeno,
/turf/open/floor/plating/indoor/metal/combine,
/area/shuttle/escape)
"gi" = (
/obj/structure/fans/tiny/invisible,
/obj/structure/railing/halflife/solo{
	dir = 4
	},
/turf/open/floor/plating/indoor/metal/grate/border{
	dir = 1
	},
/area/shuttle/escape)
"gn" = (
/obj/machinery/door/window/brigdoor/security/cell{
	dir = 4
	},
/turf/open/floor/plating/indoor/metal/combine,
/area/shuttle/escape)
"hC" = (
/obj/structure/table/halflife/metal,
/turf/open/floor/plating/indoor/metal/industrial,
/area/shuttle/escape)
"iU" = (
/turf/open/floor/plating/indoor/metal,
/area/shuttle/escape)
"ja" = (
/obj/machinery/stalker_chamber,
/obj/machinery/door/window/brigdoor/security/cell{
	dir = 4
	},
/turf/open/floor/plating/indoor/metal/combine,
/area/shuttle/escape)
"kq" = (
/obj/machinery/light/small/red/directional/south,
/turf/open/floor/plating/indoor/metal/combine,
/area/shuttle/escape)
"kD" = (
/obj/docking_port/mobile/emergency{
	dir = 2;
	name = "Transfer Train";
	preferred_direction = 2;
	port_direction = 2
	},
/turf/closed/wall/halflife/metal,
/area/shuttle/escape)
"lJ" = (
/turf/closed/wall/halflife/metal,
/area/shuttle/escape)
"mb" = (
/obj/structure/fans/tiny/invisible,
/turf/open/floor/plating/indoor/metal/grate/border{
	dir = 1
	},
/area/shuttle/escape)
"mF" = (
/obj/machinery/light/small/directional/west,
/obj/structure/fans/tiny/invisible,
/obj/structure/railing/halflife/solo{
	dir = 4
	},
/turf/open/floor/plating/indoor/metal/grate/border{
	dir = 1
	},
/area/shuttle/escape)
"mG" = (
/obj/structure/fans/tiny/invisible,
/obj/structure/railing/halflife/solo{
	dir = 8
	},
/turf/open/floor/plating/indoor/metal/grate/border{
	dir = 1
	},
/area/shuttle/escape)
"mW" = (
/obj/structure/halflife/barrel/quadruple/yellow,
/turf/open/floor/plating/indoor/metal/industrial,
/area/shuttle/escape)
"os" = (
/obj/structure/chair/comfy/halflife/captain{
	dir = 4
	},
/obj/machinery/light/small/directional/west,
/turf/open/floor/plating/indoor/metal/combine,
/area/shuttle/escape)
"oQ" = (
/obj/machinery/vending/combine_wallmed/directional/east,
/obj/machinery/light/small/directional/east,
/turf/open/floor/plating/indoor/metal/combine,
/area/shuttle/escape)
"rw" = (
/obj/structure/halflife/barrel/double/yellow/one,
/turf/open/floor/plating/indoor/metal/industrial,
/area/shuttle/escape)
"sh" = (
/turf/open/floor/plating/indoor/metal/industrial,
/area/shuttle/escape)
"sG" = (
/obj/structure/window/fulltile,
/obj/structure/fans/tiny/invisible,
/turf/open/indestructible/plating,
/area/shuttle/escape)
"tA" = (
/obj/machinery/door/window/brigdoor/security/cell{
	dir = 8
	},
/turf/open/floor/plating/indoor/metal/combine,
/area/shuttle/escape)
"tP" = (
/obj/effect/decal/cleanable/glass,
/obj/effect/decal/cleanable/blood/footprints,
/turf/open/floor/plating/indoor/metal/combine,
/area/shuttle/escape)
"us" = (
/obj/structure/fans/tiny/invisible,
/obj/machinery/light/small/directional/east,
/turf/open/floor/plating/indoor/metal/grate/border{
	dir = 1
	},
/area/shuttle/escape)
"uZ" = (
/obj/machinery/door/window/brigdoor/security/cell{
	dir = 4
	},
/obj/structure/chair/comfy/halflife/captain{
	dir = 4
	},
/turf/open/floor/plating/indoor/metal/combine,
/area/shuttle/escape)
"vx" = (
/obj/machinery/stasis{
	dir = 4
	},
/obj/effect/decal/remains/xeno,
/turf/open/floor/plating/indoor/metal/combine,
/area/shuttle/escape)
"vL" = (
/obj/machinery/turnstile/brig/halflife/forcefield/civilprotection{
	dir = 8
	},
/turf/open/floor/plating/indoor/metal/combine,
/area/shuttle/escape)
"AQ" = (
/obj/structure/chair/comfy/halflife/captain{
	dir = 8
	},
/turf/open/floor/plating/indoor/metal/combine,
/area/shuttle/escape)
"Dv" = (
/obj/machinery/combine_recharger{
	pixel_x = -32
	},
/obj/machinery/light/small/directional/west,
/turf/open/floor/plating/indoor/metal/combine,
/area/shuttle/escape)
"Ek" = (
/obj/effect/decal/cleanable/blood/footprints{
	dir = 4
	},
/turf/open/floor/plating/indoor/metal/combine,
/area/shuttle/escape)
"Fg" = (
/obj/structure/chair/comfy/halflife/captain{
	dir = 4
	},
/obj/item/bodypart/head/stalker,
/turf/open/floor/plating/indoor/metal/combine,
/area/shuttle/escape)
"Fx" = (
/obj/structure/chair/comfy/halflife/captain{
	dir = 4
	},
/obj/item/bodypart/leg/left/stalker,
/turf/open/floor/plating/indoor/metal/combine,
/area/shuttle/escape)
"GQ" = (
/obj/machinery/turnstile/brig/halflife/forcefield/civilprotection{
	dir = 4
	},
/turf/open/floor/plating/indoor/metal/combine,
/area/shuttle/escape)
"HH" = (
/obj/machinery/blackbox_recorder,
/turf/open/floor/plating/indoor/metal/combine,
/area/shuttle/escape)
"HP" = (
/obj/structure/lattice/catwalk,
/turf/template_noop,
/area/shuttle/escape)
"HR" = (
/obj/machinery/computer/emergency_shuttle,
/turf/open/floor/plating/indoor/metal/combine,
/area/shuttle/escape)
"IG" = (
/obj/structure/chair/comfy/halflife/captain{
	dir = 4
	},
/turf/open/floor/plating/indoor/metal/combine,
/area/shuttle/escape)
"Kv" = (
/obj/structure/halflife/trash/papers/two,
/turf/open/floor/plating/indoor/metal/industrial,
/area/shuttle/escape)
"Mv" = (
/obj/item/food/deadmouse/moldy,
/turf/open/floor/plating/indoor/metal/industrial,
/area/shuttle/escape)
"NY" = (
/obj/effect/turf_decal/box/red,
/obj/item/storage/briefcase,
/turf/open/floor/plating/indoor/metal/combine,
/area/shuttle/escape)
"Px" = (
/obj/machinery/stalker_chamber,
/obj/machinery/door/window/brigdoor/security/cell{
	dir = 8
	},
/turf/open/floor/plating/indoor/metal/combine,
/area/shuttle/escape)
"PF" = (
/obj/machinery/stasis,
/turf/open/floor/plating/indoor/metal/combine,
/area/shuttle/escape)
"QN" = (
/obj/effect/decal/cleanable/blood/footprints,
/obj/effect/decal/cleanable/blood/footprints{
	dir = 4
	},
/turf/open/floor/plating/indoor/metal/combine,
/area/shuttle/escape)
"TC" = (
/obj/machinery/light/small/directional/east,
/obj/structure/fans/tiny/invisible,
/obj/structure/railing/halflife/solo{
	dir = 8
	},
/turf/open/floor/plating/indoor/metal/grate/border{
	dir = 1
	},
/area/shuttle/escape)
"Ue" = (
/obj/machinery/light/small/directional/east,
/obj/structure/fans/tiny/invisible,
/turf/open/floor/plating/indoor/metal/grate/border{
	dir = 1
	},
/area/shuttle/escape)
"Wb" = (
/obj/structure/sign/poster/halflife/combine/three{
	pixel_x = -31
	},
/obj/structure/table/halflife/no_smooth/metal,
/obj/item/restraints/handcuffs{
	pixel_y = 3
	},
/turf/open/floor/plating/indoor/metal/combine,
/area/shuttle/escape)
"YE" = (
/obj/structure/chair/comfy/halflife/captain{
	dir = 8
	},
/obj/machinery/light/small/directional/east,
/turf/open/floor/plating/indoor/metal/combine,
/area/shuttle/escape)

(1,1,1) = {"
aa
aa
HP
mb
mb
mb
mb
Ue
mb
mb
mb
mG
mG
TC
mb
mG
mG
TC
mb
mG
mG
us
mG
mG
mb
us
mb
lJ
lJ
lJ
aa
aa
"}
(2,1,1) = {"
aa
HP
HP
lJ
lJ
lJ
lJ
lJ
GQ
lJ
Px
lJ
tA
lJ
tA
lJ
tA
lJ
tA
lJ
tA
lJ
tA
lJ
cg
lJ
aH
rw
mW
lJ
bi
bk
"}
(3,1,1) = {"
HP
HP
sG
Wb
Dv
IG
IG
os
aH
lJ
lJ
lJ
PF
lJ
AQ
lJ
AQ
lJ
fK
lJ
AQ
lJ
AQ
lJ
lJ
lJ
aH
Mv
Kv
lJ
bi
bk
"}
(4,1,1) = {"
HP
kD
HR
cY
aH
iU
iU
iU
aH
cY
lJ
lJ
lJ
lJ
lJ
lJ
lJ
lJ
lJ
lJ
lJ
lJ
lJ
lJ
NY
tP
QN
aH
kq
lJ
bi
bk
"}
(5,1,1) = {"
HP
HP
sG
HH
oQ
AQ
AQ
YE
aH
lJ
lJ
lJ
vx
lJ
IG
lJ
Fg
lJ
Fx
lJ
IG
lJ
IG
lJ
lJ
lJ
Ek
bu
sh
lJ
bi
bk
"}
(6,1,1) = {"
aa
HP
HP
lJ
lJ
lJ
lJ
lJ
vL
lJ
ja
lJ
gn
lJ
gn
lJ
gn
lJ
gn
lJ
gn
lJ
gn
lJ
uZ
lJ
aH
ar
hC
lJ
bi
bk
"}
(7,1,1) = {"
aa
aa
HP
mb
mb
mb
mb
bt
mb
mb
mb
gi
gi
mF
mb
gi
gi
mF
mb
gi
gi
ey
gi
gi
mb
ey
mb
lJ
lJ
lJ
aa
aa
"}
