//MAP CONVERTED BY dmm2tgm.py THIS HEADER COMMENT PREVENTS RECONVERSION, DO NOT REMOVE
"ae" = (
/obj/structure/table/halflife/no_smooth/metal,
/obj/item/reagent_containers/pill/patch/medkit,
/turf/open/floor/plating/indoor/checkered,
/area/shuttle/escape)
"bX" = (
/turf/closed/wall/halflife/metal/strong,
/area/shuttle/escape)
"cd" = (
/turf/open/floor/plating/indoor/tile/black,
/area/shuttle/escape)
"cq" = (
/obj/structure/chair/comfy/halflife/diner{
	dir = 4
	},
/turf/open/floor/plating/indoor/checkered,
/area/shuttle/escape)
"cM" = (
/obj/machinery/door/unpowered/halflife/seethrough/metal{
	dir = 8
	},
/obj/structure/fans/tiny/invisible,
/turf/open/floor/plating/indoor/checkered,
/area/shuttle/escape)
"eN" = (
/obj/structure/chair/comfy/halflife/diner{
	dir = 8
	},
/obj/machinery/light/small{
	dir = 4
	},
/turf/open/floor/plating/indoor/checkered,
/area/shuttle/escape)
"eO" = (
/obj/machinery/computer/crew{
	dir = 8
	},
/turf/open/floor/plating/indoor/checkered,
/area/shuttle/escape)
"fd" = (
/obj/machinery/light/small/directional/west,
/obj/structure/chair/comfy/halflife/diner{
	dir = 4
	},
/turf/open/floor/plating/indoor/checkered,
/area/shuttle/escape)
"fV" = (
/obj/structure/chair/comfy/halflife/captain{
	dir = 4
	},
/turf/open/floor/plating/indoor/woodc/fancy,
/area/shuttle/escape)
"gL" = (
/obj/structure/table/halflife/no_smooth/metal,
/obj/item/reagent_containers/cup/soda_cans/breenwater/red,
/turf/open/floor/plating/indoor/checkered,
/area/shuttle/escape)
"hG" = (
/obj/structure/chair/comfy/halflife/captain{
	dir = 1
	},
/turf/open/floor/plating/indoor/checkered,
/area/shuttle/escape)
"iH" = (
/obj/machinery/vending/rationvendor,
/turf/closed/wall/halflife/metal/strong,
/area/shuttle/escape)
"iY" = (
/turf/open/floor/plating/indoor/checkered,
/area/shuttle/escape)
"jB" = (
/obj/structure/table/halflife/no_smooth/metal,
/obj/machinery/light/small{
	dir = 8
	},
/obj/item/food/flavorbar,
/turf/open/floor/plating/indoor/checkered,
/area/shuttle/escape)
"lH" = (
/obj/structure/table/halflife/no_smooth/metal,
/obj/item/reagent_containers/pill/patch/medkit,
/obj/item/reagent_containers/syringe/syriniver,
/obj/machinery/light/small/directional/west,
/turf/open/floor/plating/indoor/sterilesquares,
/area/shuttle/escape)
"mN" = (
/obj/machinery/light/small/directional/west,
/obj/structure/halflife/storage/shelf,
/turf/open/floor/plating/indoor/metal/grate,
/area/shuttle/escape)
"ns" = (
/obj/structure/table/halflife/metal,
/obj/item/restraints/handcuffs{
	pixel_y = 3
	},
/obj/structure/halflife/rug/red{
	dir = 4
	},
/turf/open/floor/plating/indoor/checkered,
/area/shuttle/escape)
"nM" = (
/obj/machinery/computer/emergency_shuttle{
	dir = 4
	},
/turf/open/floor/plating/indoor/checkered,
/area/shuttle/escape)
"qb" = (
/obj/structure/table/halflife/no_smooth/metal,
/obj/machinery/light/small{
	dir = 4
	},
/turf/open/floor/plating/indoor/checkered,
/area/shuttle/escape)
"qc" = (
/obj/structure/chair/comfy/halflife/captain{
	dir = 4
	},
/obj/structure/halflife/rug/red{
	dir = 4
	},
/turf/open/floor/plating/indoor/woodc/fancy,
/area/shuttle/escape)
"qA" = (
/obj/machinery/door/unpowered/halflife/metal,
/turf/open/floor/plating/indoor/metal/grate/border,
/area/shuttle/escape)
"qK" = (
/obj/structure/closet/crate/halflife,
/turf/open/floor/plating/indoor/metal/grate,
/area/shuttle/escape)
"rf" = (
/obj/structure/table/halflife/no_smooth/metal,
/obj/item/food/flavorbar,
/turf/open/floor/plating/indoor/checkered,
/area/shuttle/escape)
"sK" = (
/obj/structure/table/halflife/no_smooth/metal,
/obj/machinery/camera/autoname{
	dir = 8
	},
/turf/open/floor/plating/indoor/checkered,
/area/shuttle/escape)
"uy" = (
/obj/structure/table/halflife/no_smooth/metal,
/obj/item/reagent_containers/cup/soda_cans/breenwater/green{
	pixel_y = 5
	},
/turf/open/floor/plating/indoor/checkered,
/area/shuttle/escape)
"uz" = (
/obj/structure/chair/comfy/halflife/diner{
	dir = 8
	},
/obj/machinery/light/small/directional/east,
/turf/open/floor/plating/indoor/checkered,
/area/shuttle/escape)
"uL" = (
/obj/structure/chair/comfy/halflife/diner{
	dir = 1
	},
/turf/open/floor/plating/indoor/checkered,
/area/shuttle/escape)
"xz" = (
/obj/structure/chair/comfy/halflife/diner{
	dir = 8
	},
/turf/open/floor/plating/indoor/checkered,
/area/shuttle/escape)
"zl" = (
/obj/structure/table/halflife/no_smooth/metal,
/obj/machinery/camera/autoname{
	dir = 4
	},
/obj/item/ammo_box/magazine/usp9mm,
/turf/open/floor/plating/indoor/checkered,
/area/shuttle/escape)
"AL" = (
/obj/structure/chair/comfy/halflife/diner{
	dir = 4
	},
/obj/machinery/light/small{
	dir = 8
	},
/turf/open/floor/plating/indoor/checkered,
/area/shuttle/escape)
"CP" = (
/obj/machinery/door/unpowered/halflife/metal,
/turf/open/floor/plating/indoor/metal/plate,
/area/shuttle/escape)
"DO" = (
/obj/structure/chair/halflife/metal/blue{
	dir = 8
	},
/turf/open/floor/plating/indoor/tile/navy,
/area/shuttle/escape)
"EI" = (
/obj/structure/chair/comfy/halflife/diner,
/turf/open/floor/plating/indoor/checkered,
/area/shuttle/escape)
"EU" = (
/obj/structure/table/halflife/no_smooth/metal,
/obj/machinery/light/small{
	dir = 8
	},
/turf/open/floor/plating/indoor/checkered,
/area/shuttle/escape)
"Fp" = (
/obj/structure/table/halflife/no_smooth/metal,
/obj/machinery/light/small{
	dir = 4
	},
/obj/item/food/flavorbar/large,
/turf/open/floor/plating/indoor/checkered,
/area/shuttle/escape)
"GL" = (
/obj/machinery/vending/combine_wallmed/directional/west,
/turf/open/floor/plating/indoor/sterilesquares,
/area/shuttle/escape)
"Iv" = (
/obj/structure/window/reinforced{
	dir = 4
	},
/turf/open/floor/plating/indoor/sterilesquares,
/area/shuttle/escape)
"IR" = (
/turf/open/floor/plating/indoor/tile/navy,
/area/shuttle/escape)
"Kh" = (
/obj/structure/extinguisher_cabinet/directional/north,
/turf/open/floor/plating/indoor/tile/black,
/area/shuttle/escape)
"Ki" = (
/obj/structure/chair/comfy/halflife/captain{
	dir = 8
	},
/turf/open/floor/plating/indoor/woodc/fancy,
/area/shuttle/escape)
"Lf" = (
/obj/structure/bed/halflife/bedframe/wire,
/obj/structure/bed/halflife/mattress/stained,
/turf/open/floor/plating/indoor/sterilesquares,
/area/shuttle/escape)
"LW" = (
/turf/open/floor/plating/indoor/sterilesquares,
/area/shuttle/escape)
"Mb" = (
/obj/machinery/power/shuttle_engine/propulsion,
/turf/open/floor/plating/indoor/metal/plate,
/area/shuttle/escape)
"MO" = (
/obj/structure/table/halflife/metal,
/obj/item/storage/box/halflife/bestration,
/turf/open/floor/plating/indoor/checkered,
/area/shuttle/escape)
"MR" = (
/obj/machinery/vending/breenwater,
/turf/open/floor/plating/indoor/checkered,
/area/shuttle/escape)
"Ow" = (
/obj/machinery/turnstile/brig/halflife/forcefield{
	dir = 1
	},
/turf/open/floor/plating/indoor/tile/black,
/area/shuttle/escape)
"OE" = (
/obj/machinery/light/small/directional/east,
/turf/open/floor/plating/indoor/metal/grate,
/area/shuttle/escape)
"QK" = (
/obj/machinery/light/small/directional/east,
/obj/structure/chair/halflife/metal/blue{
	dir = 8
	},
/turf/open/floor/plating/indoor/tile/navy,
/area/shuttle/escape)
"Rn" = (
/obj/structure/window/reinforced{
	dir = 1
	},
/obj/machinery/power/shuttle_engine/heater,
/turf/open/floor/plating/indoor/metal/plate,
/area/shuttle/escape)
"Tp" = (
/obj/structure/chair/comfy/halflife/diner{
	dir = 4
	},
/obj/machinery/light/small/directional/west,
/turf/open/floor/plating/indoor/checkered,
/area/shuttle/escape)
"UC" = (
/obj/structure/table/halflife/no_smooth/metal,
/turf/open/floor/plating/indoor/checkered,
/area/shuttle/escape)
"Vh" = (
/obj/structure/table/halflife/no_smooth/metal,
/obj/machinery/camera/autoname{
	dir = 8
	},
/obj/item/reagent_containers/cup/soda_cans/breenwater/purple,
/turf/open/floor/plating/indoor/checkered,
/area/shuttle/escape)
"Wh" = (
/turf/template_noop,
/area/template_noop)
"Wl" = (
/obj/machinery/light/small{
	dir = 8
	},
/obj/structure/table/halflife/metal,
/obj/item/reagent_containers/pill/patch/medkit/vial,
/obj/item/reagent_containers/pill/patch/medkit/vial,
/obj/item/reagent_containers/pill/patch/medkit/vial{
	pixel_x = 8;
	pixel_y = 6
	},
/turf/open/floor/plating/indoor/checkered,
/area/shuttle/escape)
"Xb" = (
/obj/docking_port/mobile/emergency{
	dir = 2;
	name = "Transfer Train";
	preferred_direction = 2;
	port_direction = 2
	},
/turf/closed/wall/halflife/metal/strong,
/area/shuttle/escape)
"Xf" = (
/obj/structure/extinguisher_cabinet/directional/north,
/turf/open/floor/plating/indoor/metal/grate,
/area/shuttle/escape)
"Zb" = (
/turf/open/floor/plating/indoor/metal/grate,
/area/shuttle/escape)
"Zk" = (
/obj/structure/table/halflife/no_smooth/metal,
/obj/item/reagent_containers/pill/patch/medkit,
/obj/machinery/light/small/directional/west,
/turf/open/floor/plating/indoor/sterilesquares,
/area/shuttle/escape)
"Zr" = (
/turf/open/floor/plating/indoor/woodc/fancy,
/area/shuttle/escape)

(1,1,1) = {"
Wh
bX
bX
bX
bX
bX
bX
cM
bX
bX
bX
bX
bX
cM
bX
bX
bX
bX
bX
bX
bX
bX
bX
bX
bX
bX
bX
bX
bX
bX
bX
bX
bX
bX
Wh
"}
(2,1,1) = {"
bX
bX
Wl
ns
MO
bX
EI
iY
AL
UC
cq
jB
cq
iY
fd
bX
Tp
rf
cq
EU
cq
gL
Tp
iY
cd
Zk
Lf
GL
lH
bX
mN
Zb
bX
Rn
Mb
"}
(3,1,1) = {"
bX
zl
Zr
Ki
Ki
bX
Kh
cd
cd
cd
cd
cd
cd
cd
cd
bX
cd
cd
cd
cd
cd
cd
cd
cd
cd
LW
LW
LW
Lf
bX
qK
Zb
bX
Rn
Mb
"}
(4,1,1) = {"
Xb
nM
hG
Zr
Zr
Ow
cd
cd
uL
EI
cd
uL
EI
cd
cd
CP
cd
MR
cd
uL
EI
cd
iH
cd
cd
LW
Iv
Iv
Iv
bX
Xf
Zb
bX
Rn
Mb
"}
(5,1,1) = {"
bX
uy
Zr
qc
fV
bX
cd
cd
cd
cd
cd
cd
cd
cd
cd
bX
cd
cd
cd
cd
cd
cd
cd
cd
cd
IR
IR
IR
IR
qA
Zb
Zb
bX
Rn
Mb
"}
(6,1,1) = {"
bX
bX
Fp
eO
ae
bX
EI
iY
eN
Vh
xz
qb
xz
iY
uz
bX
uz
UC
xz
qb
xz
sK
uz
iY
cd
QK
DO
DO
QK
bX
OE
Zb
bX
Rn
Mb
"}
(7,1,1) = {"
Wh
bX
bX
bX
bX
bX
bX
cM
bX
bX
bX
bX
bX
cM
bX
bX
bX
bX
bX
bX
bX
bX
bX
bX
bX
bX
bX
bX
bX
bX
bX
bX
bX
bX
Wh
"}
