//MAP CONVERTED BY dmm2tgm.py THIS HEADER COMMENT PREVENTS RECONVERSION, DO NOT REMOVE
"af" = (
/obj/machinery/light/small/red/dim/directional/north,
/obj/item/reagent_containers/cup/bottle/welding_fuel{
	pixel_x = 4;
	pixel_y = 24
	},
/turf/open/floor/plating/indoor/metal/industrial,
/area/shuttle/escape)
"bH" = (
/turf/closed/wall/halflife/metal/strong,
/area/shuttle/escape)
"cO" = (
/obj/structure/halflife/large_pipe/ground{
	pixel_x = 0;
	pixel_y = -32;
	dir = 1
	},
/turf/closed/wall/halflife/metal/strong,
/area/shuttle/escape)
"cU" = (
/obj/structure/chair/comfy/halflife/captain{
	dir = 4
	},
/turf/open/floor/plating/indoor/woodc/wide,
/area/shuttle/escape)
"dz" = (
/obj/machinery/door/unpowered/halflife/metal/red{
	dir = 8
	},
/turf/open/floor/plating/indoor/sterilesquares,
/area/shuttle/escape)
"dK" = (
/obj/machinery/light/small/red/directional/west,
/turf/open/floor/plating/indoor/metal/industrial,
/area/shuttle/escape)
"ec" = (
/obj/effect/turf_decal/delivery/white,
/obj/structure/closet/crate/freezer/halflife/blood,
/turf/open/floor/plating/indoor/metal/plate,
/area/shuttle/escape)
"ez" = (
/obj/structure/halflife/fence/vertical/wire/east,
/turf/open/floor/plating/indoor/metal/industrial,
/area/shuttle/escape)
"ff" = (
/obj/item/hl2key{
	lockid = "poland_train_brig";
	name = "cell key";
	desc = "The key to a brig cell.";
	pixel_x = -3;
	pixel_y = 11
	},
/turf/open/floor/plating/indoor/metal/industrial,
/area/shuttle/escape)
"ht" = (
/obj/structure/halflife/fence/wire,
/turf/open/floor/plating/indoor/metal/pipe{
	dir = 1
	},
/area/shuttle/escape)
"hJ" = (
/obj/structure/closet/crate/bin,
/obj/item/hl13_small_flag/combine,
/turf/open/floor/plating/indoor/metal/grate/border/warning{
	dir = 1
	},
/area/shuttle/escape)
"hQ" = (
/obj/machinery/light/small/red/directional/south,
/obj/structure/reagent_dispensers/fueltank/large{
	anchored = 1;
	desc = "A large tank of pre-war fuel mounted to the train's fuel system."
	},
/turf/open/floor/plating/indoor/metal/pipe{
	dir = 1
	},
/area/shuttle/escape)
"iB" = (
/obj/structure/table/halflife/wood,
/obj/item/food/meat_pierogi{
	pixel_x = -4;
	pixel_y = 8
	},
/obj/item/gun/ballistic/automatic/pistol/usp{
	pixel_x = 2;
	pixel_y = 6
	},
/obj/item/ammo_box/magazine/usp9mm{
	pixel_x = 10;
	pixel_y = 1
	},
/obj/item/ammo_box/magazine/usp9mm{
	pixel_x = 5;
	pixel_y = 0
	},
/turf/open/floor/plating/indoor/woodc/wide,
/area/shuttle/escape)
"iO" = (
/obj/structure/chair/halflife/metal/red,
/turf/open/floor/plating/indoor/metal/grate/border/warning{
	dir = 1
	},
/area/shuttle/escape)
"ja" = (
/obj/item/reagent_containers/pill/patch/medkit/vial{
	pixel_x = -11;
	pixel_y = 8
	},
/obj/item/stack/medical/suture{
	pixel_x = 4;
	pixel_y = 9
	},
/turf/open/floor/plating/indoor/sterilesquares,
/area/shuttle/escape)
"kP" = (
/turf/open/floor/plating/indoor/metal/plate,
/area/shuttle/escape)
"lq" = (
/obj/structure/chair/halflife/metal/red{
	dir = 1
	},
/obj/machinery/light/small/directional/south,
/turf/open/floor/plating/indoor/metal/plate,
/area/shuttle/escape)
"lB" = (
/obj/structure/table/halflife/no_smooth/metal,
/obj/machinery/light/small/directional/east,
/turf/open/floor/plating/indoor/metal/plate,
/area/shuttle/escape)
"lF" = (
/obj/machinery/light/small/directional/north,
/obj/item/hl13_small_flag/poland{
	pixel_x = -13;
	pixel_y = 24
	},
/turf/open/floor/plating/indoor/woodc/wide,
/area/shuttle/escape)
"mI" = (
/obj/machinery/light/small/red/directional/north,
/obj/structure/chair/halflife/metal/folding,
/turf/open/floor/plating/indoor/metal/industrial,
/area/shuttle/escape)
"pc" = (
/obj/structure/chair/halflife/metal/red,
/turf/open/floor/plating/indoor/metal/plate,
/area/shuttle/escape)
"pf" = (
/obj/effect/turf_decal/delivery/white,
/obj/structure/table/halflife/no_smooth/large/crafting/workbench,
/turf/open/floor/plating/indoor/metal/industrial,
/area/shuttle/escape)
"pr" = (
/obj/structure/halflife/fence/wire,
/turf/open/floor/plating/indoor/metal/industrial,
/area/shuttle/escape)
"qN" = (
/obj/structure/window/fulltile,
/turf/open/floor/plating/indoor/metal/plate,
/area/shuttle/escape)
"qX" = (
/obj/machinery/door/unpowered/halflife/seethrough/metal{
	dir = 8;
	keylock = 1
	},
/turf/open/floor/plating/indoor/metal/plate,
/area/shuttle/escape)
"ru" = (
/obj/structure/fans/tiny/invisible,
/turf/open/floor/plating/indoor/metal/walkway/corner,
/area/shuttle/escape)
"sk" = (
/obj/machinery/door/poddoor/preopen{
	id = "poland_shuttle_windows"
	},
/obj/structure/barricade/sandbags,
/obj/structure/fans/tiny/invisible,
/obj/effect/decal/cleanable/glass,
/turf/open/floor/plating/indoor/metal/plate,
/area/shuttle/escape)
"tI" = (
/obj/machinery/light/small/red/dim/directional/south,
/obj/structure/closet/halflife,
/obj/item/clothing/mask/gas/hl2/military,
/obj/item/clothing/head/helmet/halflife/military,
/obj/item/clothing/suit/armor/halflife/kevlar,
/obj/item/clothing/under/syndicate/camo,
/obj/item/clothing/shoes/combat,
/turf/open/floor/plating/indoor/metal/industrial,
/area/shuttle/escape)
"tS" = (
/obj/structure/fans/tiny/invisible,
/obj/structure/barricade/sandbags,
/turf/open/floor/plating/indoor/metal/industrial,
/area/shuttle/escape)
"vm" = (
/obj/structure/table/halflife/no_smooth/large/crafting/weaponbench,
/obj/item/stack/sticky_tape/one{
	pixel_x = 15;
	pixel_y = 13
	},
/turf/open/floor/plating/indoor/metal/pipe{
	dir = 1
	},
/area/shuttle/escape)
"wM" = (
/obj/machinery/iv_drip,
/turf/open/floor/plating/indoor/sterilesquares,
/area/shuttle/escape)
"wS" = (
/obj/structure/table/halflife/no_smooth/large/crafting/ammobench,
/obj/item/stack/bulletcasings{
	amount = 15;
	pixel_x = 2;
	pixel_y = 11
	},
/turf/open/floor/plating/indoor/metal/industrial,
/area/shuttle/escape)
"xf" = (
/obj/structure/fans/tiny/invisible,
/obj/structure/halflife/large_pipe/pump,
/turf/open/floor/plating/indoor/metal/grate/border/warning,
/area/shuttle/escape)
"xE" = (
/obj/structure/halflife/large_pipe/intersection_t{
	dir = 4
	},
/turf/open/floor/plating/indoor/metal/grate,
/area/shuttle/escape)
"yy" = (
/obj/structure/chair/halflife/metal/red{
	dir = 1
	},
/turf/open/floor/plating/indoor/metal/grate/border/warning{
	dir = 1
	},
/area/shuttle/escape)
"zg" = (
/obj/structure/barricade/wooden/crude,
/obj/structure/girder,
/turf/open/floor/plating/indoor/metal/grate/border/warning{
	dir = 1
	},
/area/shuttle/escape)
"zN" = (
/turf/open/floor/plating/indoor/metal/industrial,
/area/shuttle/escape)
"Aw" = (
/obj/structure/closet/crate/halflife,
/obj/effect/turf_decal/delivery/white,
/obj/item/stack/sticky_tape/one,
/obj/item/weaponcrafting/receiver,
/obj/item/weaponcrafting/frame/service,
/turf/open/floor/plating/indoor/metal/industrial,
/area/shuttle/escape)
"AQ" = (
/obj/structure/fans/tiny/invisible,
/turf/open/floor/plating/indoor/metal/walkway/corner{
	dir = 1
	},
/area/shuttle/escape)
"Bb" = (
/obj/machinery/computer/emergency_shuttle{
	dir = 4;
	name = "old train console";
	desc = "A console capable of controlling both human and Combine rolling stock and any track switches in the way."
	},
/turf/open/floor/plating/indoor/woodc/wide,
/area/shuttle/escape)
"Bt" = (
/obj/structure/chair/comfy/halflife/captain{
	dir = 1
	},
/turf/open/floor/plating/indoor/woodc/wide,
/area/shuttle/escape)
"Bw" = (
/obj/structure/window/fulltile,
/obj/machinery/door/poddoor/preopen{
	id = "poland_shuttle_windows"
	},
/turf/open/floor/plating/indoor/metal/plate,
/area/shuttle/escape)
"CC" = (
/obj/machinery/door/unpowered/halflife/metal/red,
/turf/open/floor/plating/indoor/woodc/wide,
/area/shuttle/escape)
"FA" = (
/obj/machinery/computer/camera_advanced/syndie{
	dir = 4
	},
/turf/open/floor/plating/indoor/woodc/wide,
/area/shuttle/escape)
"Gv" = (
/obj/effect/turf_decal/delivery/white,
/obj/structure/closet/crate/freezer/halflife,
/obj/item/food/pierogi_ration,
/obj/item/food/pierogi_ration,
/obj/item/food/pierogi_ration,
/obj/item/food/canned/halflife/beans,
/obj/item/food/canned/halflife/beans,
/obj/item/food/canned/halflife/beans,
/obj/item/food/canned/halflife/beans,
/obj/item/food/canned/halflife/crisps,
/obj/item/food/canned/halflife/crisps,
/obj/item/food/canned/halflife/seafood,
/obj/item/food/canned/halflife/seafood,
/obj/item/food/canned/halflife/seafood,
/obj/item/reagent_containers/cup/glass/waterbottle/large,
/obj/item/reagent_containers/cup/glass/waterbottle/large,
/obj/item/reagent_containers/cup/glass/waterbottle/large,
/turf/open/floor/plating/indoor/metal/plate,
/area/shuttle/escape)
"He" = (
/obj/docking_port/mobile/emergency{
	dir = 2;
	name = "Polish Armoured Train";
	preferred_direction = 2;
	port_direction = 2
	},
/obj/structure/fans/tiny/invisible,
/turf/open/floor/plating/indoor/metal/walkway{
	dir = 1
	},
/area/shuttle/escape)
"Ip" = (
/obj/machinery/door/unpowered/halflife/seethrough/fence/wire{
	keylock = 1;
	lockid = "poland_train_brig"
	},
/turf/open/floor/plating/indoor/metal/grate/border/warning{
	dir = 1
	},
/area/shuttle/escape)
"IS" = (
/obj/structure/table/halflife/no_smooth/large/wood/desk{
	dir = 8
	},
/obj/item/weaponcrafting/frame/coltpython{
	pixel_x = 4;
	pixel_y = 3
	},
/turf/open/floor/plating/indoor/woodc/wide,
/area/shuttle/escape)
"JD" = (
/obj/item/ammo_casing/a357/spent{
	pixel_x = -4;
	pixel_y = -9
	},
/obj/item/ammo_casing/a357/spent{
	pixel_x = -8;
	pixel_y = -11
	},
/obj/item/ammo_casing/a357/spent{
	pixel_x = -4;
	pixel_y = -11
	},
/obj/item/ammo_casing/a357/spent{
	pixel_x = -8;
	pixel_y = -9
	},
/obj/item/ammo_casing/a357{
	pixel_x = 2;
	pixel_y = -9
	},
/obj/item/ammo_casing/a357{
	pixel_x = 2;
	pixel_y = -11
	},
/obj/item/paper_bin{
	pixel_x = 2;
	pixel_y = 7
	},
/obj/item/pen{
	pixel_x = 2;
	pixel_y = 8
	},
/turf/open/floor/plating/indoor/woodc/wide,
/area/shuttle/escape)
"Kj" = (
/obj/effect/turf_decal/delivery/white,
/obj/structure/closet/crate/halflife,
/obj/item/storage/toolbox/mechanical,
/obj/item/storage/toolbox/mechanical,
/obj/item/stack/sheet/iron/five,
/turf/open/floor/plating/indoor/metal/industrial,
/area/shuttle/escape)
"Lh" = (
/obj/machinery/door/unpowered/halflife/metal,
/turf/open/floor/plating/indoor/metal/grate/border/warning{
	dir = 1
	},
/area/shuttle/escape)
"Ll" = (
/obj/structure/fans/tiny/invisible,
/turf/open/floor/plating/indoor/metal/walkway{
	dir = 1
	},
/area/shuttle/escape)
"Lm" = (
/turf/open/floor/plating/indoor/metal/pipe{
	dir = 1
	},
/area/shuttle/escape)
"Lx" = (
/turf/open/floor/plating/indoor/metal/grate/border/warning{
	dir = 1
	},
/area/shuttle/escape)
"MX" = (
/obj/item/chair/halflife/metal/folding,
/obj/effect/decal/cleanable/blood/old,
/turf/open/floor/plating/indoor/metal/grate/border/warning{
	dir = 1
	},
/area/shuttle/escape)
"NH" = (
/obj/structure/halflife/fence/corner/wire{
	dir = 8
	},
/turf/open/floor/plating/indoor/metal/industrial,
/area/shuttle/escape)
"NV" = (
/obj/machinery/light/small/red/directional/north,
/obj/structure/halflife/large_pipe/intersection_t{
	dir = 4
	},
/turf/open/floor/plating/indoor/metal/grate,
/area/shuttle/escape)
"NX" = (
/obj/machinery/light/small/directional/west,
/obj/structure/table/halflife/no_smooth/large/metal,
/obj/item/clothing/glasses/hud/health{
	pixel_x = -5;
	pixel_y = 14
	},
/obj/item/healthanalyzer{
	pixel_x = 3;
	pixel_y = 2
	},
/obj/item/reagent_containers/pill/patch/medkit/vial{
	pixel_x = 9;
	pixel_y = 9
	},
/obj/item/reagent_containers/pill/patch/medkit/vial{
	pixel_x = 15;
	pixel_y = 10
	},
/turf/open/floor/plating/indoor/sterilesquares,
/area/shuttle/escape)
"Ov" = (
/turf/open/floor/plating/indoor/woodc/wide,
/area/shuttle/escape)
"OC" = (
/obj/structure/chair/comfy/halflife/diner{
	dir = 8
	},
/turf/open/floor/plating/indoor/metal/plate,
/area/shuttle/escape)
"ON" = (
/obj/structure/closet/halflife/wall/firstaid,
/obj/effect/spawner/random/halflife/loot/heal,
/obj/effect/spawner/random/halflife/loot/heal,
/obj/effect/spawner/random/halflife/loot/heal,
/obj/structure/bed/halflife/bedframe/wire,
/obj/structure/bed/halflife/mattress/stained,
/turf/open/floor/plating/indoor/sterilesquares,
/area/shuttle/escape)
"OZ" = (
/obj/machinery/door/unpowered/halflife/seethrough/metal{
	dir = 8
	},
/obj/structure/fans/tiny/invisible,
/turf/open/floor/plating/indoor/metal/plate,
/area/shuttle/escape)
"QD" = (
/obj/machinery/door/unpowered/halflife/seethrough/metal{
	dir = 8;
	keylock = 1
	},
/turf/open/floor/plating/indoor/metal/industrial,
/area/shuttle/escape)
"RK" = (
/obj/structure/closet/halflife,
/obj/item/storage/belt/civilprotection/polish_resistance/ak,
/obj/item/gun/ballistic/automatic/ak47,
/turf/open/floor/plating/indoor/metal/industrial,
/area/shuttle/escape)
"RR" = (
/obj/effect/decal/cleanable/blood/old,
/turf/open/floor/plating/indoor/metal/pipe{
	dir = 1
	},
/area/shuttle/escape)
"SZ" = (
/obj/structure/chair/halflife/metal/red{
	dir = 1
	},
/turf/open/floor/plating/indoor/metal/plate,
/area/shuttle/escape)
"Tl" = (
/obj/machinery/light/small/directional/north,
/obj/machinery/button/door{
	id = "poland_shuttle_windows";
	name = "Viewing Port Blast Doors";
	pixel_x = -7;
	pixel_y = 2
	},
/obj/structure/table/halflife/no_smooth/wood,
/obj/machinery/recharger{
	pixel_y = 3;
	pixel_x = 4
	},
/turf/open/floor/plating/indoor/woodc/wide,
/area/shuttle/escape)
"Up" = (
/obj/machinery/light/small/directional/west,
/turf/open/floor/plating/indoor/metal/grate/border/warning{
	dir = 1
	},
/area/shuttle/escape)
"UD" = (
/turf/open/floor/plating/indoor/sterilesquares,
/area/shuttle/escape)
"UT" = (
/turf/template_noop,
/area/template_noop)
"Va" = (
/obj/structure/chair/comfy/halflife/captain{
	dir = 8
	},
/turf/open/floor/plating/indoor/woodc/wide,
/area/shuttle/escape)
"Vc" = (
/obj/structure/halflife/large_pipe/pump,
/turf/open/floor/plating/indoor/metal/pipe/intersection{
	dir = 1
	},
/area/shuttle/escape)
"VC" = (
/obj/structure/window/fulltile,
/obj/machinery/door/poddoor/preopen{
	id = "poland_shuttle_windows"
	},
/obj/structure/fans/tiny/invisible,
/turf/open/floor/plating/indoor/metal/plate,
/area/shuttle/escape)
"Wc" = (
/obj/item/hl13_small_flag/poland{
	pixel_x = 6;
	pixel_y = 2
	},
/turf/open/floor/plating/indoor/metal/plate,
/area/shuttle/escape)
"WJ" = (
/obj/structure/fans/tiny/invisible,
/obj/machinery/light/blacklight/directional/south{
	bulb_colour = "#ff0000";
	nightshift_light_color = "#ff0000"
	},
/turf/open/floor/plating/indoor/metal/walkway/end,
/area/shuttle/escape)
"Xq" = (
/obj/structure/fans/tiny/invisible,
/obj/machinery/light/directional/south,
/turf/open/floor/plating/indoor/metal/walkway/end,
/area/shuttle/escape)
"Yc" = (
/obj/machinery/light/small/directional/east,
/obj/structure/table/halflife/no_smooth/metal,
/turf/open/floor/plating/indoor/metal/plate,
/area/shuttle/escape)
"ZU" = (
/obj/effect/turf_decal/delivery/white,
/turf/open/floor/plating/indoor/metal/industrial,
/area/shuttle/escape)

(1,1,1) = {"
ru
WJ
bH
VC
bH
bH
sk
bH
OZ
bH
VC
bH
OZ
bH
VC
bH
bH
bH
sk
bH
bH
bH
sk
bH
bH
bH
VC
bH
cO
UT
"}
(2,1,1) = {"
Ll
bH
bH
iB
FA
bH
Lx
Lx
Lx
Lx
Lx
Lx
Lx
Lx
Lx
Lx
Up
Lx
Lx
Lx
Lh
Lx
Lx
Lx
dK
zN
Kj
bH
xf
tS
"}
(3,1,1) = {"
Ll
bH
lF
Ov
Va
qN
kP
kP
OC
Yc
kP
OC
lB
OC
kP
Wc
bH
bH
qX
bH
bH
ez
ez
NH
zN
zN
Aw
bH
xE
bH
"}
(4,1,1) = {"
He
Bw
Bb
Bt
Ov
CC
kP
Gv
bH
bH
dz
bH
bH
bH
QD
bH
bH
pc
kP
SZ
bH
Lm
RR
ht
vm
Lm
hQ
bH
Vc
tS
"}
(5,1,1) = {"
Ll
bH
Tl
Ov
cU
qN
kP
ec
bH
ON
UD
NX
bH
wS
zN
tI
bH
pc
kP
lq
bH
mI
zN
pr
ff
zN
pf
bH
NV
bH
"}
(6,1,1) = {"
Ll
bH
bH
JD
IS
bH
Lx
hJ
bH
wM
UD
ja
bH
af
zN
RK
bH
iO
Lx
yy
bH
MX
Lx
Ip
zN
zN
ZU
zg
xf
tS
"}
(7,1,1) = {"
AQ
Xq
bH
VC
bH
bH
sk
bH
bH
bH
VC
bH
bH
bH
sk
bH
bH
bH
VC
bH
bH
bH
VC
bH
bH
bH
sk
bH
cO
UT
"}
