//MAP CONVERTED BY dmm2tgm.py THIS HEADER COMMENT PREVENTS RECONVERSION, DO NOT REMOVE
"aF" = (
/obj/machinery/light/small,
/obj/structure/halflife/trash/papers/three,
/turf/open/floor/plating/indoor/metal/plate,
/area/shuttle/escape)
"bA" = (
/turf/open/floor/plating/indoor/metal/pipe{
	dir = 1
	},
/area/shuttle/escape)
"bQ" = (
/obj/structure/railing/halflife/wood/single,
/obj/structure/halflife/trash/cardboard{
	dir = 4
	},
/turf/open/floor/plating/indoor/metal/pipe{
	dir = 1
	},
/area/shuttle/escape)
"cm" = (
/obj/structure/halflife/trash/papers/three{
	dir = 1
	},
/turf/open/floor/plating/indoor/metal/pipe{
	dir = 1
	},
/area/shuttle/escape)
"dm" = (
/obj/structure/railing/halflife/wood/single,
/turf/open/floor/plating/indoor/metal/pipe{
	dir = 1
	},
/area/shuttle/escape)
"dJ" = (
/obj/structure/chair/halflife/overlaypickup/plastic{
	dir = 8
	},
/turf/open/floor/plating/indoor/metal/plate,
/area/shuttle/escape)
"fj" = (
/obj/structure/halflife/trash/glass/plate,
/turf/open/floor/plating/indoor/metal/plate,
/area/shuttle/escape)
"hI" = (
/turf/template_noop,
/area/template_noop)
"iq" = (
/obj/structure/fans/tiny/invisible,
/turf/open/floor/plating/indoor/metal/plate,
/area/shuttle/escape)
"jE" = (
/turf/open/floor/plating/indoor/metal/plate,
/area/shuttle/escape)
"kV" = (
/obj/structure/railing/halflife/wood/single{
	dir = 1
	},
/turf/open/floor/plating/indoor/metal/pipe{
	dir = 1
	},
/area/shuttle/escape)
"mq" = (
/obj/item/chair/halflife/metal/broken,
/turf/open/floor/plating/indoor/metal/pipe{
	dir = 1
	},
/area/shuttle/escape)
"oW" = (
/obj/structure/barricade/wooden,
/turf/open/floor/plating/indoor/metal/pipe{
	dir = 1
	},
/area/shuttle/escape)
"oX" = (
/obj/structure/chair/halflife/overlaypickup/plastic{
	dir = 4
	},
/turf/open/floor/plating/indoor/metal/pipe{
	dir = 1
	},
/area/shuttle/escape)
"pg" = (
/obj/item/chair/halflife/plastic{
	dir = 1
	},
/turf/open/floor/plating/indoor/metal/pipe{
	dir = 1
	},
/area/shuttle/escape)
"pn" = (
/obj/structure/halflife/trash/papers/three{
	dir = 4
	},
/turf/open/floor/plating/indoor/metal/plate,
/area/shuttle/escape)
"pO" = (
/obj/structure/halflife/trash/garbage,
/turf/open/floor/plating/indoor/metal/plate,
/area/shuttle/escape)
"pU" = (
/obj/structure/table/halflife/no_smooth/metal,
/obj/machinery/camera/autoname{
	dir = 4
	},
/obj/structure/halflife/trash/wood,
/obj/structure/halflife/trash/glass/basic,
/turf/open/floor/plating/indoor/metal/plate,
/area/shuttle/escape)
"pZ" = (
/obj/effect/turf_decal/caution{
	dir = 1
	},
/turf/open/floor/plating/indoor/metal/grate/border/warning,
/area/shuttle/escape)
"qQ" = (
/turf/closed/wall/halflife/metal,
/area/shuttle/escape)
"rx" = (
/obj/machinery/door/unpowered/halflife/seethrough/metal{
	dir = 8
	},
/obj/structure/fans/tiny/invisible,
/turf/open/floor/plating/indoor/metal/plate,
/area/shuttle/escape)
"sd" = (
/obj/structure/railing/halflife/wood/single,
/turf/open/floor/plating/indoor/metal/plate,
/area/shuttle/escape)
"sC" = (
/mob/living/simple_animal/hostile/halflife/headcrab,
/turf/open/floor/plating/indoor/metal/plate,
/area/shuttle/escape)
"tg" = (
/obj/structure/railing/halflife/wood/single{
	dir = 1
	},
/turf/open/floor/plating/indoor/metal/plate,
/area/shuttle/escape)
"tK" = (
/obj/structure/barricade/wooden,
/turf/open/floor/plating/indoor/metal/plate,
/area/shuttle/escape)
"uY" = (
/obj/structure/halflife/trash/garbage,
/turf/open/floor/plating/indoor/metal/grate/border{
	dir = 1
	},
/area/shuttle/escape)
"wE" = (
/obj/item/chair/halflife/metal/folding,
/turf/open/floor/plating/indoor/metal/pipe{
	dir = 1
	},
/area/shuttle/escape)
"yt" = (
/obj/machinery/computer/emergency_shuttle{
	dir = 4
	},
/turf/open/floor/plating/indoor/metal/grate/border{
	dir = 1
	},
/area/shuttle/escape)
"zd" = (
/obj/machinery/power/shuttle_engine/propulsion,
/turf/open/floor/plating/indoor/metal/plate,
/area/shuttle/escape)
"Ae" = (
/obj/structure/halflife/trash/papers/three,
/turf/open/floor/plating/indoor/metal/plate,
/area/shuttle/escape)
"Ak" = (
/obj/item/chair/halflife/metal/blue,
/turf/open/floor/plating/indoor/metal/plate,
/area/shuttle/escape)
"Av" = (
/obj/structure/halflife/trash/papers/two,
/turf/open/floor/plating/indoor/metal/plate,
/area/shuttle/escape)
"BW" = (
/obj/machinery/turnstile/brig/halflife/forcefield{
	dir = 1
	},
/turf/open/floor/plating/indoor/metal/grate/border{
	dir = 1
	},
/area/shuttle/escape)
"Ca" = (
/obj/item/chair/halflife/plastic{
	dir = 1
	},
/turf/open/floor/plating/indoor/metal/plate,
/area/shuttle/escape)
"Cy" = (
/obj/structure/chair/halflife/overlaypickup/plastic,
/turf/open/floor/plating/indoor/metal/plate,
/area/shuttle/escape)
"Fw" = (
/obj/structure/chair/halflife/overlaypickup/plastic{
	dir = 4
	},
/turf/open/floor/plating/indoor/metal/plate,
/area/shuttle/escape)
"FU" = (
/obj/structure/halflife/trash/books/pile_alt,
/turf/open/floor/plating/indoor/metal/grate/border/warning,
/area/shuttle/escape)
"Gc" = (
/obj/structure/chair/halflife/metal/blue/broken{
	dir = 4
	},
/turf/open/floor/plating/indoor/metal/plate,
/area/shuttle/escape)
"Gx" = (
/turf/open/floor/plating/indoor/metal/grate/border/warning,
/area/shuttle/escape)
"Jf" = (
/obj/structure/chair/halflife/overlaypickup/plastic{
	dir = 8
	},
/turf/open/floor/plating/indoor/metal/pipe{
	dir = 1
	},
/area/shuttle/escape)
"Jv" = (
/obj/structure/chair/halflife/overlaypickup/plastic{
	dir = 1
	},
/turf/open/floor/plating/indoor/metal/grate/border{
	dir = 1
	},
/area/shuttle/escape)
"Kq" = (
/obj/item/chair/halflife/plastic,
/turf/open/floor/plating/indoor/metal/plate,
/area/shuttle/escape)
"LE" = (
/obj/item/chair/halflife/plastic{
	dir = 1
	},
/obj/structure/halflife/trash/papers/two{
	dir = 8
	},
/turf/open/floor/plating/indoor/metal/plate,
/area/shuttle/escape)
"Ma" = (
/obj/structure/chair/halflife/metal/broken,
/turf/open/floor/plating/indoor/metal/pipe{
	dir = 1
	},
/area/shuttle/escape)
"Nx" = (
/obj/docking_port/mobile/emergency{
	dir = 2;
	name = "Transfer Train";
	preferred_direction = 2;
	port_direction = 2
	},
/turf/closed/wall/halflife/metal,
/area/shuttle/escape)
"Pz" = (
/obj/item/flashlight/flare{
	start_on = 1;
	icon_state = "flare-on"
	},
/turf/open/floor/plating/indoor/metal/grate/border{
	dir = 1
	},
/area/shuttle/escape)
"PO" = (
/obj/structure/halflife/trash/papers/two{
	dir = 1
	},
/turf/open/floor/plating/indoor/metal/plate,
/area/shuttle/escape)
"PX" = (
/obj/structure/fans/tiny/invisible,
/turf/open/floor/plating/indoor/metal/pipe{
	dir = 1
	},
/area/shuttle/escape)
"RZ" = (
/obj/structure/halflife/trash/glass/cans,
/turf/open/floor/plating/indoor/metal/plate,
/area/shuttle/escape)
"Sg" = (
/obj/structure/halflife/trash/garbage,
/turf/open/floor/plating/indoor/metal/pipe{
	dir = 1
	},
/area/shuttle/escape)
"TI" = (
/turf/open/floor/plating/indoor/metal/grate/border{
	dir = 1
	},
/area/shuttle/escape)
"Xk" = (
/obj/structure/halflife/trash/papers/three{
	dir = 1
	},
/turf/open/floor/plating/indoor/metal/plate,
/area/shuttle/escape)
"YA" = (
/obj/structure/halflife/trash/papers/three{
	dir = 4
	},
/obj/structure/halflife/trash/garbage,
/turf/open/floor/plating/indoor/metal/plate,
/area/shuttle/escape)
"YG" = (
/obj/structure/window/reinforced{
	dir = 1
	},
/obj/machinery/power/shuttle_engine/heater,
/turf/open/floor/plating/indoor/metal/plate,
/area/shuttle/escape)

(1,1,1) = {"
hI
qQ
qQ
qQ
qQ
qQ
qQ
qQ
qQ
qQ
qQ
rx
qQ
qQ
qQ
qQ
qQ
qQ
qQ
qQ
qQ
qQ
qQ
qQ
qQ
qQ
qQ
qQ
qQ
hI
"}
(2,1,1) = {"
qQ
qQ
oX
bA
bQ
mq
bA
Sg
cm
bA
bA
bA
bA
bA
bA
Sg
qQ
qQ
Ma
bA
bA
Gx
bA
kV
pg
bA
oW
qQ
YG
zd
"}
(3,1,1) = {"
qQ
pU
jE
aF
qQ
Fw
Ca
Fw
Fw
jE
Gc
Fw
LE
Fw
Fw
jE
Fw
RZ
jE
Av
Fw
Gx
pO
tg
Xk
tK
sC
qQ
YG
zd
"}
(4,1,1) = {"
Nx
yt
Jv
TI
BW
TI
Pz
TI
TI
uY
TI
Pz
TI
TI
TI
TI
TI
TI
Pz
TI
TI
FU
qQ
qQ
qQ
qQ
YA
qQ
YG
zd
"}
(5,1,1) = {"
qQ
Cy
jE
Ak
qQ
PO
dJ
dJ
dJ
dJ
dJ
dJ
Av
dJ
dJ
dJ
Ae
dJ
dJ
jE
Kq
pZ
sd
pn
fj
qQ
qQ
qQ
YG
zd
"}
(6,1,1) = {"
qQ
qQ
Jf
qQ
qQ
Sg
bA
bA
bA
bA
wE
bA
bA
bA
Sg
bA
bA
bA
bA
bA
bA
pZ
dm
PX
PX
PX
bA
qQ
YG
zd
"}
(7,1,1) = {"
hI
qQ
qQ
qQ
qQ
qQ
qQ
qQ
qQ
qQ
qQ
qQ
qQ
qQ
qQ
qQ
qQ
qQ
qQ
qQ
qQ
qQ
qQ
qQ
hI
iq
iq
qQ
qQ
hI
"}
