//MAP CONVERTED BY dmm2tgm.py THIS HEADER COMMENT PREVENTS RECONVERSION, DO NOT REMOVE
"aa" = (
/turf/template_noop,
/area/template_noop)
"ao" = (
/obj/structure/chair/comfy/halflife/diner{
	dir = 8
	},
/obj/machinery/light/small/directional/east,
/turf/open/floor/plating/indoor/grooved,
/area/shuttle/escape)
"cU" = (
/obj/docking_port/mobile/emergency{
	dir = 2;
	name = "Transfer Train";
	preferred_direction = 2;
	port_direction = 2
	},
/turf/closed/wall/halflife/metal/strong/train,
/area/shuttle/escape)
"cY" = (
/obj/machinery/turnstile/brig/halflife/forcefield{
	dir = 1
	},
/turf/open/floor/plating/indoor/metal/plate,
/area/shuttle/escape)
"dn" = (
/obj/structure/chair/comfy/halflife/diner{
	dir = 4
	},
/turf/open/floor/plating/indoor/grooved,
/area/shuttle/escape)
"fK" = (
/obj/structure/chair/comfy/halflife/diner{
	dir = 8
	},
/turf/open/floor/plating/indoor/grooved,
/area/shuttle/escape)
"gn" = (
/obj/structure/table/halflife/no_smooth/metal,
/obj/machinery/light/small{
	dir = 4
	},
/turf/open/floor/plating/indoor/grooved,
/area/shuttle/escape)
"gD" = (
/obj/structure/chair/comfy/halflife/captain{
	dir = 4
	},
/turf/open/floor/plating/indoor/grooved,
/area/shuttle/escape)
"gX" = (
/obj/structure/halflife/trash/papers/one{
	dir = 8
	},
/turf/open/floor/plating/indoor/metal/plate,
/area/shuttle/escape)
"iY" = (
/obj/structure/halflife/trash/papers/two,
/turf/open/floor/plating/indoor/metal/plate,
/area/shuttle/escape)
"ja" = (
/obj/structure/chair/comfy/halflife/diner{
	dir = 8
	},
/obj/machinery/light/small{
	dir = 4
	},
/turf/open/floor/plating/indoor/grooved,
/area/shuttle/escape)
"kO" = (
/obj/structure/halflife/storage/shelf,
/turf/open/floor/plating/indoor/metal/plate,
/area/shuttle/escape)
"lo" = (
/obj/structure/table/halflife/metal,
/obj/item/restraints/handcuffs{
	pixel_y = 3
	},
/turf/open/floor/plating/indoor/grooved,
/area/shuttle/escape)
"lJ" = (
/turf/closed/wall/halflife/metal/strong/train,
/area/shuttle/escape)
"mW" = (
/obj/structure/closet/crate/halflife,
/turf/open/floor/plating/indoor/metal/plate,
/area/shuttle/escape)
"pe" = (
/obj/structure/halflife/trash/papers/two{
	dir = 1
	},
/turf/open/floor/plating/indoor/metal/plate,
/area/shuttle/escape)
"sG" = (
/obj/machinery/light/small{
	dir = 8
	},
/obj/structure/table/halflife/metal,
/obj/item/reagent_containers/pill/patch/medkit/vial,
/turf/open/floor/plating/indoor/grooved,
/area/shuttle/escape)
"tA" = (
/obj/structure/table/halflife/no_smooth/metal,
/turf/open/floor/plating/indoor/grooved,
/area/shuttle/escape)
"uZ" = (
/obj/structure/table/halflife/no_smooth/metal,
/obj/machinery/camera/autoname{
	dir = 8
	},
/turf/open/floor/plating/indoor/grooved,
/area/shuttle/escape)
"vx" = (
/obj/structure/chair/comfy/halflife/diner{
	dir = 1
	},
/turf/open/floor/plating/indoor/grooved,
/area/shuttle/escape)
"vT" = (
/obj/machinery/light/small/directional/east,
/turf/open/floor/plating/indoor/metal/plate,
/area/shuttle/escape)
"wG" = (
/obj/structure/chair/comfy/halflife/diner,
/obj/machinery/vending/combine_wallmed/directional/north,
/turf/open/floor/plating/indoor/grooved,
/area/shuttle/escape)
"yB" = (
/obj/machinery/computer/crew{
	dir = 8
	},
/turf/open/floor/plating/indoor/grooved,
/area/shuttle/escape)
"zZ" = (
/obj/structure/chair/comfy/halflife/diner{
	dir = 4
	},
/obj/machinery/light/small/directional/west,
/turf/open/floor/plating/indoor/grooved,
/area/shuttle/escape)
"BO" = (
/obj/machinery/light/small/directional/west,
/obj/structure/chair/comfy/halflife/diner{
	dir = 4
	},
/turf/open/floor/plating/indoor/grooved,
/area/shuttle/escape)
"Fx" = (
/obj/structure/table/halflife/no_smooth/metal,
/obj/machinery/light/small{
	dir = 8
	},
/turf/open/floor/plating/indoor/grooved,
/area/shuttle/escape)
"GQ" = (
/obj/structure/table/halflife/metal,
/turf/open/floor/plating/indoor/metal/plate,
/area/shuttle/escape)
"Hg" = (
/obj/structure/chair/comfy/halflife/captain{
	dir = 8
	},
/turf/open/floor/plating/indoor/grooved,
/area/shuttle/escape)
"Hq" = (
/obj/machinery/computer/emergency_shuttle{
	dir = 4
	},
/turf/open/floor/plating/indoor/grooved,
/area/shuttle/escape)
"HH" = (
/turf/open/floor/plating/indoor/metal/plate,
/area/shuttle/escape)
"HR" = (
/obj/structure/chair/comfy/halflife/captain{
	dir = 1
	},
/turf/open/floor/plating/indoor/grooved,
/area/shuttle/escape)
"IE" = (
/obj/structure/table/halflife/metal,
/obj/structure/halflife/trash/glass/basic,
/turf/open/floor/plating/indoor/metal/plate,
/area/shuttle/escape)
"JE" = (
/obj/structure/extinguisher_cabinet/directional/north,
/turf/open/floor/plating/indoor/metal/plate,
/area/shuttle/escape)
"JH" = (
/obj/structure/table/halflife/no_smooth/metal,
/obj/machinery/camera/autoname{
	dir = 4
	},
/turf/open/floor/plating/indoor/grooved,
/area/shuttle/escape)
"Lp" = (
/obj/structure/rack,
/obj/machinery/light/small/directional/west,
/turf/open/floor/plating/indoor/metal/plate,
/area/shuttle/escape)
"Px" = (
/obj/structure/chair/comfy/halflife/diner{
	dir = 4
	},
/obj/machinery/light/small{
	dir = 8
	},
/turf/open/floor/plating/indoor/grooved,
/area/shuttle/escape)
"Rn" = (
/obj/structure/fans/tiny/invisible,
/obj/machinery/door/airlock/highsecurity/combine,
/turf/open/floor/plating/indoor/grooved,
/area/shuttle/escape)
"Vv" = (
/turf/open/floor/plating/indoor/grooved,
/area/shuttle/escape)
"XA" = (
/obj/structure/chair/comfy/halflife/diner,
/obj/structure/extinguisher_cabinet/directional/north,
/turf/open/floor/plating/indoor/grooved,
/area/shuttle/escape)
"Yj" = (
/obj/machinery/door/airlock/highsecurity/combine,
/turf/open/floor/plating/indoor/metal/plate,
/area/shuttle/escape)
"YE" = (
/obj/structure/chair/comfy/halflife/diner,
/turf/open/floor/plating/indoor/grooved,
/area/shuttle/escape)

(1,1,1) = {"
aa
lJ
lJ
lJ
lJ
lJ
lJ
Rn
lJ
lJ
lJ
lJ
lJ
Rn
lJ
lJ
lJ
lJ
lJ
lJ
lJ
lJ
lJ
lJ
lJ
lJ
lJ
lJ
lJ
aa
"}
(2,1,1) = {"
lJ
lJ
sG
lo
lJ
lJ
dn
Vv
Px
tA
dn
Fx
dn
Vv
BO
lJ
zZ
tA
dn
Fx
dn
tA
zZ
lJ
mW
Lp
mW
lJ
lJ
lJ
"}
(3,1,1) = {"
lJ
JH
Vv
Hg
lJ
XA
gX
HH
HH
HH
HH
HH
HH
HH
HH
lJ
HH
HH
iY
HH
HH
HH
HH
lJ
JE
HH
HH
lJ
lJ
lJ
"}
(4,1,1) = {"
cU
Hq
HR
Vv
cY
HH
HH
HH
vx
YE
HH
vx
YE
HH
HH
Yj
HH
HH
HH
vx
YE
HH
HH
Yj
HH
HH
HH
lJ
lJ
lJ
"}
(5,1,1) = {"
lJ
tA
Vv
gD
lJ
wG
HH
HH
HH
pe
HH
HH
HH
HH
HH
lJ
HH
HH
HH
HH
HH
HH
HH
lJ
kO
HH
IE
lJ
lJ
lJ
"}
(6,1,1) = {"
lJ
lJ
gn
yB
lJ
lJ
fK
Vv
ja
uZ
fK
gn
fK
Vv
ao
lJ
ao
tA
fK
gn
fK
uZ
ao
lJ
kO
vT
GQ
lJ
lJ
lJ
"}
(7,1,1) = {"
aa
lJ
lJ
lJ
lJ
lJ
lJ
Rn
lJ
lJ
lJ
lJ
lJ
Rn
lJ
lJ
lJ
lJ
lJ
lJ
lJ
lJ
lJ
lJ
lJ
lJ
lJ
lJ
lJ
aa
"}
