//MAP CONVERTED BY dmm2tgm.py THIS HEADER COMMENT PREVENTS RECONVERSION, DO NOT REMOVE
"aJ" = (
/turf/open/floor/plating/indoor/metal/plate,
/area/shuttle/escape)
"bn" = (
/obj/structure/table/halflife/no_smooth/large/wood/desk{
	dir = 8
	},
/obj/item/weaponcrafting/frame/coltpython{
	pixel_x = 4;
	pixel_y = 3
	},
/turf/open/floor/plating/indoor/woodc/wide,
/area/shuttle/escape)
"bJ" = (
/obj/item/hl13_small_flag/poland{
	pixel_x = 6;
	pixel_y = 2
	},
/turf/open/floor/plating/indoor/metal/plate,
/area/shuttle/escape)
"cH" = (
/obj/structure/chair/comfy/halflife/captain{
	dir = 8
	},
/turf/open/floor/plating/indoor/woodc/wide,
/area/shuttle/escape)
"cI" = (
/obj/structure/halflife/fence/wire,
/turf/open/floor/plating/indoor/metal/industrial,
/area/shuttle/escape)
"cK" = (
/turf/open/floor/plating/indoor/metal/grate/border/warning{
	dir = 1
	},
/area/shuttle/escape)
"cX" = (
/turf/open/floor/plating/indoor/woodc/wide,
/area/shuttle/escape)
"dm" = (
/obj/structure/chair/halflife/metal/red{
	dir = 1
	},
/obj/machinery/light/small/directional/south,
/turf/open/floor/plating/indoor/metal/plate,
/area/shuttle/escape)
"dw" = (
/obj/structure/chair/halflife/metal/red,
/turf/open/floor/plating/indoor/metal/plate,
/area/shuttle/escape)
"eH" = (
/obj/machinery/door/airlock/highsecurity/combine,
/turf/open/floor/plating/indoor/metal/grate/border/warning{
	dir = 1
	},
/area/shuttle/escape)
"eT" = (
/turf/open/floor/plating/indoor/sterilesquares,
/area/shuttle/escape)
"fk" = (
/obj/structure/chair/comfy/halflife/captain{
	dir = 1
	},
/turf/open/floor/plating/indoor/woodc/wide,
/area/shuttle/escape)
"fx" = (
/obj/item/ammo_casing/a357/spent{
	pixel_x = -4;
	pixel_y = -9
	},
/obj/item/ammo_casing/a357/spent{
	pixel_x = -8;
	pixel_y = -11
	},
/obj/item/ammo_casing/a357/spent{
	pixel_x = -4;
	pixel_y = -11
	},
/obj/item/ammo_casing/a357/spent{
	pixel_x = -8;
	pixel_y = -9
	},
/obj/item/ammo_casing/a357{
	pixel_x = 2;
	pixel_y = -9
	},
/obj/item/ammo_casing/a357{
	pixel_x = 2;
	pixel_y = -11
	},
/obj/item/paper_bin{
	pixel_x = 2;
	pixel_y = 7
	},
/obj/item/pen{
	pixel_x = 2;
	pixel_y = 8
	},
/turf/open/floor/plating/indoor/woodc/wide,
/area/shuttle/escape)
"fB" = (
/obj/machinery/door/unpowered/halflife/seethrough/fence/wire{
	keylock = 1;
	lockid = "poland_train_brig"
	},
/turf/open/floor/plating/indoor/metal/grate/border/warning{
	dir = 1
	},
/area/shuttle/escape)
"gt" = (
/obj/machinery/door/airlock/highsecurity/combine,
/turf/open/floor/plating/indoor/metal/plate,
/area/shuttle/escape)
"je" = (
/obj/structure/closet/halflife/wall/firstaid,
/obj/effect/spawner/random/halflife/loot/heal,
/obj/effect/spawner/random/halflife/loot/heal,
/obj/effect/spawner/random/halflife/loot/heal,
/obj/structure/bed/halflife/bedframe/wire,
/obj/structure/bed/halflife/mattress/stained,
/turf/open/floor/plating/indoor/sterilesquares,
/area/shuttle/escape)
"jC" = (
/turf/template_noop,
/area/template_noop)
"jX" = (
/obj/machinery/computer/camera_advanced/syndie{
	dir = 4
	},
/turf/open/floor/plating/indoor/woodc/wide,
/area/shuttle/escape)
"lj" = (
/obj/structure/halflife/large_pipe/intersection_t{
	dir = 4
	},
/turf/open/floor/plating/indoor/metal/grate,
/area/shuttle/escape)
"lB" = (
/obj/structure/closet/crate/halflife,
/obj/effect/turf_decal/delivery/white,
/obj/item/stack/sticky_tape/one,
/obj/item/weaponcrafting/receiver,
/obj/item/weaponcrafting/frame/service,
/turf/open/floor/plating/indoor/metal/industrial,
/area/shuttle/escape)
"lY" = (
/obj/docking_port/mobile/emergency{
	dir = 2;
	name = "Polish Armoured Train";
	preferred_direction = 2;
	port_direction = 2
	},
/obj/structure/fans/tiny/invisible,
/turf/open/floor/plating/indoor/metal/walkway{
	dir = 1
	},
/area/shuttle/escape)
"mk" = (
/obj/structure/fans/tiny/invisible,
/obj/structure/barricade/sandbags,
/turf/open/floor/plating/indoor/metal/industrial,
/area/shuttle/escape)
"nm" = (
/obj/structure/table/halflife/no_smooth/metal,
/obj/machinery/light/small/directional/east,
/turf/open/floor/plating/indoor/metal/plate,
/area/shuttle/escape)
"nR" = (
/obj/effect/turf_decal/delivery/white,
/obj/structure/table/halflife/no_smooth/large/crafting/workbench,
/obj/item/reagent_containers/cup/glass/bottle/vodka{
	pixel_x = 9;
	pixel_y = 17
	},
/turf/open/floor/plating/indoor/metal/industrial,
/area/shuttle/escape)
"oH" = (
/turf/closed/wall/halflife/metal/strong,
/area/shuttle/escape)
"pQ" = (
/obj/structure/chair/halflife/metal/red,
/turf/open/floor/plating/indoor/metal/grate/border/warning{
	dir = 1
	},
/area/shuttle/escape)
"ql" = (
/obj/structure/extinguisher_cabinet/directional/west,
/turf/open/floor/plating/indoor/metal/industrial,
/area/shuttle/escape)
"qq" = (
/obj/machinery/door/airlock/highsecurity/combine,
/turf/open/floor/plating/indoor/metal/industrial,
/area/shuttle/escape)
"qv" = (
/obj/structure/closet/crate/bin,
/obj/item/hl13_small_flag/combine,
/turf/open/floor/plating/indoor/metal/grate/border/warning{
	dir = 1
	},
/area/shuttle/escape)
"qO" = (
/obj/item/chair/halflife/metal/folding,
/obj/effect/decal/cleanable/blood/old,
/turf/open/floor/plating/indoor/metal/grate/border/warning{
	dir = 1
	},
/area/shuttle/escape)
"rj" = (
/obj/structure/fans/tiny/invisible,
/obj/structure/halflife/large_pipe/pump,
/turf/open/floor/plating/indoor/metal/grate/border/warning,
/area/shuttle/escape)
"st" = (
/obj/structure/chair/comfy/halflife/diner{
	dir = 8
	},
/turf/open/floor/plating/indoor/metal/plate,
/area/shuttle/escape)
"sK" = (
/obj/effect/turf_decal/delivery/white,
/obj/structure/closet/crate/freezer/halflife/blood,
/obj/machinery/light/small/directional/south,
/turf/open/floor/plating/indoor/metal/plate,
/area/shuttle/escape)
"uq" = (
/obj/machinery/light/small/red/directional/south,
/obj/structure/reagent_dispensers/fueltank/large{
	anchored = 1;
	desc = "A large tank of pre-war fuel mounted to the train's fuel system."
	},
/turf/open/floor/plating/indoor/metal/pipe{
	dir = 1
	},
/area/shuttle/escape)
"uA" = (
/obj/structure/chair/halflife/metal/red{
	dir = 1
	},
/turf/open/floor/plating/indoor/metal/grate/border/warning{
	dir = 1
	},
/area/shuttle/escape)
"vE" = (
/obj/item/reagent_containers/pill/patch/medkit/vial{
	pixel_x = -11;
	pixel_y = 8
	},
/obj/item/stack/medical/suture{
	pixel_x = 4;
	pixel_y = 9
	},
/obj/item/reagent_containers/cup/glass/bottle/vodka{
	pixel_x = 8;
	pixel_y = 9
	},
/turf/open/floor/plating/indoor/sterilesquares,
/area/shuttle/escape)
"vJ" = (
/obj/effect/turf_decal/delivery/white,
/obj/structure/closet/crate/halflife,
/obj/item/storage/toolbox/mechanical,
/obj/item/storage/toolbox/mechanical,
/obj/item/stack/sheet/iron/five,
/turf/open/floor/plating/indoor/metal/industrial,
/area/shuttle/escape)
"wY" = (
/obj/item/hl13_small_flag/poland{
	pixel_x = -13;
	pixel_y = 26
	},
/turf/open/floor/plating/indoor/metal/grate/border/warning{
	dir = 1
	},
/area/shuttle/escape)
"yI" = (
/obj/machinery/iv_drip,
/turf/open/floor/plating/indoor/sterilesquares,
/area/shuttle/escape)
"yW" = (
/turf/open/floor/plating/indoor/metal/pipe{
	dir = 1
	},
/area/shuttle/escape)
"zi" = (
/obj/machinery/door/airlock/highsecurity/combine,
/turf/open/floor/plating/indoor/woodc/wide,
/area/shuttle/escape)
"AT" = (
/obj/item/hl2key{
	lockid = "poland_train_brig";
	name = "cell key";
	desc = "The key to a brig cell.";
	pixel_x = -3;
	pixel_y = 11
	},
/turf/open/floor/plating/indoor/metal/industrial,
/area/shuttle/escape)
"Bv" = (
/obj/structure/halflife/large_pipe/ground{
	pixel_x = 0;
	pixel_y = -32;
	dir = 1
	},
/turf/closed/wall/halflife/metal/strong,
/area/shuttle/escape)
"BZ" = (
/obj/structure/halflife/large_pipe/pump,
/turf/open/floor/plating/indoor/metal/pipe/intersection{
	dir = 1
	},
/area/shuttle/escape)
"Cd" = (
/obj/item/reagent_containers/cup/bottle/welding_fuel{
	pixel_x = 4;
	pixel_y = 24
	},
/obj/machinery/light/small/directional/north,
/turf/open/floor/plating/indoor/metal/industrial,
/area/shuttle/escape)
"Ck" = (
/obj/structure/barricade/wooden/crude,
/obj/structure/girder,
/obj/structure/fans/tiny/invisible,
/turf/open/floor/plating/indoor/metal/grate/border/warning{
	dir = 1
	},
/area/shuttle/escape)
"EC" = (
/turf/open/floor/plating/indoor/metal/industrial,
/area/shuttle/escape)
"EG" = (
/obj/effect/turf_decal/delivery/white,
/obj/structure/closet/crate/freezer/halflife,
/obj/item/food/pierogi_ration,
/obj/item/food/pierogi_ration,
/obj/item/food/pierogi_ration,
/obj/item/food/canned/halflife/beans,
/obj/item/food/canned/halflife/beans,
/obj/item/food/canned/halflife/beans,
/obj/item/food/canned/halflife/beans,
/obj/item/food/canned/halflife/crisps,
/obj/item/food/canned/halflife/crisps,
/obj/item/food/canned/halflife/seafood,
/obj/item/food/canned/halflife/seafood,
/obj/item/food/canned/halflife/seafood,
/obj/item/reagent_containers/cup/glass/waterbottle/large,
/obj/item/reagent_containers/cup/glass/waterbottle/large,
/obj/item/reagent_containers/cup/glass/waterbottle/large,
/turf/open/floor/plating/indoor/metal/plate,
/area/shuttle/escape)
"FS" = (
/obj/structure/chair/halflife/metal/red{
	dir = 1
	},
/turf/open/floor/plating/indoor/metal/plate,
/area/shuttle/escape)
"GV" = (
/obj/effect/decal/cleanable/blood/old,
/turf/open/floor/plating/indoor/metal/pipe{
	dir = 1
	},
/area/shuttle/escape)
"Hn" = (
/obj/structure/fans/tiny/invisible,
/obj/machinery/light/directional/south,
/turf/open/floor/plating/indoor/metal/walkway/end,
/area/shuttle/escape)
"Hv" = (
/obj/machinery/light/small/directional/north,
/obj/item/reagent_containers/cup/glass/bottle/vodka{
	pixel_x = 7;
	pixel_y = 11
	},
/obj/item/reagent_containers/cup/glass/bottle/vodka{
	pixel_x = 10;
	pixel_y = 8
	},
/obj/structure/table/halflife/no_smooth/wood,
/obj/structure/extinguisher_cabinet/directional/west,
/obj/item/clothing/head/helmet/halflife/military/poland{
	pixel_x = -6;
	pixel_y = 5
	},
/turf/open/floor/plating/indoor/woodc/wide,
/area/shuttle/escape)
"Ig" = (
/obj/structure/fans/tiny/invisible,
/obj/machinery/door/airlock/highsecurity/combine,
/turf/open/floor/plating/indoor/metal/plate,
/area/shuttle/escape)
"Im" = (
/obj/machinery/light/small/red/directional/west,
/turf/open/floor/plating/indoor/metal/industrial,
/area/shuttle/escape)
"Io" = (
/obj/structure/window/fulltile,
/obj/machinery/door/poddoor/preopen{
	id = "poland_shuttle_windows"
	},
/turf/open/floor/plating/indoor/metal/plate,
/area/shuttle/escape)
"Ja" = (
/obj/effect/turf_decal/delivery/white,
/turf/open/floor/plating/indoor/metal/industrial,
/area/shuttle/escape)
"Jq" = (
/obj/machinery/light/small/directional/west,
/turf/open/floor/plating/indoor/metal/grate/border/warning{
	dir = 1
	},
/area/shuttle/escape)
"Jw" = (
/obj/machinery/light/small/directional/west,
/obj/structure/table/halflife/no_smooth/large/metal,
/obj/item/clothing/glasses/hud/health{
	pixel_x = -5;
	pixel_y = 14
	},
/obj/item/healthanalyzer{
	pixel_x = 3;
	pixel_y = 2
	},
/obj/item/reagent_containers/pill/patch/medkit/vial{
	pixel_x = 9;
	pixel_y = 9
	},
/obj/item/reagent_containers/pill/patch/medkit/vial{
	pixel_x = 15;
	pixel_y = 10
	},
/turf/open/floor/plating/indoor/sterilesquares,
/area/shuttle/escape)
"Km" = (
/obj/structure/closet/halflife,
/obj/item/storage/belt/civilprotection/polish_resistance/ak,
/obj/item/gun/ballistic/automatic/ak47,
/turf/open/floor/plating/indoor/metal/industrial,
/area/shuttle/escape)
"Kv" = (
/obj/structure/fans/tiny/invisible,
/turf/open/floor/plating/indoor/metal/walkway/corner,
/area/shuttle/escape)
"Lv" = (
/obj/structure/chair/comfy/halflife/captain{
	dir = 4
	},
/turf/open/floor/plating/indoor/woodc/wide,
/area/shuttle/escape)
"LG" = (
/obj/structure/table/halflife/no_smooth/large/crafting/ammobench,
/obj/item/stack/bulletcasings{
	amount = 15;
	pixel_x = 2;
	pixel_y = 11
	},
/turf/open/floor/plating/indoor/metal/industrial,
/area/shuttle/escape)
"Nk" = (
/obj/structure/closet/halflife,
/obj/item/clothing/mask/gas/hl2/military,
/obj/item/clothing/suit/armor/halflife/kevlar,
/obj/item/clothing/under/syndicate/camo,
/obj/item/clothing/shoes/combat,
/obj/machinery/light/small/directional/south,
/obj/item/clothing/head/helmet/halflife/military/poland,
/turf/open/floor/plating/indoor/metal/industrial,
/area/shuttle/escape)
"Ns" = (
/obj/structure/halflife/fence/wire,
/turf/open/floor/plating/indoor/metal/pipe{
	dir = 1
	},
/area/shuttle/escape)
"Ny" = (
/obj/structure/fans/tiny/invisible,
/turf/open/floor/plating/indoor/metal/walkway/corner{
	dir = 1
	},
/area/shuttle/escape)
"NT" = (
/obj/structure/window/fulltile,
/obj/machinery/door/poddoor/preopen{
	id = "poland_shuttle_windows"
	},
/obj/structure/fans/tiny/invisible,
/turf/open/floor/plating/indoor/metal/plate,
/area/shuttle/escape)
"Or" = (
/obj/structure/table/halflife/no_smooth/large/crafting/weaponbench,
/obj/item/stack/sticky_tape/one{
	pixel_x = 15;
	pixel_y = 13
	},
/turf/open/floor/plating/indoor/metal/pipe{
	dir = 1
	},
/area/shuttle/escape)
"Ox" = (
/obj/machinery/light/small/directional/east,
/obj/structure/table/halflife/no_smooth/metal,
/turf/open/floor/plating/indoor/metal/plate,
/area/shuttle/escape)
"Pi" = (
/obj/structure/table/halflife/wood,
/obj/item/food/meat_pierogi{
	pixel_x = -4;
	pixel_y = 8
	},
/obj/item/gun/ballistic/automatic/pistol/usp{
	pixel_x = 2;
	pixel_y = 6
	},
/obj/item/ammo_box/magazine/usp9mm{
	pixel_x = 10;
	pixel_y = 1
	},
/obj/item/ammo_box/magazine/usp9mm{
	pixel_x = 5;
	pixel_y = 0
	},
/turf/open/floor/plating/indoor/woodc/wide,
/area/shuttle/escape)
"Qh" = (
/obj/structure/fans/tiny/invisible,
/obj/machinery/light/blacklight/directional/south{
	bulb_colour = "#ff0000";
	nightshift_light_color = "#ff0000"
	},
/turf/open/floor/plating/indoor/metal/walkway/end,
/area/shuttle/escape)
"RA" = (
/obj/machinery/light/small/directional/north,
/obj/machinery/button/door{
	id = "poland_shuttle_windows";
	name = "Viewing Port Blast Doors";
	pixel_x = -7;
	pixel_y = 2
	},
/obj/structure/table/halflife/no_smooth/wood,
/obj/machinery/recharger{
	pixel_y = 3;
	pixel_x = 4
	},
/turf/open/floor/plating/indoor/woodc/wide,
/area/shuttle/escape)
"Tw" = (
/obj/machinery/light/small/red/directional/north,
/obj/structure/halflife/large_pipe/intersection_t{
	dir = 4
	},
/turf/open/floor/plating/indoor/metal/grate,
/area/shuttle/escape)
"TN" = (
/obj/machinery/door/poddoor/preopen{
	id = "poland_shuttle_windows"
	},
/obj/structure/barricade/sandbags,
/obj/structure/fans/tiny/invisible,
/obj/effect/decal/cleanable/glass,
/turf/open/floor/plating/indoor/metal/plate,
/area/shuttle/escape)
"VW" = (
/obj/structure/halflife/fence/corner/wire{
	dir = 8
	},
/turf/open/floor/plating/indoor/metal/industrial,
/area/shuttle/escape)
"Wd" = (
/obj/machinery/computer/emergency_shuttle{
	dir = 4;
	name = "old train console";
	desc = "A console capable of controlling both human and Combine rolling stock and any track switches in the way."
	},
/turf/open/floor/plating/indoor/woodc/wide,
/area/shuttle/escape)
"WL" = (
/obj/structure/fans/tiny/invisible,
/turf/open/floor/plating/indoor/metal/walkway{
	dir = 1
	},
/area/shuttle/escape)
"WY" = (
/obj/machinery/door/airlock/highsecurity/combine,
/turf/open/floor/plating/indoor/sterilesquares,
/area/shuttle/escape)
"Zi" = (
/obj/structure/window/fulltile,
/turf/open/floor/plating/indoor/metal/plate,
/area/shuttle/escape)
"Zq" = (
/obj/machinery/light/small/red/directional/north,
/obj/structure/chair/halflife/metal/folding,
/turf/open/floor/plating/indoor/metal/industrial,
/area/shuttle/escape)
"Zr" = (
/obj/structure/halflife/fence/vertical/wire/east,
/turf/open/floor/plating/indoor/metal/industrial,
/area/shuttle/escape)

(1,1,1) = {"
Kv
Qh
oH
NT
oH
oH
TN
oH
Ig
oH
NT
oH
Ig
oH
NT
oH
oH
oH
TN
oH
oH
oH
TN
oH
oH
oH
NT
oH
Bv
jC
"}
(2,1,1) = {"
WL
oH
oH
Pi
jX
oH
wY
cK
cK
cK
cK
cK
cK
cK
cK
cK
Jq
cK
cK
cK
eH
cK
cK
cK
Im
ql
vJ
oH
rj
mk
"}
(3,1,1) = {"
WL
oH
Hv
cX
cH
Zi
aJ
aJ
st
Ox
aJ
st
nm
st
aJ
bJ
oH
oH
gt
oH
oH
Zr
Zr
VW
EC
EC
lB
oH
lj
oH
"}
(4,1,1) = {"
lY
Io
Wd
fk
cX
zi
aJ
EG
oH
oH
WY
oH
oH
oH
qq
oH
oH
dw
aJ
FS
oH
yW
GV
Ns
Or
yW
uq
oH
BZ
mk
"}
(5,1,1) = {"
WL
oH
RA
cX
Lv
Zi
aJ
sK
oH
je
eT
Jw
oH
LG
EC
Nk
oH
dw
aJ
dm
oH
Zq
EC
cI
AT
EC
nR
oH
Tw
oH
"}
(6,1,1) = {"
WL
oH
oH
fx
bn
oH
cK
qv
oH
yI
eT
vE
oH
Cd
EC
Km
oH
pQ
cK
uA
oH
qO
cK
fB
EC
EC
Ja
Ck
rj
mk
"}
(7,1,1) = {"
Ny
Hn
oH
NT
oH
oH
TN
oH
oH
oH
NT
oH
oH
oH
TN
oH
oH
oH
NT
oH
oH
oH
NT
oH
oH
oH
TN
oH
Bv
jC
"}
