//MAP CONVERTED BY dmm2tgm.py THIS HEADER COMMENT PREVENTS RECONVERSION, DO NOT REMOVE
"aa" = (
/obj/item/hl13_small_flag/poland{
	pixel_x = 6;
	pixel_y = 2
	},
/turf/open/floor/plating/indoor/metal/plate,
/area/shuttle/escape)
"cA" = (
/obj/structure/chair/comfy/halflife/captain{
	dir = 1
	},
/turf/open/floor/plating/indoor/woodc/wide,
/area/shuttle/escape)
"cL" = (
/turf/open/floor/plating/indoor/metal/plate,
/area/shuttle/escape)
"ew" = (
/obj/structure/table/halflife/no_smooth/large/crafting/ammobench,
/obj/item/stack/bulletcasings{
	amount = 15;
	pixel_x = 2;
	pixel_y = 11
	},
/turf/open/floor/plating/indoor/metal/industrial,
/area/shuttle/escape)
"fH" = (
/obj/machinery/door/unpowered/halflife/metal/red,
/turf/open/floor/plating/indoor/woodc/wide,
/area/shuttle/escape)
"hM" = (
/obj/machinery/light/small/red/directional/north,
/obj/structure/chair/halflife/metal/folding,
/turf/open/floor/plating/indoor/metal/industrial,
/area/shuttle/escape)
"ip" = (
/obj/structure/chair/comfy/halflife/captain{
	dir = 8
	},
/turf/open/floor/plating/indoor/woodc/wide,
/area/shuttle/escape)
"it" = (
/obj/structure/fans/tiny/invisible,
/obj/machinery/light/directional/south,
/turf/open/floor/plating/indoor/metal/walkway/end,
/area/shuttle/escape)
"jp" = (
/turf/closed/wall/halflife/metal/strong,
/area/shuttle/escape)
"jE" = (
/obj/structure/halflife/large_pipe/intersection_t{
	dir = 4
	},
/turf/open/floor/plating/indoor/metal/grate,
/area/shuttle/escape)
"jM" = (
/obj/structure/halflife/large_pipe/ground{
	pixel_x = 0;
	pixel_y = -32;
	dir = 1
	},
/turf/closed/wall/halflife/metal/strong,
/area/shuttle/escape)
"jX" = (
/turf/template_noop,
/area/template_noop)
"ki" = (
/obj/structure/fans/tiny/invisible,
/turf/open/floor/plating/indoor/metal/walkway/corner{
	dir = 1
	},
/area/shuttle/escape)
"kV" = (
/obj/structure/chair/halflife/metal/red,
/turf/open/floor/plating/indoor/metal/plate,
/area/shuttle/escape)
"mm" = (
/obj/machinery/iv_drip,
/turf/open/floor/plating/indoor/sterilesquares,
/area/shuttle/escape)
"mH" = (
/turf/open/floor/plating/indoor/woodc/wide,
/area/shuttle/escape)
"ne" = (
/obj/structure/fans/tiny/invisible,
/turf/open/floor/plating/indoor/metal/walkway{
	dir = 1
	},
/area/shuttle/escape)
"nV" = (
/obj/item/chair/halflife/metal/folding,
/obj/effect/decal/cleanable/blood/old,
/turf/open/floor/plating/indoor/metal/grate/border/warning{
	dir = 1
	},
/area/shuttle/escape)
"rn" = (
/obj/structure/halflife/fence/wire,
/turf/open/floor/plating/indoor/metal/pipe{
	dir = 1
	},
/area/shuttle/escape)
"rT" = (
/obj/effect/turf_decal/delivery/white,
/turf/open/floor/plating/indoor/metal/industrial,
/area/shuttle/escape)
"sd" = (
/obj/machinery/light/small/red/dim/directional/north,
/obj/item/reagent_containers/cup/bottle/welding_fuel{
	pixel_x = 4;
	pixel_y = 24
	},
/turf/open/floor/plating/indoor/metal/industrial,
/area/shuttle/escape)
"sj" = (
/obj/structure/halflife/fence/vertical/wire/east,
/turf/open/floor/plating/indoor/metal/industrial,
/area/shuttle/escape)
"tc" = (
/obj/docking_port/mobile/emergency{
	dir = 2;
	name = "Polish Armoured Train";
	preferred_direction = 2;
	port_direction = 2
	},
/obj/structure/fans/tiny/invisible,
/turf/open/floor/plating/indoor/metal/walkway{
	dir = 1
	},
/area/shuttle/escape)
"tx" = (
/obj/structure/fans/tiny/invisible,
/obj/structure/halflife/large_pipe/pump,
/turf/open/floor/plating/indoor/metal/grate/border/warning,
/area/shuttle/escape)
"tB" = (
/turf/open/floor/plating/indoor/metal/grate/border/warning{
	dir = 1
	},
/area/shuttle/escape)
"tH" = (
/obj/structure/halflife/fence/wire,
/turf/open/floor/plating/indoor/metal/industrial,
/area/shuttle/escape)
"tS" = (
/obj/machinery/light/small/directional/west,
/turf/open/floor/plating/indoor/metal/grate/border/warning{
	dir = 1
	},
/area/shuttle/escape)
"tU" = (
/turf/open/floor/plating/indoor/metal/pipe{
	dir = 1
	},
/area/shuttle/escape)
"ul" = (
/obj/structure/halflife/fence/corner/wire{
	dir = 8
	},
/turf/open/floor/plating/indoor/metal/industrial,
/area/shuttle/escape)
"us" = (
/obj/machinery/door/unpowered/halflife/seethrough/metal{
	dir = 8;
	keylock = 1
	},
/turf/open/floor/plating/indoor/metal/plate,
/area/shuttle/escape)
"uE" = (
/obj/effect/turf_decal/delivery/white,
/obj/structure/closet/crate/freezer/halflife,
/obj/item/food/pierogi_ration,
/obj/item/food/pierogi_ration,
/obj/item/food/pierogi_ration,
/obj/item/food/canned/halflife/beans,
/obj/item/food/canned/halflife/beans,
/obj/item/food/canned/halflife/beans,
/obj/item/food/canned/halflife/beans,
/obj/item/food/canned/halflife/crisps,
/obj/item/food/canned/halflife/crisps,
/obj/item/food/canned/halflife/seafood,
/obj/item/food/canned/halflife/seafood,
/obj/item/food/canned/halflife/seafood,
/obj/item/reagent_containers/cup/glass/waterbottle/large,
/obj/item/reagent_containers/cup/glass/waterbottle/large,
/obj/item/reagent_containers/cup/glass/waterbottle/large,
/turf/open/floor/plating/indoor/metal/plate,
/area/shuttle/escape)
"uH" = (
/obj/structure/fans/tiny/invisible,
/turf/open/floor/plating/indoor/metal/walkway/corner,
/area/shuttle/escape)
"uK" = (
/obj/structure/table/halflife/no_smooth/large/wood/desk{
	dir = 8
	},
/obj/item/weaponcrafting/frame/coltpython{
	pixel_x = 4;
	pixel_y = 3
	},
/turf/open/floor/plating/indoor/woodc/wide,
/area/shuttle/escape)
"vo" = (
/obj/machinery/light/small/red/directional/north,
/obj/structure/halflife/large_pipe/intersection_t{
	dir = 4
	},
/turf/open/floor/plating/indoor/metal/grate,
/area/shuttle/escape)
"vD" = (
/obj/item/reagent_containers/pill/patch/medkit/vial{
	pixel_x = -11;
	pixel_y = 8
	},
/obj/item/stack/medical/suture{
	pixel_x = 4;
	pixel_y = 9
	},
/turf/open/floor/plating/indoor/sterilesquares,
/area/shuttle/escape)
"vK" = (
/obj/structure/closet/crate/halflife,
/obj/effect/turf_decal/delivery/white,
/obj/item/stack/sticky_tape/one,
/obj/item/weaponcrafting/receiver,
/obj/item/weaponcrafting/frame/service,
/turf/open/floor/plating/indoor/metal/industrial,
/area/shuttle/escape)
"yr" = (
/obj/machinery/door/poddoor/preopen{
	id = "poland_shuttle_windows"
	},
/obj/structure/barricade/sandbags,
/obj/structure/fans/tiny/invisible,
/obj/effect/decal/cleanable/glass,
/turf/open/floor/plating/indoor/metal/plate,
/area/shuttle/escape)
"yt" = (
/obj/structure/chair/comfy/halflife/diner{
	dir = 8
	},
/turf/open/floor/plating/indoor/metal/plate,
/area/shuttle/escape)
"Am" = (
/obj/effect/turf_decal/delivery/white,
/obj/structure/table/halflife/no_smooth/large/crafting/workbench,
/turf/open/floor/plating/indoor/metal/industrial,
/area/shuttle/escape)
"Ao" = (
/obj/structure/window/fulltile,
/turf/open/floor/plating/indoor/metal/plate,
/area/shuttle/escape)
"Bp" = (
/obj/structure/fans/tiny/invisible,
/obj/machinery/light/blacklight/directional/south{
	bulb_colour = "#ff0000";
	nightshift_light_color = "#ff0000"
	},
/turf/open/floor/plating/indoor/metal/walkway/end,
/area/shuttle/escape)
"BT" = (
/obj/machinery/light/small/red/dim/directional/south,
/obj/structure/closet/halflife,
/obj/item/clothing/mask/gas/hl2/military,
/obj/item/clothing/head/helmet/halflife/military,
/obj/item/clothing/suit/armor/halflife/kevlar,
/obj/item/clothing/under/syndicate/camo,
/obj/item/clothing/shoes/combat,
/turf/open/floor/plating/indoor/metal/industrial,
/area/shuttle/escape)
"CF" = (
/obj/structure/chair/halflife/metal/red{
	dir = 1
	},
/obj/machinery/light/small/directional/south,
/turf/open/floor/plating/indoor/metal/plate,
/area/shuttle/escape)
"CR" = (
/turf/open/floor/plating/indoor/sterilesquares,
/area/shuttle/escape)
"DB" = (
/obj/machinery/light/small/red/directional/west,
/turf/open/floor/plating/indoor/metal/industrial,
/area/shuttle/escape)
"Ex" = (
/obj/machinery/door/unpowered/halflife/seethrough/metal{
	dir = 8;
	keylock = 1
	},
/turf/open/floor/plating/indoor/metal/industrial,
/area/shuttle/escape)
"Ey" = (
/obj/structure/chair/comfy/halflife/captain{
	dir = 4
	},
/turf/open/floor/plating/indoor/woodc/wide,
/area/shuttle/escape)
"Ff" = (
/turf/open/floor/plating/indoor/metal/industrial,
/area/shuttle/escape)
"Fu" = (
/obj/structure/chair/halflife/metal/red{
	dir = 1
	},
/turf/open/floor/plating/indoor/metal/grate/border/warning{
	dir = 1
	},
/area/shuttle/escape)
"FT" = (
/obj/structure/window/fulltile,
/obj/machinery/door/poddoor/preopen{
	id = "poland_shuttle_windows"
	},
/obj/structure/fans/tiny/invisible,
/turf/open/floor/plating/indoor/metal/plate,
/area/shuttle/escape)
"Gf" = (
/obj/machinery/light/small/directional/east,
/obj/structure/table/halflife/no_smooth/metal,
/turf/open/floor/plating/indoor/metal/plate,
/area/shuttle/escape)
"Gr" = (
/obj/machinery/door/unpowered/halflife/metal/red{
	dir = 8
	},
/turf/open/floor/plating/indoor/sterilesquares,
/area/shuttle/escape)
"GM" = (
/obj/machinery/light/small/directional/north,
/obj/machinery/button/door{
	id = "poland_shuttle_windows";
	name = "Viewing Port Blast Doors";
	pixel_x = -7;
	pixel_y = 2
	},
/obj/structure/table/halflife/no_smooth/wood,
/obj/machinery/recharger{
	pixel_y = 3;
	pixel_x = 4
	},
/turf/open/floor/plating/indoor/woodc/wide,
/area/shuttle/escape)
"GR" = (
/obj/structure/table/halflife/no_smooth/large/crafting/weaponbench,
/obj/item/stack/sticky_tape/one{
	pixel_x = 15;
	pixel_y = 13
	},
/turf/open/floor/plating/indoor/metal/pipe{
	dir = 1
	},
/area/shuttle/escape)
"He" = (
/obj/machinery/door/unpowered/halflife/metal,
/turf/open/floor/plating/indoor/metal/grate/border/warning{
	dir = 1
	},
/area/shuttle/escape)
"HC" = (
/obj/machinery/door/unpowered/halflife/seethrough/fence/wire{
	keylock = 1;
	lockid = "poland_train_brig"
	},
/turf/open/floor/plating/indoor/metal/grate/border/warning{
	dir = 1
	},
/area/shuttle/escape)
"HV" = (
/obj/effect/turf_decal/delivery/white,
/obj/structure/closet/crate/freezer/halflife/blood,
/turf/open/floor/plating/indoor/metal/plate,
/area/shuttle/escape)
"Ij" = (
/obj/machinery/computer/camera_advanced/syndie{
	dir = 4
	},
/turf/open/floor/plating/indoor/woodc/wide,
/area/shuttle/escape)
"IY" = (
/obj/effect/decal/cleanable/blood/old,
/turf/open/floor/plating/indoor/metal/pipe{
	dir = 1
	},
/area/shuttle/escape)
"Jb" = (
/obj/machinery/light/small/red/directional/south,
/obj/structure/reagent_dispensers/fueltank/large{
	anchored = 1;
	desc = "A large tank of pre-war fuel mounted to the train's fuel system."
	},
/turf/open/floor/plating/indoor/metal/pipe{
	dir = 1
	},
/area/shuttle/escape)
"JX" = (
/obj/structure/closet/halflife,
/obj/item/storage/belt/civilprotection/polish_resistance/ak,
/obj/item/gun/ballistic/automatic/ak47,
/turf/open/floor/plating/indoor/metal/industrial,
/area/shuttle/escape)
"KN" = (
/obj/structure/barricade/wooden/crude,
/obj/structure/girder,
/turf/open/floor/plating/indoor/metal/grate/border/warning{
	dir = 1
	},
/area/shuttle/escape)
"Le" = (
/obj/structure/halflife/large_pipe/pump,
/turf/open/floor/plating/indoor/metal/pipe/intersection{
	dir = 1
	},
/area/shuttle/escape)
"LD" = (
/obj/effect/turf_decal/delivery/white,
/obj/structure/closet/crate/halflife,
/obj/item/storage/toolbox/mechanical,
/obj/item/storage/toolbox/mechanical,
/obj/item/stack/sheet/iron/five,
/turf/open/floor/plating/indoor/metal/industrial,
/area/shuttle/escape)
"Mm" = (
/obj/machinery/computer/emergency_shuttle{
	dir = 4;
	name = "old train console";
	desc = "A console capable of controlling both human and Combine rolling stock and any track switches in the way."
	},
/turf/open/floor/plating/indoor/woodc/wide,
/area/shuttle/escape)
"Qs" = (
/obj/structure/fans/tiny/invisible,
/obj/structure/barricade/sandbags,
/turf/open/floor/plating/indoor/metal/industrial,
/area/shuttle/escape)
"Rf" = (
/obj/structure/closet/halflife/wall/firstaid,
/obj/effect/spawner/random/halflife/loot/heal,
/obj/effect/spawner/random/halflife/loot/heal,
/obj/effect/spawner/random/halflife/loot/heal,
/obj/structure/bed/halflife/bedframe/wire,
/obj/structure/bed/halflife/mattress/stained,
/turf/open/floor/plating/indoor/sterilesquares,
/area/shuttle/escape)
"Sg" = (
/obj/machinery/light/small/directional/north,
/obj/item/hl13_small_flag/poland{
	pixel_x = -13;
	pixel_y = 24
	},
/turf/open/floor/plating/indoor/woodc/wide,
/area/shuttle/escape)
"SI" = (
/obj/structure/closet/crate/bin,
/obj/item/hl13_small_flag/combine,
/turf/open/floor/plating/indoor/metal/grate/border/warning{
	dir = 1
	},
/area/shuttle/escape)
"Tg" = (
/obj/structure/table/halflife/wood,
/obj/item/food/meat_pierogi{
	pixel_x = -4;
	pixel_y = 8
	},
/obj/item/gun/ballistic/automatic/pistol/usp{
	pixel_x = 2;
	pixel_y = 6
	},
/obj/item/ammo_box/magazine/usp9mm{
	pixel_x = 10;
	pixel_y = 1
	},
/obj/item/ammo_box/magazine/usp9mm{
	pixel_x = 5;
	pixel_y = 0
	},
/turf/open/floor/plating/indoor/woodc/wide,
/area/shuttle/escape)
"TG" = (
/obj/item/ammo_casing/a357/spent{
	pixel_x = -4;
	pixel_y = -9
	},
/obj/item/ammo_casing/a357/spent{
	pixel_x = -8;
	pixel_y = -11
	},
/obj/item/ammo_casing/a357/spent{
	pixel_x = -4;
	pixel_y = -11
	},
/obj/item/ammo_casing/a357/spent{
	pixel_x = -8;
	pixel_y = -9
	},
/obj/item/ammo_casing/a357{
	pixel_x = 2;
	pixel_y = -9
	},
/obj/item/ammo_casing/a357{
	pixel_x = 2;
	pixel_y = -11
	},
/obj/item/paper_bin{
	pixel_x = 2;
	pixel_y = 7
	},
/obj/item/pen{
	pixel_x = 2;
	pixel_y = 8
	},
/turf/open/floor/plating/indoor/woodc/wide,
/area/shuttle/escape)
"TY" = (
/obj/structure/chair/halflife/metal/red,
/turf/open/floor/plating/indoor/metal/grate/border/warning{
	dir = 1
	},
/area/shuttle/escape)
"Uc" = (
/obj/machinery/door/unpowered/halflife/seethrough/metal{
	dir = 8
	},
/obj/structure/fans/tiny/invisible,
/turf/open/floor/plating/indoor/metal/plate,
/area/shuttle/escape)
"Vd" = (
/obj/structure/window/fulltile,
/obj/machinery/door/poddoor/preopen{
	id = "poland_shuttle_windows"
	},
/turf/open/floor/plating/indoor/metal/plate,
/area/shuttle/escape)
"VF" = (
/obj/item/hl2key{
	lockid = "poland_train_brig";
	name = "cell key";
	desc = "The key to a brig cell.";
	pixel_x = -3;
	pixel_y = 11
	},
/turf/open/floor/plating/indoor/metal/industrial,
/area/shuttle/escape)
"Wb" = (
/obj/structure/chair/halflife/metal/red{
	dir = 1
	},
/turf/open/floor/plating/indoor/metal/plate,
/area/shuttle/escape)
"YJ" = (
/obj/structure/table/halflife/no_smooth/metal,
/obj/machinery/light/small/directional/east,
/turf/open/floor/plating/indoor/metal/plate,
/area/shuttle/escape)
"YY" = (
/obj/machinery/light/small/directional/west,
/obj/structure/table/halflife/no_smooth/large/metal,
/obj/item/clothing/glasses/hud/health{
	pixel_x = -5;
	pixel_y = 14
	},
/obj/item/healthanalyzer{
	pixel_x = 3;
	pixel_y = 2
	},
/obj/item/reagent_containers/pill/patch/medkit/vial{
	pixel_x = 9;
	pixel_y = 9
	},
/obj/item/reagent_containers/pill/patch/medkit/vial{
	pixel_x = 15;
	pixel_y = 10
	},
/turf/open/floor/plating/indoor/sterilesquares,
/area/shuttle/escape)

(1,1,1) = {"
uH
Bp
jp
FT
jp
jp
FT
jp
Uc
jp
yr
jp
Uc
jp
FT
jp
jp
jp
yr
jp
jp
jp
yr
jp
jp
jp
FT
jp
jM
jX
"}
(2,1,1) = {"
ne
jp
jp
Tg
Ij
jp
tB
tB
tB
tB
tB
tB
tB
tB
tB
tB
tS
tB
tB
tB
He
tB
tB
tB
DB
Ff
LD
jp
tx
Qs
"}
(3,1,1) = {"
ne
jp
Sg
mH
ip
Ao
cL
cL
yt
Gf
cL
yt
YJ
yt
cL
aa
jp
jp
us
jp
jp
sj
sj
ul
Ff
Ff
vK
jp
jE
jp
"}
(4,1,1) = {"
tc
Vd
Mm
cA
mH
fH
cL
uE
jp
jp
Gr
jp
jp
jp
Ex
jp
jp
kV
cL
Wb
jp
tU
IY
rn
GR
tU
Jb
jp
Le
Qs
"}
(5,1,1) = {"
ne
jp
GM
mH
Ey
Ao
cL
HV
jp
Rf
CR
YY
jp
ew
Ff
BT
jp
kV
cL
CF
jp
hM
Ff
tH
VF
Ff
Am
jp
vo
jp
"}
(6,1,1) = {"
ne
jp
jp
TG
uK
jp
tB
SI
jp
mm
CR
vD
jp
sd
Ff
JX
jp
TY
tB
Fu
jp
nV
tB
HC
Ff
Ff
rT
KN
tx
Qs
"}
(7,1,1) = {"
ki
it
jp
FT
jp
jp
yr
jp
jp
jp
FT
jp
jp
jp
yr
jp
jp
jp
FT
jp
jp
jp
FT
jp
jp
jp
yr
jp
jM
jX
"}
