//MAP CONVERTED BY dmm2tgm.py THIS HEADER COMMENT PREVENTS RECONVERSION, DO NOT REMOVE
"a" = (
/turf/open/floor/plating/indoor/metal/grate/border/warning{
	dir = 1
	},
/area/shuttle/escape)
"b" = (
/turf/template_noop,
/area/template_noop)
"d" = (
/turf/open/floor/plating/indoor/metal/plate,
/area/shuttle/escape)
"e" = (
/obj/structure/window/fulltile,
/turf/open/floor/plating/indoor/metal/plate,
/area/shuttle/escape)
"g" = (
/obj/structure/window/fulltile,
/obj/machinery/door/poddoor/preopen{
	id = "poland_shuttle_windows"
	},
/turf/open/floor/plating/indoor/metal/plate,
/area/shuttle/escape)
"h" = (
/turf/open/floor/plating/indoor/woodc/wide,
/area/shuttle/escape)
"j" = (
/obj/structure/closet/crate/bin,
/obj/item/hl13_small_flag/combine,
/turf/open/floor/plating/indoor/metal/grate/border/warning{
	dir = 1
	},
/area/shuttle/escape)
"k" = (
/obj/structure/table/halflife/metal/heavy,
/obj/machinery/light/small/directional/north,
/obj/machinery/button/door{
	id = "poland_shuttle_windows";
	name = "Viewing Port Blast Doors"
	},
/turf/open/floor/plating/indoor/metal/grate/border/warning,
/area/shuttle/escape)
"o" = (
/obj/structure/chair/office/halflife/red,
/turf/open/floor/plating/indoor/woodc/wide,
/area/shuttle/escape)
"p" = (
/obj/structure/closet/halflife/wall/firstaid,
/obj/effect/spawner/random/halflife/loot/heal,
/obj/effect/spawner/random/halflife/loot/heal,
/obj/effect/spawner/random/halflife/loot/heal,
/turf/open/floor/plating/indoor/metal/grate/border/warning{
	dir = 1
	},
/area/shuttle/escape)
"s" = (
/obj/machinery/light/small/red/dim/directional/south,
/obj/structure/closet/halflife,
/obj/item/clothing/mask/gas/hl2/military,
/obj/item/clothing/head/helmet/halflife/military,
/obj/item/clothing/suit/armor/halflife/kevlar,
/obj/item/clothing/under/syndicate/camo,
/obj/item/clothing/shoes/combat,
/turf/open/floor/plating/indoor/metal/industrial,
/area/shuttle/escape)
"t" = (
/obj/docking_port/mobile/emergency{
	dir = 2;
	name = "Polish Armoured Train";
	preferred_direction = 2;
	port_direction = 2
	},
/obj/structure/fans/tiny/invisible,
/turf/open/floor/plating/indoor/metal/plate,
/area/shuttle/escape)
"v" = (
/obj/machinery/door/unpowered/halflife/metal/red,
/turf/open/floor/plating/indoor/metal/plate,
/area/shuttle/escape)
"x" = (
/obj/structure/table/halflife/no_smooth/large/wood/desk{
	dir = 1
	},
/obj/machinery/light/small/directional/west,
/turf/open/floor/plating/indoor/woodc/wide,
/area/shuttle/escape)
"A" = (
/obj/machinery/computer/emergency_shuttle{
	dir = 4;
	name = "old train console";
	desc = "A console capable of controlling both human and Combine rolling stock and any track switches in the way."
	},
/turf/open/floor/plating/indoor/metal/grate/border/warning,
/area/shuttle/escape)
"D" = (
/obj/machinery/door/poddoor/preopen{
	id = "poland_shuttle_windows"
	},
/obj/structure/barricade/sandbags,
/obj/structure/fans/tiny/invisible,
/obj/effect/decal/cleanable/glass,
/turf/open/floor/plating/indoor/metal/plate,
/area/shuttle/escape)
"E" = (
/obj/machinery/light/small/directional/east,
/turf/open/floor/plating/indoor/metal/plate,
/area/shuttle/escape)
"F" = (
/turf/open/space/basic,
/area/space)
"H" = (
/obj/structure/closet/halflife,
/obj/item/gun/ballistic/automatic/servicerifle/no_mag,
/obj/item/storage/belt/civilprotection/polish_resistance/servicerifle,
/obj/item/gun/ballistic/automatic/servicerifle/no_mag,
/turf/open/floor/plating/indoor/metal/industrial,
/area/shuttle/escape)
"I" = (
/obj/item/hl13_small_flag/poland{
	pixel_x = 11;
	pixel_y = 3
	},
/turf/open/floor/plating/indoor/woodc/wide,
/area/shuttle/escape)
"J" = (
/obj/machinery/door/unpowered/halflife/seethrough/metal{
	dir = 8;
	keylock = 1
	},
/turf/open/floor/plating/indoor/metal/industrial,
/area/shuttle/escape)
"K" = (
/obj/structure/table/halflife/no_smooth/large/crafting/ammobench,
/turf/open/floor/plating/indoor/metal/industrial,
/area/shuttle/escape)
"L" = (
/obj/structure/table/halflife/metal/heavy,
/obj/machinery/light/small/directional/north,
/turf/open/floor/plating/indoor/metal/grate/border/warning,
/area/shuttle/escape)
"M" = (
/obj/structure/fans/tiny/invisible,
/turf/open/floor/plating/indoor/metal/plate,
/area/shuttle/escape)
"N" = (
/obj/machinery/light/small/red/dim/directional/north,
/turf/open/floor/plating/indoor/metal/industrial,
/area/shuttle/escape)
"O" = (
/turf/closed/wall/halflife/metal/strong,
/area/shuttle/escape)
"P" = (
/obj/structure/table/halflife/metal/heavy,
/turf/open/floor/plating/indoor/metal/grate/border/warning{
	dir = 1
	},
/area/shuttle/escape)
"T" = (
/obj/machinery/door/unpowered/halflife/seethrough/metal{
	dir = 8
	},
/obj/structure/fans/tiny/invisible,
/turf/open/floor/plating/indoor/metal/plate,
/area/shuttle/escape)
"V" = (
/turf/open/floor/plating/indoor/metal/industrial,
/area/shuttle/escape)
"W" = (
/turf/open/space/basic,
/area/shuttle/escape)
"Y" = (
/obj/structure/window/fulltile,
/obj/machinery/door/poddoor/preopen{
	id = "poland_shuttle_windows"
	},
/obj/structure/fans/tiny/invisible,
/turf/open/floor/plating/indoor/metal/plate,
/area/shuttle/escape)
"Z" = (
/obj/machinery/door/unpowered/halflife/metal/red{
	dir = 8
	},
/turf/open/floor/plating/indoor/woodc/wide,
/area/shuttle/escape)

(1,1,1) = {"
b
M
O
Y
O
O
Y
O
T
O
D
O
T
O
Y
O
O
O
D
O
O
W
W
F
F
F
F
"}
(2,1,1) = {"
M
O
O
P
P
O
p
a
a
a
a
a
a
a
a
a
a
a
a
a
a
W
W
F
F
F
F
"}
(3,1,1) = {"
M
O
L
d
d
e
d
d
d
d
E
d
d
d
d
E
d
d
d
d
d
W
W
F
F
F
F
"}
(4,1,1) = {"
t
g
A
d
d
v
d
d
O
Z
O
Z
O
O
J
O
O
d
d
d
d
W
W
F
F
F
F
"}
(5,1,1) = {"
M
O
k
d
d
e
d
d
O
o
x
h
O
K
V
s
O
d
d
d
d
W
W
F
F
F
F
"}
(6,1,1) = {"
M
O
O
P
P
O
a
j
O
I
h
h
O
N
V
H
O
a
a
a
a
W
W
F
F
F
F
"}
(7,1,1) = {"
b
M
O
Y
O
O
D
O
O
O
Y
O
O
O
D
O
O
O
Y
O
O
W
W
F
F
F
F
"}
