//MAP CONVERTED BY dmm2tgm.py THIS HEADER COMMENT PREVENTS RECONVERSION, DO NOT REMOVE
"a" = (
/obj/machinery/power/shuttle_engine/propulsion,
/turf/open/floor/plating/indoor/metal/plate,
/area/shuttle/escape)
"b" = (
/obj/structure/table/halflife/no_smooth/metal,
/obj/machinery/camera/autoname{
	dir = 8
	},
/turf/open/floor/plating/indoor/checkered,
/area/shuttle/escape)
"c" = (
/obj/structure/chair/comfy/halflife/diner{
	dir = 4
	},
/obj/machinery/light/small{
	dir = 8
	},
/turf/open/floor/plating/indoor/checkered,
/area/shuttle/escape)
"d" = (
/obj/structure/chair/comfy/halflife/diner{
	dir = 1
	},
/turf/open/floor/plating/indoor/checkered,
/area/shuttle/escape)
"e" = (
/obj/structure/closet/crate,
/turf/open/floor/plating/indoor/metal/grate,
/area/shuttle/escape)
"f" = (
/turf/template_noop,
/area/template_noop)
"g" = (
/obj/structure/table/halflife/no_smooth/metal,
/obj/machinery/light/small{
	dir = 4
	},
/turf/open/floor/plating/indoor/checkered,
/area/shuttle/escape)
"h" = (
/turf/open/floor/plating/indoor/sterilesquares,
/area/shuttle/escape)
"i" = (
/obj/structure/table/halflife/no_smooth/metal,
/turf/open/floor/plating/indoor/checkered,
/area/shuttle/escape)
"j" = (
/obj/docking_port/mobile/emergency{
	dir = 2;
	name = "Transfer Train";
	preferred_direction = 2;
	port_direction = 2
	},
/turf/closed/wall/halflife/metal,
/area/shuttle/escape)
"k" = (
/obj/structure/table/halflife/no_smooth/metal,
/obj/machinery/light/small{
	dir = 8
	},
/obj/item/food/flavorbar,
/turf/open/floor/plating/indoor/checkered,
/area/shuttle/escape)
"l" = (
/obj/structure/window/reinforced{
	dir = 1
	},
/obj/machinery/power/shuttle_engine/heater,
/turf/open/floor/plating/indoor/metal/plate,
/area/shuttle/escape)
"m" = (
/obj/structure/chair/comfy/halflife/diner,
/turf/open/floor/plating/indoor/checkered,
/area/shuttle/escape)
"n" = (
/obj/structure/table/halflife/no_smooth/metal,
/obj/item/reagent_containers/cup/soda_cans/breenwater/green{
	pixel_y = 5
	},
/turf/open/floor/plating/indoor/checkered,
/area/shuttle/escape)
"o" = (
/obj/structure/chair/comfy/halflife/captain{
	dir = 4
	},
/obj/structure/halflife/rug/red,
/turf/open/floor/plating/indoor/woodc/fancy,
/area/shuttle/escape)
"p" = (
/turf/open/floor/plating/indoor/tile/navy,
/area/shuttle/escape)
"q" = (
/obj/structure/table/halflife/no_smooth/metal,
/obj/machinery/light/small{
	dir = 4
	},
/obj/item/food/flavorbar/large,
/turf/open/floor/plating/indoor/checkered,
/area/shuttle/escape)
"r" = (
/obj/structure/table/halflife/metal,
/obj/item/restraints/handcuffs{
	pixel_y = 3
	},
/obj/structure/halflife/rug/red,
/turf/open/floor/plating/indoor/checkered,
/area/shuttle/escape)
"s" = (
/obj/machinery/door/unpowered/halflife/metal,
/turf/open/floor/plating/indoor/metal/plate,
/area/shuttle/escape)
"t" = (
/obj/structure/table/halflife/no_smooth/metal,
/obj/item/reagent_containers/pill/patch/medkit,
/obj/machinery/light/small/directional/west,
/turf/open/floor/plating/indoor/sterilesquares,
/area/shuttle/escape)
"u" = (
/obj/structure/table/halflife/no_smooth/metal,
/obj/machinery/light/small{
	dir = 8
	},
/turf/open/floor/plating/indoor/checkered,
/area/shuttle/escape)
"v" = (
/obj/machinery/light/small/directional/west,
/obj/structure/chair/comfy/halflife/diner{
	dir = 4
	},
/turf/open/floor/plating/indoor/checkered,
/area/shuttle/escape)
"w" = (
/obj/structure/table/halflife/no_smooth/metal,
/obj/machinery/camera/autoname{
	dir = 8
	},
/obj/item/reagent_containers/cup/soda_cans/breenwater/purple,
/turf/open/floor/plating/indoor/checkered,
/area/shuttle/escape)
"x" = (
/obj/structure/chair/comfy/halflife/captain{
	dir = 1
	},
/turf/open/floor/plating/indoor/checkered,
/area/shuttle/escape)
"y" = (
/obj/structure/chair/comfy/halflife/diner{
	dir = 8
	},
/turf/open/floor/plating/indoor/checkered,
/area/shuttle/escape)
"z" = (
/obj/machinery/light/small/directional/west,
/obj/structure/halflife/storage/shelf,
/turf/open/floor/plating/indoor/metal/grate,
/area/shuttle/escape)
"A" = (
/obj/structure/chair/comfy/halflife/diner{
	dir = 4
	},
/turf/open/floor/plating/indoor/checkered,
/area/shuttle/escape)
"B" = (
/obj/machinery/light/small{
	dir = 8
	},
/obj/structure/table/halflife/metal,
/obj/item/reagent_containers/pill/patch/medkit/vial,
/obj/item/reagent_containers/pill/patch/medkit/vial,
/obj/item/reagent_containers/pill/patch/medkit/vial{
	pixel_x = 8;
	pixel_y = 6
	},
/turf/open/floor/plating/indoor/checkered,
/area/shuttle/escape)
"C" = (
/obj/machinery/vending/breenwater,
/turf/open/floor/plating/indoor/checkered,
/area/shuttle/escape)
"D" = (
/obj/structure/chair/halflife/metal/blue{
	dir = 8
	},
/turf/open/floor/plating/indoor/tile/navy,
/area/shuttle/escape)
"E" = (
/obj/structure/table/halflife/no_smooth/metal,
/obj/item/food/flavorbar,
/turf/open/floor/plating/indoor/checkered,
/area/shuttle/escape)
"F" = (
/obj/structure/bed/halflife/bedframe/wire,
/obj/structure/bed/halflife/mattress/stained,
/turf/open/floor/plating/indoor/sterilesquares,
/area/shuttle/escape)
"G" = (
/obj/structure/chair/comfy/halflife/diner{
	dir = 4
	},
/obj/machinery/light/small/directional/west,
/turf/open/floor/plating/indoor/checkered,
/area/shuttle/escape)
"H" = (
/obj/machinery/turnstile/brig/halflife/forcefield{
	dir = 1
	},
/turf/open/floor/plating/indoor/woodc/fancy,
/area/shuttle/escape)
"I" = (
/turf/open/floor/plating/indoor/woodc/fancy,
/area/shuttle/escape)
"J" = (
/obj/structure/window/reinforced{
	dir = 4
	},
/turf/open/floor/plating/indoor/sterilesquares,
/area/shuttle/escape)
"K" = (
/obj/structure/chair/comfy/halflife/captain{
	dir = 8
	},
/turf/open/floor/plating/indoor/woodc/fancy,
/area/shuttle/escape)
"L" = (
/obj/structure/table/halflife/no_smooth/metal,
/obj/item/reagent_containers/cup/soda_cans/breenwater/red,
/turf/open/floor/plating/indoor/checkered,
/area/shuttle/escape)
"M" = (
/obj/machinery/computer/crew{
	dir = 8
	},
/turf/open/floor/plating/indoor/checkered,
/area/shuttle/escape)
"N" = (
/turf/closed/wall/halflife/metal,
/area/shuttle/escape)
"O" = (
/obj/machinery/door/unpowered/halflife/metal,
/turf/open/floor/plating/indoor/metal/grate/border,
/area/shuttle/escape)
"P" = (
/obj/structure/table/halflife/no_smooth/metal,
/obj/machinery/camera/autoname{
	dir = 4
	},
/obj/item/ammo_box/magazine/usp9mm,
/turf/open/floor/plating/indoor/checkered,
/area/shuttle/escape)
"Q" = (
/turf/open/floor/plating/indoor/tile/black,
/area/shuttle/escape)
"R" = (
/obj/structure/table/halflife/no_smooth/metal,
/obj/item/reagent_containers/pill/patch/medkit,
/obj/item/reagent_containers/syringe/syriniver,
/obj/machinery/light/small/directional/west,
/turf/open/floor/plating/indoor/sterilesquares,
/area/shuttle/escape)
"S" = (
/obj/structure/chair/comfy/halflife/diner{
	dir = 8
	},
/obj/machinery/light/small{
	dir = 4
	},
/turf/open/floor/plating/indoor/checkered,
/area/shuttle/escape)
"T" = (
/obj/structure/chair/comfy/halflife/diner{
	dir = 8
	},
/obj/machinery/light/small/directional/east,
/turf/open/floor/plating/indoor/checkered,
/area/shuttle/escape)
"U" = (
/obj/machinery/light/small/directional/east,
/turf/open/floor/plating/indoor/metal/grate,
/area/shuttle/escape)
"V" = (
/turf/open/floor/plating/indoor/metal/grate,
/area/shuttle/escape)
"W" = (
/obj/machinery/computer/emergency_shuttle{
	dir = 4
	},
/turf/open/floor/plating/indoor/checkered,
/area/shuttle/escape)
"X" = (
/obj/machinery/door/unpowered/halflife/seethrough/metal{
	dir = 8
	},
/obj/structure/fans/tiny/invisible,
/turf/open/floor/plating/indoor/checkered,
/area/shuttle/escape)
"Y" = (
/turf/open/floor/plating/indoor/checkered,
/area/shuttle/escape)
"Z" = (
/obj/machinery/light/small/directional/east,
/obj/structure/chair/halflife/metal/blue{
	dir = 8
	},
/turf/open/floor/plating/indoor/tile/navy,
/area/shuttle/escape)

(1,1,1) = {"
f
N
N
N
N
N
N
X
N
N
N
N
N
X
N
N
N
N
N
N
N
N
N
N
N
N
N
N
N
N
N
N
N
N
f
"}
(2,1,1) = {"
N
N
B
r
N
N
A
Y
c
i
A
k
A
Y
v
N
G
E
A
u
A
L
G
Y
Q
t
F
h
R
N
z
V
N
l
a
"}
(3,1,1) = {"
N
P
I
K
N
m
Q
Q
Q
Q
Q
Q
Q
Q
Q
N
Q
Q
Q
Q
Q
Q
Q
Q
Q
h
h
h
F
N
e
V
N
l
a
"}
(4,1,1) = {"
j
W
x
I
H
Q
Q
Q
d
m
Q
d
m
Q
Q
s
Q
C
Q
d
m
Q
Q
Q
Q
h
J
J
J
N
V
V
N
l
a
"}
(5,1,1) = {"
N
n
I
o
N
m
Q
Q
Q
Q
Q
Q
Q
Q
Q
N
Q
Q
Q
Q
Q
Q
Q
Q
Q
p
p
p
p
O
V
V
N
l
a
"}
(6,1,1) = {"
N
N
q
M
N
N
y
Y
S
w
y
g
y
Y
T
N
T
i
y
g
y
b
T
Y
Q
Z
D
D
Z
N
U
V
N
l
a
"}
(7,1,1) = {"
f
N
N
N
N
N
N
X
N
N
N
N
N
X
N
N
N
N
N
N
N
N
N
N
N
N
N
N
N
N
N
N
N
N
f
"}
