//MAP CONVERTED BY dmm2tgm.py THIS HEADER COMMENT PREVENTS RECONVERSION, DO NOT REMOVE
"a" = (
/turf/open/floor/plating/indoor/metal/plate,
/area/shuttle/escape/backup)
"c" = (
/obj/structure/chair/comfy/halflife/diner{
	dir = 8
	},
/obj/machinery/light/small{
	dir = 4
	},
/turf/open/floor/plating/indoor/grooved,
/area/shuttle/escape/backup)
"d" = (
/obj/structure/extinguisher_cabinet/directional/north,
/turf/open/floor/plating/indoor/metal/plate,
/area/shuttle/escape/backup)
"e" = (
/obj/structure/table/halflife/no_smooth/metal,
/obj/item/paper/fluff/stations/centcom/broken_evac{
	pixel_x = 2;
	pixel_y = 4
	},
/turf/open/floor/plating/indoor/grooved,
/area/shuttle/escape/backup)
"f" = (
/obj/structure/chair/comfy/halflife/diner{
	dir = 1
	},
/turf/open/floor/plating/indoor/grooved,
/area/shuttle/escape/backup)
"g" = (
/obj/structure/table/halflife/no_smooth/metal,
/obj/machinery/camera/autoname{
	dir = 8
	},
/turf/open/floor/plating/indoor/grooved,
/area/shuttle/escape/backup)
"h" = (
/obj/structure/halflife/trash/papers/one{
	dir = 8
	},
/turf/open/floor/plating/indoor/metal/plate,
/area/shuttle/escape/backup)
"j" = (
/obj/structure/chair/comfy/halflife/diner{
	dir = 4
	},
/turf/open/floor/plating/indoor/grooved,
/area/shuttle/escape/backup)
"k" = (
/obj/structure/table/halflife/no_smooth/metal,
/obj/machinery/light/small{
	dir = 4
	},
/turf/open/floor/plating/indoor/grooved,
/area/shuttle/escape/backup)
"l" = (
/obj/structure/chair/comfy/halflife/diner,
/obj/structure/extinguisher_cabinet/directional/north,
/turf/open/floor/plating/indoor/grooved,
/area/shuttle/escape/backup)
"m" = (
/turf/template_noop,
/area/template_noop)
"n" = (
/obj/structure/rack,
/obj/machinery/light/small/directional/west,
/turf/open/floor/plating/indoor/metal/plate,
/area/shuttle/escape/backup)
"o" = (
/obj/structure/chair/comfy/halflife/captain{
	dir = 1
	},
/turf/open/floor/plating/indoor/grooved,
/area/shuttle/escape/backup)
"p" = (
/obj/structure/halflife/storage/shelf,
/turf/open/floor/plating/indoor/metal/plate,
/area/shuttle/escape/backup)
"q" = (
/obj/machinery/light/small{
	dir = 8
	},
/obj/structure/table/halflife/metal,
/obj/item/reagent_containers/pill/patch/medkit/vial,
/turf/open/floor/plating/indoor/grooved,
/area/shuttle/escape/backup)
"r" = (
/obj/structure/table/halflife/metal,
/obj/item/restraints/handcuffs{
	pixel_y = 3
	},
/turf/open/floor/plating/indoor/grooved,
/area/shuttle/escape/backup)
"s" = (
/obj/structure/chair/comfy/halflife/diner,
/obj/machinery/vending/combine_wallmed/directional/north,
/turf/open/floor/plating/indoor/grooved,
/area/shuttle/escape/backup)
"t" = (
/obj/structure/fans/tiny/invisible,
/obj/structure/railing{
	dir = 4
	},
/turf/open/floor/plating/indoor/metal/plate,
/area/shuttle/escape/backup)
"u" = (
/obj/structure/chair/comfy/halflife/diner{
	dir = 8
	},
/obj/machinery/light/small/directional/east,
/turf/open/floor/plating/indoor/grooved,
/area/shuttle/escape/backup)
"v" = (
/obj/structure/table/halflife/metal,
/obj/structure/halflife/trash/glass/basic,
/turf/open/floor/plating/indoor/metal/plate,
/area/shuttle/escape/backup)
"w" = (
/obj/machinery/turnstile/brig/halflife/forcefield{
	dir = 1
	},
/turf/open/floor/plating/indoor/metal/plate,
/area/shuttle/escape/backup)
"x" = (
/obj/structure/closet/crate/halflife,
/turf/open/floor/plating/indoor/metal/plate,
/area/shuttle/escape/backup)
"z" = (
/obj/machinery/door/unpowered/halflife/seethrough/metal{
	dir = 8
	},
/obj/structure/fans/tiny/invisible,
/turf/open/floor/plating/indoor/grooved,
/area/shuttle/escape/backup)
"A" = (
/obj/structure/table/halflife/no_smooth/metal,
/turf/open/floor/plating/indoor/grooved,
/area/shuttle/escape/backup)
"B" = (
/obj/structure/halflife/trash/papers/two,
/turf/open/floor/plating/indoor/metal/plate,
/area/shuttle/escape/backup)
"C" = (
/obj/structure/chair/comfy/halflife/diner,
/turf/open/floor/plating/indoor/grooved,
/area/shuttle/escape/backup)
"D" = (
/obj/machinery/computer/emergency_shuttle{
	dir = 4
	},
/turf/open/floor/plating/indoor/grooved,
/area/shuttle/escape/backup)
"F" = (
/obj/structure/chair/comfy/halflife/diner{
	dir = 4
	},
/obj/machinery/light/small{
	dir = 8
	},
/turf/open/floor/plating/indoor/grooved,
/area/shuttle/escape/backup)
"H" = (
/obj/docking_port/mobile/emergency/backup{
	name = "Secondary Transfer Train";
	dir = 2
	},
/turf/closed/wall/halflife/metal/strong/train,
/area/shuttle/escape/backup)
"I" = (
/obj/structure/fans/tiny/invisible,
/obj/structure/railing{
	dir = 8
	},
/turf/open/floor/plating/indoor/metal/plate,
/area/shuttle/escape/backup)
"K" = (
/obj/structure/chair/comfy/halflife/captain{
	dir = 4
	},
/turf/open/floor/plating/indoor/grooved,
/area/shuttle/escape/backup)
"L" = (
/turf/open/floor/plating/indoor/grooved,
/area/shuttle/escape/backup)
"N" = (
/obj/structure/chair/comfy/halflife/diner{
	dir = 4
	},
/obj/machinery/light/small/directional/west,
/turf/open/floor/plating/indoor/grooved,
/area/shuttle/escape/backup)
"O" = (
/obj/machinery/door/unpowered/halflife/metal,
/turf/open/floor/plating/indoor/metal/plate,
/area/shuttle/escape/backup)
"P" = (
/turf/closed/wall/halflife/metal/strong/train,
/area/shuttle/escape/backup)
"R" = (
/obj/structure/halflife/trash/papers/two{
	dir = 1
	},
/turf/open/floor/plating/indoor/metal/plate,
/area/shuttle/escape/backup)
"S" = (
/obj/structure/chair/comfy/halflife/captain{
	dir = 8
	},
/turf/open/floor/plating/indoor/grooved,
/area/shuttle/escape/backup)
"U" = (
/obj/machinery/light/small/directional/east,
/turf/open/floor/plating/indoor/metal/plate,
/area/shuttle/escape/backup)
"V" = (
/obj/machinery/computer/crew{
	dir = 8
	},
/turf/open/floor/plating/indoor/grooved,
/area/shuttle/escape/backup)
"X" = (
/obj/structure/table/halflife/no_smooth/metal,
/obj/machinery/camera/autoname{
	dir = 4
	},
/turf/open/floor/plating/indoor/grooved,
/area/shuttle/escape/backup)
"Y" = (
/obj/structure/chair/comfy/halflife/diner{
	dir = 8
	},
/turf/open/floor/plating/indoor/grooved,
/area/shuttle/escape/backup)
"Z" = (
/obj/structure/table/halflife/no_smooth/metal,
/obj/machinery/light/small{
	dir = 8
	},
/turf/open/floor/plating/indoor/grooved,
/area/shuttle/escape/backup)

(1,1,1) = {"
m
P
P
P
P
P
P
z
P
P
P
P
P
z
P
m
m
m
P
P
P
P
P
P
P
P
P
P
P
m
"}
(2,1,1) = {"
P
P
q
r
P
P
j
L
F
A
j
Z
j
L
P
P
m
P
P
A
j
Z
j
A
N
P
x
n
P
P
"}
(3,1,1) = {"
P
X
L
S
P
l
h
a
a
a
a
a
a
a
a
P
I
P
a
a
B
a
a
a
a
P
d
a
a
P
"}
(4,1,1) = {"
H
D
o
L
w
a
a
a
f
C
a
f
C
a
a
O
a
O
a
a
a
f
C
a
a
O
a
a
a
P
"}
(5,1,1) = {"
P
e
L
K
P
s
a
a
a
R
a
a
a
a
a
P
t
P
a
a
a
a
a
a
a
P
p
a
v
P
"}
(6,1,1) = {"
P
P
k
V
P
P
Y
L
c
g
Y
k
Y
L
P
P
m
P
P
A
Y
k
Y
g
u
P
p
U
P
P
"}
(7,1,1) = {"
m
P
P
P
P
P
P
z
P
P
P
P
P
z
P
m
m
m
P
P
P
P
P
P
P
P
P
P
P
m
"}
