//MAP CONVERTED BY dmm2tgm.py THIS HEADER COMMENT PREVENTS RECONVERSION, DO NOT REMOVE
"aa" = (
/turf/template_noop,
/area/template_noop)
"ad" = (
/obj/structure/table/halflife/no_smooth/cable_reel,
/obj/item/reagent_containers/cup/glass/bottle/vodka{
	pixel_y = 13;
	pixel_x = -8
	},
/obj/item/food/canned/halflife/beans{
	pixel_y = 8;
	pixel_x = 6
	},
/turf/open/floor/plating/indoor/woodc/wide,
/area/shuttle/syndicate/hallway)
"af" = (
/obj/structure/chair/halflife/metal/folding{
	dir = 1
	},
/turf/open/floor/plating/indoor/woodc/wide,
/area/shuttle/syndicate/hallway)
"ak" = (
/obj/structure/chair/halflife/metal/folding{
	dir = 4
	},
/turf/open/floor/plating/indoor/woodc/wide,
/area/shuttle/syndicate/hallway)
"as" = (
/obj/machinery/door/unpowered/halflife/wood{
	dir = 8
	},
/obj/structure/fans/tiny/invisible,
/turf/open/floor/plating/indoor/woodc/wide,
/area/shuttle/syndicate/hallway)
"ax" = (
/obj/machinery/porta_turret/combine/rebel{
	dir = 4;
	anchored = 1
	},
/obj/structure/railing/halflife/solo{
	dir = 1
	},
/obj/structure/railing/halflife/solo{
	dir = 4
	},
/turf/open/floor/plating/indoor/woodc/wide,
/area/shuttle/syndicate/hallway)
"aB" = (
/obj/structure/bed/halflife/bedframe/wood,
/obj/structure/bed/halflife/mattress/stale,
/turf/open/floor/plating/indoor/woodc/wide,
/area/shuttle/syndicate/hallway)
"bc" = (
/turf/closed/wall/halflife/wood,
/area/shuttle/syndicate/hallway)
"bn" = (
/obj/structure/railing/halflife/solo,
/obj/structure/railing/halflife/solo{
	dir = 4
	},
/turf/open/floor/plating/indoor/woodc/wide,
/area/shuttle/syndicate/hallway)
"bx" = (
/obj/structure/bed/halflife/bedframe/wood,
/obj/structure/bed/halflife/mattress/stained,
/turf/open/floor/plating/indoor/woodc/wide,
/area/shuttle/syndicate/hallway)
"nN" = (
/obj/docking_port/mobile/infiltrator,
/turf/open/floor/plating/indoor/woodc/wide,
/area/shuttle/syndicate/hallway)
"pQ" = (
/obj/machinery/computer/shuttle/syndicate,
/obj/machinery/light/small/directional/north,
/turf/open/floor/plating/indoor/woodc/wide,
/area/shuttle/syndicate/hallway)
"st" = (
/turf/open/floor/plating/indoor/woodc/wide,
/area/shuttle/syndicate/hallway)
"ye" = (
/obj/structure/table/halflife/no_smooth/wood,
/turf/open/floor/plating/indoor/woodc/wide,
/area/shuttle/syndicate/hallway)
"AZ" = (
/obj/structure/table/halflife/no_smooth/wood,
/obj/machinery/jukebox/radio,
/turf/open/floor/plating/indoor/woodc/wide,
/area/shuttle/syndicate/hallway)
"Fd" = (
/obj/machinery/light/small/directional/west,
/turf/open/floor/plating/indoor/woodc/wide,
/area/shuttle/syndicate/hallway)
"In" = (
/obj/machinery/computer/camera_advanced/syndie,
/turf/open/floor/plating/indoor/woodc/wide,
/area/shuttle/syndicate/hallway)
"KB" = (
/obj/structure/table/halflife/no_smooth/wood,
/obj/structure/halflife/trash/glass/basic,
/obj/machinery/light/small/directional/east,
/turf/open/floor/plating/indoor/woodc/wide,
/area/shuttle/syndicate/hallway)
"Nr" = (
/obj/structure/halflife/trash/cardboard,
/obj/item/light/bulb,
/obj/item/light/bulb,
/turf/open/floor/plating/indoor/woodc/wide,
/area/shuttle/syndicate/hallway)
"Qx" = (
/obj/structure/bed/halflife/bedframe/wood,
/obj/structure/bed/halflife/mattress/yellowed,
/turf/open/floor/plating/indoor/woodc/wide,
/area/shuttle/syndicate/hallway)
"QX" = (
/obj/structure/table/halflife/no_smooth/wood,
/obj/machinery/light/small/directional/east,
/turf/open/floor/plating/indoor/woodc/wide,
/area/shuttle/syndicate/hallway)
"UN" = (
/obj/machinery/door/unpowered/halflife/wood,
/turf/open/floor/plating/indoor/woodc/wide,
/area/shuttle/syndicate/hallway)
"VW" = (
/obj/structure/table/halflife/no_smooth/wood,
/obj/machinery/light/small/directional/west,
/turf/open/floor/plating/indoor/woodc/wide,
/area/shuttle/syndicate/hallway)

(1,1,1) = {"
aa
aa
aa
aa
aa
aa
aa
aa
aa
aa
aa
aa
aa
aa
aa
aa
aa
aa
aa
aa
aa
aa
aa
"}
(2,1,1) = {"
aa
aa
aa
aa
aa
aa
aa
aa
aa
aa
aa
aa
aa
aa
aa
aa
aa
aa
aa
aa
aa
aa
aa
"}
(3,1,1) = {"
aa
aa
aa
aa
aa
aa
aa
aa
aa
aa
aa
aa
aa
aa
aa
aa
aa
aa
aa
aa
aa
aa
aa
"}
(4,1,1) = {"
aa
aa
aa
aa
aa
aa
aa
aa
aa
aa
aa
aa
aa
aa
aa
aa
aa
aa
aa
aa
aa
aa
aa
"}
(5,1,1) = {"
aa
aa
aa
aa
aa
aa
aa
aa
aa
aa
aa
aa
aa
aa
aa
aa
aa
aa
aa
aa
aa
aa
aa
"}
(6,1,1) = {"
aa
aa
aa
aa
aa
aa
aa
aa
aa
aa
aa
aa
aa
aa
aa
aa
aa
aa
aa
aa
aa
aa
aa
"}
(7,1,1) = {"
aa
aa
aa
aa
aa
aa
aa
aa
aa
ax
st
st
st
bn
aa
aa
aa
aa
aa
aa
aa
aa
aa
"}
(8,1,1) = {"
aa
aa
aa
aa
aa
bc
bc
bc
bc
bc
bc
as
bc
bc
bc
aa
aa
aa
aa
aa
aa
aa
aa
"}
(9,1,1) = {"
aa
aa
aa
aa
bc
bc
ak
ye
ak
Fd
st
st
bc
VW
bc
bc
bc
aa
aa
aa
aa
aa
aa
"}
(10,1,1) = {"
aa
aa
aa
aa
bc
AZ
st
st
st
st
st
st
UN
st
Qx
bc
bc
aa
aa
aa
aa
aa
aa
"}
(11,1,1) = {"
aa
aa
aa
aa
bc
pQ
af
st
st
st
st
st
bc
bc
bc
bc
bc
aa
aa
aa
aa
aa
aa
"}
(12,1,1) = {"
aa
aa
aa
aa
bc
In
st
st
st
st
st
st
UN
st
bx
bc
bc
aa
aa
aa
aa
aa
aa
"}
(13,1,1) = {"
aa
aa
aa
aa
bc
bc
ad
aB
Nr
KB
st
st
bc
QX
bc
bc
bc
aa
aa
aa
aa
aa
aa
"}
(14,1,1) = {"
aa
aa
aa
aa
aa
bc
bc
bc
bc
bc
bc
as
bc
bc
bc
aa
aa
aa
aa
aa
aa
aa
aa
"}
(15,1,1) = {"
aa
aa
aa
aa
aa
aa
aa
aa
aa
ax
st
nN
st
bn
aa
aa
aa
aa
aa
aa
aa
aa
aa
"}
(16,1,1) = {"
aa
aa
aa
aa
aa
aa
aa
aa
aa
aa
aa
aa
aa
aa
aa
aa
aa
aa
aa
aa
aa
aa
aa
"}
(17,1,1) = {"
aa
aa
aa
aa
aa
aa
aa
aa
aa
aa
aa
aa
aa
aa
aa
aa
aa
aa
aa
aa
aa
aa
aa
"}
