//MAP CONVERTED BY dmm2tgm.py THIS HEADER COMMENT PREVENTS RECONVERSION, DO NOT REMOVE
"a" = (
/obj/structure/chair/halflife/metal/red{
	dir = 1
	},
/obj/effect/decal/cleanable/blood/old,
/obj/machinery/light/cold/directional/south,
/turf/open/floor/plating/indoor/metal,
/area/shuttle/labor)
"b" = (
/obj/structure/fans/tiny/invisible,
/obj/machinery/door/unpowered/halflife/metal{
	dir = 4
	},
/turf/open/floor/plating/indoor/metal,
/area/shuttle/labor)
"c" = (
/obj/effect/decal/cleanable/blood/old,
/turf/open/floor/plating/indoor/metal,
/area/shuttle/labor)
"d" = (
/obj/machinery/door/airlock/highsecurity/combine,
/obj/structure/fans/tiny/invisible,
/obj/effect/mapping_helpers/airlock/access/all/security/brig,
/turf/open/floor/plating/indoor/metal,
/area/shuttle/labor)
"e" = (
/obj/machinery/mineral/labor_claim_console{
	pixel_x = 30
	},
/turf/open/floor/plating/indoor/metal,
/area/shuttle/labor)
"f" = (
/turf/open/floor/plating/indoor/metal,
/area/shuttle/labor)
"g" = (
/obj/structure/window/fulltile,
/obj/structure/fans/tiny/invisible,
/turf/open/floor/plating/indoor/metal,
/area/shuttle/labor)
"h" = (
/obj/docking_port/mobile{
	dir = 2;
	shuttle_id = "laborcamp";
	name = "labor camp shuttle";
	port_direction = 2;
	preferred_direction = 2;
	width = 5;
	height = 13
	},
/obj/structure/window/fulltile,
/obj/structure/fans/tiny/invisible,
/turf/open/floor/plating/indoor/metal,
/area/shuttle/labor)
"i" = (
/obj/structure/fans/tiny/invisible,
/obj/machinery/door/unpowered/halflife/metal{
	dir = 8
	},
/turf/open/floor/plating/indoor/metal,
/area/shuttle/labor)
"j" = (
/obj/machinery/computer/shuttle/labor,
/turf/open/floor/plating/indoor/metal,
/area/shuttle/labor)
"k" = (
/turf/closed/wall/halflife/metal/weak,
/area/shuttle/labor)
"l" = (
/obj/structure/chair/office/halflife/blue{
	dir = 1
	},
/turf/open/floor/plating/indoor/metal,
/area/shuttle/labor)
"n" = (
/obj/machinery/mineral/stacking_unit_console{
	pixel_x = -1;
	pixel_y = -31
	},
/obj/machinery/light/cold/directional/south,
/turf/open/floor/plating/indoor/metal,
/area/shuttle/labor)
"p" = (
/obj/machinery/turnstile/brig/halflife/forcefield/civilprotection/nodirectional,
/turf/open/floor/plating/indoor/metal,
/area/shuttle/labor)
"q" = (
/obj/machinery/mineral/stacking_machine/laborstacker{
	input_dir = 2;
	output_dir = 1
	},
/turf/open/floor/plating/indoor/metal,
/area/shuttle/labor)
"s" = (
/obj/structure/table/halflife/metal,
/turf/open/floor/plating/indoor/metal,
/area/shuttle/labor)
"W" = (
/turf/template_noop,
/area/template_noop)

(1,1,1) = {"
W
g
g
d
k
k
i
k
W
W
W
W
W
"}
(2,1,1) = {"
g
g
s
f
q
c
f
k
k
k
k
W
W
"}
(3,1,1) = {"
h
j
l
n
k
f
f
a
k
k
k
k
k
"}
(4,1,1) = {"
g
g
s
f
p
e
f
k
k
k
k
W
W
"}
(5,1,1) = {"
W
g
g
d
k
k
b
k
W
W
W
W
W
"}
