//MAP CONVERTED BY dmm2tgm.py THIS HEADER COMMENT PREVENTS RECONVERSION, DO NOT REMOVE
"a" = (
/turf/open/floor/plating/indoor/woodc/wide,
/area/shuttle/pirate/flying_dutchman)
"b" = (
/obj/structure/table/halflife/no_smooth/cable_reel,
/obj/item/reagent_containers/cup/glass/bottle/vodka{
	pixel_y = 13;
	pixel_x = -8
	},
/obj/item/food/canned/halflife/beans{
	pixel_y = 8;
	pixel_x = 6
	},
/turf/open/floor/plating/indoor/woodc/wide,
/area/shuttle/pirate/flying_dutchman)
"d" = (
/obj/structure/table/halflife/no_smooth/wood,
/obj/machinery/light/small/directional/north,
/obj/machinery/jukebox/radio,
/turf/open/floor/plating/indoor/woodc/wide,
/area/shuttle/pirate/flying_dutchman)
"j" = (
/obj/machinery/piratepad,
/turf/open/floor/plating/indoor/woodc/wide,
/area/shuttle/pirate/flying_dutchman)
"k" = (
/obj/structure/halflife/trash/cardboard,
/obj/item/melee/tireiron,
/obj/item/light/bulb,
/obj/item/light/bulb,
/turf/open/floor/plating/indoor/woodc/wide,
/area/shuttle/pirate/flying_dutchman)
"o" = (
/obj/structure/chair/halflife/metal/folding{
	dir = 1
	},
/turf/open/floor/plating/indoor/woodc/wide,
/area/shuttle/pirate/flying_dutchman)
"p" = (
/obj/structure/table/halflife/no_smooth/wood,
/obj/item/gun/ballistic/automatic/pistol/makeshift{
	pixel_y = 5;
	pixel_x = -5
	},
/obj/item/switchblade,
/turf/open/floor/plating/indoor/woodc/wide,
/area/shuttle/pirate/flying_dutchman)
"s" = (
/obj/machinery/door/unpowered/halflife/wood{
	dir = 8
	},
/obj/structure/fans/tiny/invisible,
/turf/open/floor/plating/indoor/woodc/wide,
/area/shuttle/pirate/flying_dutchman)
"t" = (
/obj/structure/halflife/pallet,
/obj/item/binoculars,
/turf/open/floor/plating/indoor/woodc/wide,
/area/shuttle/pirate/flying_dutchman)
"u" = (
/obj/structure/table/halflife/no_smooth/wood,
/obj/machinery/light/small/directional/east,
/obj/item/switchblade,
/obj/item/gun/ballistic/automatic/pistol/makeshift{
	pixel_y = 5;
	pixel_x = -5
	},
/turf/open/floor/plating/indoor/woodc/wide,
/area/shuttle/pirate/flying_dutchman)
"v" = (
/obj/machinery/computer/shuttle/bandits,
/turf/open/floor/plating/indoor/woodc/wide,
/area/shuttle/pirate/flying_dutchman)
"C" = (
/obj/structure/table/halflife/no_smooth/wood,
/obj/item/stack/medical/bandage,
/obj/item/stack/medical/gauze{
	pixel_x = -7
	},
/obj/item/reagent_containers/pill/patch/medkit/vial{
	pixel_y = 4;
	pixel_x = 7
	},
/obj/item/reagent_containers/syringe/syriniver,
/turf/open/floor/plating/indoor/woodc/wide,
/area/shuttle/pirate/flying_dutchman)
"G" = (
/obj/docking_port/mobile{
	name = "Bandit Ship";
	shuttle_id = "bandit";
	port_direction = 2;
	dir = 2
	},
/turf/closed/wall/halflife/wood,
/area/shuttle/pirate/flying_dutchman)
"H" = (
/obj/structure/table/halflife/no_smooth/wood,
/obj/item/restraints/handcuffs,
/obj/item/restraints/handcuffs,
/obj/item/restraints/handcuffs,
/obj/item/ammo_box/magazine/makeshift9mm{
	pixel_x = -3
	},
/obj/item/ammo_box/magazine/makeshift9mm,
/turf/open/floor/plating/indoor/woodc/wide,
/area/shuttle/pirate/flying_dutchman)
"I" = (
/obj/structure/table/halflife/no_smooth/wood,
/obj/machinery/light/small/directional/west,
/obj/item/switchblade,
/obj/item/gun/ballistic/automatic/pistol/makeshift{
	pixel_y = 5;
	pixel_x = -5
	},
/turf/open/floor/plating/indoor/woodc/wide,
/area/shuttle/pirate/flying_dutchman)
"J" = (
/obj/machinery/computer/piratepad_control{
	dir = 4
	},
/turf/open/floor/plating/indoor/woodc/wide,
/area/shuttle/pirate/flying_dutchman)
"K" = (
/obj/effect/mob_spawn/ghost_role/human/pirate/bandit,
/obj/structure/bed/halflife/bedframe/wood,
/obj/structure/bed/halflife/mattress/yellowed,
/turf/open/floor/plating/indoor/woodc/wide,
/area/shuttle/pirate/flying_dutchman)
"M" = (
/obj/structure/bed/halflife/bedframe/wood,
/obj/effect/mob_spawn/ghost_role/human/pirate/bandit,
/obj/structure/bed/halflife/mattress/stale,
/obj/machinery/light/small/directional/east,
/turf/open/floor/plating/indoor/woodc/wide,
/area/shuttle/pirate/flying_dutchman)
"O" = (
/turf/template_noop,
/area/template_noop)
"Q" = (
/turf/closed/wall/halflife/wood,
/area/shuttle/pirate/flying_dutchman)
"V" = (
/obj/machinery/door/unpowered/halflife/wood,
/turf/open/floor/plating/indoor/woodc/wide,
/area/shuttle/pirate/flying_dutchman)
"W" = (
/obj/effect/mob_spawn/ghost_role/human/pirate/bandit,
/obj/structure/bed/halflife/bedframe/wood,
/obj/structure/bed/halflife/mattress/stained,
/turf/open/floor/plating/indoor/woodc/wide,
/area/shuttle/pirate/flying_dutchman)
"Y" = (
/obj/structure/halflife/trash/glass/basic,
/turf/open/floor/plating/indoor/woodc/wide,
/area/shuttle/pirate/flying_dutchman)

(1,1,1) = {"
O
Q
Q
Q
Q
s
Q
Q
Q
O
O
"}
(2,1,1) = {"
Q
Q
j
J
C
a
Q
I
Q
Q
Q
"}
(3,1,1) = {"
Q
d
a
a
a
a
V
a
K
Q
Q
"}
(4,1,1) = {"
G
v
o
t
a
Y
Q
Q
Q
Q
Q
"}
(5,1,1) = {"
Q
H
a
a
a
a
V
a
W
Q
Q
"}
(6,1,1) = {"
Q
Q
b
M
k
p
Q
u
Q
Q
Q
"}
(7,1,1) = {"
O
Q
Q
Q
Q
Q
Q
Q
Q
O
O
"}
